geography code,outcode,postcodes,Welsh speaking ability: Total: All usual residents aged 3 years and over,Welsh speaking ability: Cannot speak Welsh,Welsh speaking ability: Can speak Welsh
W00009564,CF1,"CF1 8DS, CF1 9AX, CF1 9AY, CF1 9BD, CF11 6DP, CF11 6DS, CF11 6DU, CF11 6DW, CF11 6DX, CF11 6DZ, CF11 6EA, CF11 9BE",341,288,53
W00009565,CF1,"CF1 8DQ, CF1 8DR, CF1 8JY, CF1 8JZ, CF1 8LA, CF1 8LE, CF1 8SU, CF11 6DQ, CF11 6DR, CF11 6EW, CF11 6EY, CF11 6JZ",383,332,51
W00010573,CF1,"CF1 1JU, CF1 1NZ, CF1 1PH, CF1 1SN, CF1 1UE, CF1 1UF, CF1 2DJ, CF1 2DN, CF1 2EA, CF1 2EE, CF1 2EN, CF1 2EY, CF1 2EZ, CF1 2RZ, CF1 2SE, CF1 2SJ, CF1 2SP, CF1 2SQ, CF1 2SR, CF1 2TB, CF1 2TH, CF1 2TJ, CF1 3BX, CF1 3QT, CF1 3SL, CF1 3SS, CF1 3SW, CF1 3SX, CF1 3XJ, CF1 3XL, CF1 4AA, CF1 4AB, CF1 4AF, CF1 4AG, CF1 4AH, CF1 4AJ, CF1 4AQ, CF1 4AR, CF1 4AS, CF1 4AT, CF1 4AU, CF1 4AW, CF1 4AX, CF1 4AY, CF1 4BE, CF1 4BH, CF1 4BJ, CF1 4BW, CF1 4BX, CF1 4BY, CF1 4BZ, CF1 4DA, CF1 4DR, CF1 4DS, CF1 4DW, CF1 4DX, CF1 4DY, CF1 4EA, CF1 4EB, CF1 4ED, CF1 4EE, CF1 4EF, CF1 4EG, CF1 4EH, CF1 4EP, CF1 4EQ, CF1 4ER, CF1 4ES, CF1 4HB, CF1 4HD, CF1 4HE, CF1 4HF, CF1 4HG, CF1 4HH, CF1 4JA, CF1 4JB, CF1 4LH, CF1 4LR, CF1 4NB, CF1 4ND, CF1 4NE, CF1 4NF, CF1 4NG, CF1 4NN, CF1 4NR, CF1 4NU, CF1 4NW, CF1 4NX, CF1 4PX, CF1 4QL, CF1 4RA, CF1 4RF, CF1 4RG, CF1 4RH, CF1 4RN, CF1 4RP, CF1 4RR, CF1 4RS, CF1 4RT, CF1 4RW, CF1 4RY, CF1 4SA, CF1 4SB, CF1 4SD, CF1 4SE, CF1 4SF, CF1 4SG, CF1 4SH, CF1 4SL, CF1 4SQ, CF1 4SS, CF1 4SU, CF1 4SX, CF1 4SY, CF1 4SZ, CF1 4TA, CF1 4TD, CF1 4TF, CF1 4TH, CF1 4TJ, CF1 4TL, CF1 4TN, CF1 4TP, CF1 4TQ, CF1 4TR, CF1 4TT, CF1 4TU, CF1 4TW, CF1 4TX, CF1 4TY, CF1 4TZ, CF1 4UD, CF1 4UE, CF1 4UF, CF1 4UG, CF1 4UH, CF1 4UJ, CF1 4UL, CF1 4UN, CF1 4UP, CF1 4UZ, CF1 4WA, CF1 4WB, CF1 4WD, CF1 4WE, CF1 4WG, CF1 4WZ, CF1 4XA, CF1 4XB, CF1 4XD, CF1 4XE, CF1 4XF, CF1 4XG, CF1 4XH, CF1 4XJ, CF1 4XL, CF1 4XN, CF1 4XP, CF1 4XQ, CF1 4XR, CF1 4XS, CF1 4XT, CF1 4XU, CF1 4XW, CF1 4XX, CF1 4XY, CF1 4XZ, CF1 6PS, CF10 1GG, CF10 1GJ, CF10 1GN, CF10 1GP, CF10 2AA, CF10 2AN, CF10 2AW, CF10 2AY, CF10 2AZ, CF10 2BU, CF10 2BW, CF10 2BX, CF10 2BY, CF10 2DB, CF10 2DP, CF10 2DQ, CF10 2DS, CF10 2DW, CF10 2DX, CF10 2DY, CF10 2DZ, CF10 2EA, CF10 2EB, CF10 2EH, CF10 2FN, CF10 2FR, CF10 2GA, CF10 2GB, CF10 2GD, CF10 2GE, CF10 2GF, CF10 2GG, CF10 2GH, CF10 2GQ, CF10 2GR, CF10 2GS, CF10 2NW, CF10 2PX, CF10 2QS, CF10 2QT, CF10 2QY, CF10 2RG, CF10 2RJ, CF10 2SD, CF10 2SF, CF10 2SS, CF10 2TA, CF10 2TJ, CF10 2TP, CF10 2TQ, CF10 2TR, CF10 2TS, CF10 2TU, CF10 2TZ, CF10 2UB, CF10 2UF, CF10 2UH, CF10 2UW, CF10 2WF, CF10 2XE, CF10 2XG, CF10 2XL, CF10 2XN, CF10 2YL",367,346,21
W00010154,CF1,"CF1 6JA, CF10 5AU, CF10 5AX, CF10 5FA, CF10 5UU",277,251,26
W00010153,CF1,"CF1 1NA, CF1 1NU, CF1 1PQ, CF1 1SE, CF1 2DP, CF1 2DR, CF1 2DS, CF1 2DW, CF1 2EP, CF1 2SY, CF1 2TD, CF1 2UZ, CF1 2XG, CF1 2XL, CF1 2YB, CF1 2YE, CF1 2YH, CF1 2YJ, CF1 2YQ, CF1 4DB, CF1 4DD, CF1 4DE, CF1 4DF, CF1 4DG, CF1 4DH, CF1 4DJ, CF1 4DL, CF1 4DP, CF1 4DQ, CF1 4DT, CF1 4TS, CF1 4UU, CF10 1AQ, CF10 1BF, CF10 1BL, CF10 1BN, CF10 1BQ, CF10 1BZ, CF10 1DS, CF10 1DT, CF10 1DU, CF10 1EF, CF10 1GA, CF10 1SL, CF10 1TA, CF10 1UR, CF10 1US, CF10 2DJ, CF10 2DL, CF10 2DN, CF10 2DR, CF10 2DT, CF10 2DU, CF10 2EF, CF10 2EJ, CF10 2EL, CF10 2ER, CF10 2EW, CF10 2LE, CF10 2SJ, CF10 2SL",233,213,20
W00010148,CF1,"CF1 7HW, CF11 7FD, CF11 7PD",160,143,17
W00010147,CF1,"CF1 5ED, CF1 5EX, CF10 4AA, CF10 4AU, CF10 4DJ, CF10 4DQ, CF10 4JY, CF10 4NF, CF10 4NH, CF10 4NJ, CF10 4NS, CF10 4QQ, CF10 4XX",231,208,23
W00010184,CF1,"CF1 5BJ, CF1 5BL, CF1 5BN, CF1 5BS, CF1 5BT, CF1 5EN, CF1 5EP, CF1 5EQ, CF1 5ER, CF1 5SU, CF1 5XA, CF1 5XD, CF1 5XE, CF1 5XG, CF1 5XJ, CF1 5XQ, CF1 5XR, CF1 5XU, CF1 5XW, CF1 5XX, CF1 5XZ, CF1 5YA, CF1 5YD, CF1 5YE, CF1 5YF, CF1 5YH, CF1 5YJ, CF1 5YL, CF1 5YN, CF1 5YP, CF1 5YQ, CF1 5YR, CF1 5YS, CF1 5YT, CF1 5YW, CF1 5YX, CF1 5YZ, CF1 6TN, CF10 4AB, CF10 4BN, CF10 4BT, CF10 4DN, CF10 4NN",278,252,26
W00010575,CF1,"CF1 6XE, CF1 6YY, CF1 6ZD, CF5 6FZ, CF5 6SG, CF5 6SH, CF5 6SL, CF5 6SN, CF5 6SP, CF5 6SQ, CF5 6ST, CF5 6SX, CF5 6SY, CF5 6TA, CF5 6TN, CF5 6TR, CF5 6TU, CF5 6TW, CF5 6TX",326,283,43
W00010140,CF1,"CF1 8TU, CF1 8UN, CF1 8UP, CF11 8BF, CF11 8DQ, CF11 8DT, CF11 8DU, CF11 8DW, CF11 8DX, CF11 8DY, CF11 8DZ, CF11 8SU",451,346,105
W00009599,CF1,"CF1 8LT, CF1 8LU, CF1 9AD, CF1 9AE, CF1 9RB, CF1 9RF, CF1 9RH, CF1 9SD, CF1 9SF, CF1 9SG, CF1 9XA, CF1 9XE, CF1 9XG, CF1 9XN, CF1 9XZ, CF11 6BY, CF11 6LF, CF11 6LT, CF11 6LU, CF11 6LW, CF11 6LX, CF11 6LZ, CF11 9AD, CF11 9AE, CF11 9BJ, CF11 9FH, CF11 9RF, CF11 9RR, CF11 9RZ, CF11 9SG, CF11 9YF",320,278,42
W00009598,CF1,"CF1 9AH, CF1 9AJ, CF1 9BH, CF1 9SH, CF11 6BG, CF11 6BJ, CF11 6FW, CF11 6FZ, CF11 9AS, CF11 9BA, CF11 9BG, CF11 9BH",433,412,21
W00010139,CF1,"CF1 5LP, CF1 5TR, CF1 5TT, CF10 4HA, CF10 4LS, CF10 4NQ, CF10 4PJ, CF10 4RF, CF10 4RG, CF10 4TE",296,262,34
W00009566,CF1,"CF1 8JX, CF1 8LD, CF1 8LP, CF1 8LR, CF1 8UX, CF1 8UZ, CF1 8WA, CF1 8WB, CF1 9AF, CF1 9RJ, CF1 9TZ, CF11 6EQ, CF11 6ER, CF11 6JX, CF11 6LB, CF11 6LE, CF11 6WP",407,376,31
W00009567,CF1,"CF1 8DY, CF1 8EE, CF1 8HB, CF1 8JD, CF1 8JN, CF1 8XA, CF1 8XG, CF1 8XN, CF1 8XZ, CF1 8YA, CF1 8YB, CF1 8YE, CF1 8YF, CF1 8YG, CF1 8YH, CF1 8YJ, CF1 8YL, CF1 8YN, CF1 8YP, CF1 8YQ, CF1 8YW, CF1 8YY, CF11 6HE, CF11 6HU, CF11 6HY, CF11 6JE, CF11 6JN",263,238,25
W00010141,CF1,"CF1 1AD, CF1 1DA, CF1 1DB, CF1 1DD, CF1 1DE, CF1 1DF, CF1 1DG, CF1 1DH, CF1 1DJ, CF1 1DL, CF1 1DN, CF1 1EA, CF1 1EB, CF1 1EH, CF1 1EJ, CF1 1EN, CF1 1ER, CF1 1ES, CF1 1EU, CF1 1GP, CF1 1HA, CF1 1HB, CF1 1HD, CF1 1HE, CF1 1HF, CF1 1HH, CF1 1HL, CF1 1HN, CF1 1JA, CF1 1JB, CF1 1JD, CF1 1JE, CF1 1JF, CF1 1JG, CF1 1JL, CF1 1JN, CF1 1JP, CF1 1JR, CF1 1JS, CF1 1JX, CF1 1JY, CF1 1JZ, CF1 1LD, CF1 1LL, CF1 1LN, CF1 1LQ, CF1 1LT, CF1 1NB, CF1 1NG, CF1 1NJ, CF1 1NN, CF1 1NR, CF1 1NS, CF1 1NT, CF1 1NX, CF1 1PD, CF1 1PE, CF1 1PG, CF1 1PJ, CF1 1PL, CF1 1PS, CF1 1PY, CF1 1QA, CF1 1QD, CF1 1SU, CF1 1TB, CF1 1TD, CF1 1TE, CF1 1TF, CF1 1TH, CF1 1TL, CF1 1TX, CF1 1UA, CF1 1UB, CF1 1UH, CF1 1UL, CF1 1UN, CF1 1UP, CF1 1UT, CF1 1UU, CF1 1UW, CF1 1UX, CF1 1WH, CF1 1XB, CF1 1XD, CF1 1XE, CF1 1XF, CF1 1XH, CF1 1XJ, CF1 1XQ, CF1 1XS, CF1 1XT, CF1 1YD, CF1 1YH, CF1 1YJ, CF1 1YP, CF1 2BL, CF1 2BR, CF1 2BW, CF1 2PH, CF1 2QE, CF1 2QZ, CF1 2XA, CF1 2XB, CF1 2XF, CF1 2XN, CF1 2XX, CF1 3QW, CF1 9SX, CF1 9XW, CF10 1BJ, CF10 1DA, CF10 1DB, CF10 1DE, CF10 1DF, CF10 1DG, CF10 1DH, CF10 1DJ, CF10 1DL, CF10 1DN, CF10 1EE, CF10 1ER, CF10 1ES, CF10 1ET, CF10 1EY, CF10 1JA, CF10 1LA, CF10 1NS, CF10 1NT, CF10 1NW, CF10 1PG, CF10 1UB, CF10 1UD, CF10 1UE, CF10 1XD, CF10 1XR, CF10 1XX, CF10 1XZ, CF10 1YW, CF10 2XB, CF11 9SX",171,153,18
W00010580,CF1,"CF1 2UL, CF1 5AZ, CF1 5BG, CF1 5BP, CF10 4AH, CF10 4AJ, CF10 4AY, CF10 4AZ, CF10 4BG, CF10 4BQ, CF10 4BZ, CF10 4DW, CF10 4DZ, CF10 4PP, CF10 4PS, CF10 4RT, CF10 4TP",615,537,78
W00010170,CF1,"CF1 7EJ, CF1 7HZ, CF11 7EF, CF11 7EH",193,175,18
W00010168,CF1,"CF1 7EF, CF1 7EH, CF11 7JT, CF11 7JU",240,216,24
W00010585,CF1,"CF1 8BS, CF1 8BU, CF1 8DG, CF1 8UL, CF11 8FS, CF11 8PL",263,218,45
W00009557,CF1,"CF1 8LL, CF11 6AG, CF11 6AQ, CF11 6AS, CF11 6AT, CF11 6AU, CF11 6BE, CF11 6LH, CF11 6NB",407,380,27
W00009558,CF1,"CF1 9DZ, CF1 9EA, CF1 9NS, CF11 9DP, CF11 9DS, CF11 9DY, CF11 9DZ, CF11 9FE, CF11 9NA, CF11 9NJ, CF11 9NY, CF11 9NZ, CF11 9XH",305,236,69
W00010201,CF1,"CF1 6JG, CF1 6TU, CF10 5NF, CF10 5NG, CF10 5NJ, CF10 5ZN",233,210,23
W00010200,CF1,"CF1 6UF, CF1 6UW, CF10 5NR, CF10 5NS",247,231,16
W00010198,CF1,"CF1 5SS, CF1 6PE, CF10 4DA, CF10 4DB, CF10 4DD, CF10 4EX, CF10 5AP, CF10 5HP, CF10 5LF, CF10 5LS",266,251,15
W00009559,CF1,"CF1 8DN, CF1 8DT, CF1 8DU, CF1 8DW, CF1 8DX, CF1 8DZ, CF1 8EA, CF1 8HU, CF1 8JH, CF1 9AU, CF1 9AW, CF1 9BB, CF1 9BG, CF11 6DB, CF11 6DT, CF11 6JH, CF11 6JP, CF11 6JQ",373,332,41
W00010195,CF1,"CF1 6PR, CF10 4AD, CF10 4AE, CF10 4AF, CF10 4AQ, CF10 4AT",155,131,24
W00009560,CF1,"CF1 8LF, CF1 8LQ, CF1 8LS, CF1 8LX, CF1 9DR, CF1 9TA, CF1 9TL, CF11 6LD, CF11 6LP, CF11 6LR, CF11 6UX, CF11 9AF",420,384,36
W00009561,CF1,"CF1 8HS, CF1 8HT, CF1 8JF, CF1 8JG, CF1 8JJ, CF1 8JP, CF1 8JQ, CF1 8JR, CF1 8XR, CF1 8XU, CF1 8XW, CF1 8YD, CF1 8YR, CF1 9AR, CF1 9AS, CF1 9AT, CF1 9BA, CF11 6FU, CF11 6HS, CF11 6HT, CF11 6JF, CF11 6JG, CF11 6JJ, CF11 6NY, CF11 8HA, CF11 8HG, CF11 8HH, CF11 9AN, CF11 9AR, CF11 9AT, CF11 9TB, CF11 9TQ",336,295,41
W00009726,CF1,"CF1 1RH, CF14 1LQ, CF14 1LU, CF14 1LW, CF14 1NB, CF14 1NH, CF14 1PA, CF14 1PB, CF14 1PD, CF14 1PE, CF14 1PG, CF14 1PH, CF14 2DX, CF14 2DZ, CF14 2EB, CF4 1AA, CF4 1DA, CF4 1DB, CF4 1LQ, CF4 1LU, CF4 1LW, CF4 1NL, CF4 1NN, CF4 1XA, CF4 1XQ, CF4 2DX, CF4 2DZ",328,225,103
W00010191,CF1,"CF1 5BH, CF1 5SX, CF10 4AG, CF10 4AN, CF10 4AR, CF10 4AS, CF10 4BY, CF10 4LG, CF10 4QG, CF10 4QL, CF10 4SD, CF10 4TL, CF10 4UP, CF10 4WW, CF10 4YY",185,168,17
W00009562,CF1,"CF1 9AG, CF1 9BE, CF1 9TY, CF11 6FX, CF11 6FY, CF11 6JY, CF11 6LA, CF11 9AG, CF11 9BD, CF11 9BL, CF11 9BN, CF11 9SH",302,282,20
W00008814,CF1,"CF1 5ES, CF1 5ET, CF1 5HF, CF1 5HG, CF1 5HH, CF1 5HN, CF1 5HS, CF1 5QD, CF1 5RG, CF1 5ST, CF1 5SY, CF1 5SZ, CF10 5HE, CF10 5HG, CF10 5HL, CF10 5HN, CF10 5HU, CF10 5HW, CF10 5HZ",488,459,29
W00010173,CF1,"CF1 7HQ, CF1 7JD, CF1 7JG, CF1 7JH, CF1 7JJ, CF1 7JL, CF1 7QD, CF1 7QE, CF1 7QF, CF1 7RL, CF1 7RP, CF1 7RQ, CF1 7TR, CF1 7TS, CF1 7TX, CF1 7TY, CF1 7UG, CF1 7UH, CF1 7UJ, CF1 7UQ, CF1 7UZ, CF1 7XR, CF11 0AA, CF11 0AB, CF11 0AD, CF11 0AE, CF11 0AF, CF11 0AG, CF11 0AH, CF11 0AJ, CF11 0AR, CF11 0BB, CF11 0JR, CF11 0SR, CF11 0XR, CF11 7FF, CF11 7JH, CF11 7JW, CF11 8EE, CF11 8QF, CF11 8RQ, CF11 8TS, CF11 8TT, CF11 8TX, CF11 8UP, CF11 8UT, CF11 8UU, CF11 8YN, CF11 8YT",252,225,27
W00009563,CF1,"CF1 8LJ, CF1 8LN, CF1 8LY, CF1 8LZ, CF1 8PA, CF1 9AA, CF1 9AB, CF1 9AZ, CF1 9BJ, CF1 9SR, CF1 9SS, CF1 9ST, CF1 9TH, CF1 9TR, CF1 9TU, CF1 9XJ, CF11 6LG, CF11 6LJ, CF11 6LL, CF11 6LN, CF11 6LY, CF11 9AA, CF11 9AB, CF11 9AQ, CF11 9AU, CF11 9BB, CF11 9RP, CF11 9SR, CF11 9SS, CF11 9ST, CF11 9TT, CF24 4XG",279,260,19
W00009568,CF1,"CF1 8LG, CF1 8LH, CF1 8LW, CF1 8RG, CF1 8SY, CF11 6AY, CF11 6BD, CF11 6EN, CF11 6EP, CF11 6LQ, CF11 6LS",376,346,30
W00010584,CF1,"CF1 1QY, CF1 1QZ, CF1 1RN, CF1 1XA, CF1 1XL, CF1 1XP, CF1 1XR, CF1 1XU, CF1 1XY, CF1 1YT, CF1 1YY, CF1 1ZD, CF1 1ZE, CF1 1ZF, CF1 1ZG, CF1 1ZH, CF1 1ZJ, CF1 1ZL, CF1 1ZN, CF1 1ZP, CF1 1ZQ, CF1 1ZR, CF1 1ZS, CF1 1ZT, CF1 1ZU, CF1 1ZW, CF1 1ZX, CF1 1ZY, CF1 1ZZ, CF1 2AW, CF1 2AY, CF1 2AZ, CF1 2BA, CF1 2BB, CF1 2BD, CF1 2BE, CF1 2BN, CF1 2BP, CF1 2BS, CF1 2BT, CF1 2DA, CF1 2DG, CF1 2DH, CF1 2DL, CF1 2PE, CF1 2PG, CF1 2PW, CF1 2PX, CF1 2PY, CF1 2PZ, CF1 2QA, CF1 2QB, CF1 2QD, CF1 2QF, CF1 2QJ, CF1 2QL, CF1 2QN, CF1 2QQ, CF1 2QR, CF1 2QS, CF1 2QW, CF1 2RA, CF1 2RB, CF1 2RE, CF1 2RG, CF1 2RJ, CF1 2RP, CF1 2RQ, CF1 2RS, CF1 2RW, CF1 2RX, CF1 2SA, CF1 2SB, CF1 2SD, CF1 2SH, CF1 2UA, CF1 2UB, CF1 2UD, CF1 2UG, CF1 2XE, CF1 2XP, CF1 3AA, CF1 3AD, CF1 3AE, CF1 3AF, CF1 3AG, CF1 3AH, CF1 3AP, CF1 3AQ, CF1 3AR, CF1 3AS, CF1 3AT, CF1 3BA, CF1 3BD, CF1 3BE, CF1 3BG, CF1 3BH, CF1 3BJ, CF1 3BL, CF1 3BN, CF1 3BQ, CF1 3BT, CF1 3DY, CF1 3EA, CF1 3EB, CF1 3HA, CF1 3JA, CF1 3JB, CF1 3JD, CF1 3JF, CF1 3JG, CF1 3JH, CF1 3JN, CF1 3JP, CF1 3JQ, CF1 3JR, CF1 3JS, CF1 3JU, CF1 3JW, CF1 3JY, CF1 3LB, CF1 3LE, CF1 3LH, CF1 3LP, CF1 3LQ, CF1 3LR, CF1 3LU, CF1 3LY, CF1 3LZ, CF1 3NA, CF1 3NB, CF1 3ND, CF1 3NE, CF1 3NF, CF1 3NH, CF1 3NJ, CF1 3NL, CF1 3NN, CF1 3NP, CF1 3NQ, CF1 3NS, CF1 3NU, CF1 3NW, CF1 3NX, CF1 3NY, CF1 3NZ, CF1 3PA, CF1 3PB, CF1 3PF, CF1 3PG, CF1 3PJ, CF1 3PL, CF1 3PN, CF1 3PP, CF1 3PQ, CF1 3PR, CF1 3PS, CF1 3PU, CF1 3PW, CF1 3PX, CF1 3PY, CF1 3QA, CF1 3QB, CF1 3QD, CF1 3QE, CF1 3QF, CF1 3QG, CF1 3QH, CF1 3QJ, CF1 3QL, CF1 3QN, CF1 3QP, CF1 3QQ, CF1 3QS, CF1 3QU, CF1 3QX, CF1 3QY, CF1 3RA, CF1 3RB, CF1 3RG, CF1 3RL, CF1 3RP, CF1 3RQ, CF1 3RR, CF1 3RW, CF1 3RX, CF1 3SA, CF1 3SH, CF1 3TN, CF1 3TR, CF1 3TX, CF1 3TZ, CF1 3UD, CF1 3UN, CF1 3UP, CF1 3UQ, CF1 3XA, CF1 3XB, CF1 3XD, CF1 3XE, CF1 3XF, CF1 3XG, CF1 3XH, CF1 3XN, CF1 3XP, CF1 3XQ, CF1 3XR, CF1 3XS, CF1 3XT, CF1 3XU, CF1 3XW, CF1 3XX, CF1 3XY, CF1 3XZ, CF1 3YB, CF1 3YD, CF1 3YE, CF1 3YF, CF1 3YG, CF1 3YH, CF1 3YJ, CF1 3YL, CF1 3YN, CF1 3YP, CF1 3YQ, CF1 3YX, CF1 4AD, CF1 4AE, CF1 4BA, CF1 4BD, CF1 4BU, CF1 4JE, CF1 4JG, CF1 4JJ, CF1 4JQ, CF1 4JR, CF1 4JS, CF1 4JT, CF1 4JU, CF1 4JX, CF1 4JY, CF1 4LA, CF1 4LB, CF1 4LD, CF1 4LE, CF1 4LF, CF1 4LG, CF1 4LL, CF1 4LN, CF1 4LP, CF1 4LQ, CF1 4LS, CF1 4NZ, CF1 4PQ, CF1 4PR, CF1 4QB, CF1 4QQ, CF1 4QS, CF1 4QT, CF1 4QU, CF1 4QY, CF1 4RB, CF1 4RJ, CF1 4ST, CF1 4TB, CF1 4UW, CF1 4YA, CF1 4YB, CF1 4YD, CF1 4YE, CF1 4YF, CF1 4YG, CF1 4YH, CF1 4YJ, CF1 4YL, CF1 4YN, CF1 4YP, CF1 4YU, CF1 6TR, CF10 1AR, CF10 1AS, CF10 1AW, CF10 1AX, CF10 1AY, CF10 1AZ, CF10 1BA, CF10 1BB, CF10 1BD, CF10 1BE, CF10 1BG, CF10 1BR, CF10 1BS, CF10 1BT, CF10 1BU, CF10 1BW, CF10 1BX, CF10 1BY, CF10 1DD, CF10 1DP, CF10 1EA, CF10 1GL, CF10 1PT, CF10 1PU, CF10 1PX, CF10 1PY, CF10 1PZ, CF10 1QR, CF10 1RG, CF10 1RJ, CF10 1SX, CF10 1SZ, CF10 1UL, CF10 2AE, CF10 2AF, CF10 2AG, CF10 2AH, CF10 2AP, CF10 2AQ, CF10 2AR, CF10 2AS, CF10 2NG, CF10 2PB, CF10 2UD, CF10 3AA, CF10 3AE, CF10 3AF, CF10 3AG, CF10 3AH, CF10 3AJ, CF10 3AN, CF10 3AP, CF10 3AQ, CF10 3AS, CF10 3AT, CF10 3AU, CF10 3AX, CF10 3AZ, CF10 3BA, CF10 3BB, CF10 3BD, CF10 3BE, CF10 3BG, CF10 3BH, CF10 3BJ, CF10 3BL, CF10 3BN, CF10 3BP, CF10 3BS, CF10 3DA, CF10 3DB, CF10 3DG, CF10 3DQ, CF10 3DS, CF10 3EA, CF10 3ER, CF10 3ES, CF10 3ET, CF10 3EW, CF10 3FA, CF10 3FB, CF10 3FD, CF10 3FE, CF10 3FF, CF10 3FG, CF10 3HE, CF10 3HH, CF10 3HJ, CF10 3HX, CF10 3JF, CF10 3JJ, CF10 3JN, CF10 3JR, CF10 3LU, CF10 3NB, CF10 3ND, CF10 3NE, CF10 3NH, CF10 3NL, CF10 3NN, CF10 3NP, CF10 3NQ, CF10 3NS, CF10 3NW, CF10 3NX, CF10 3NY, CF10 3NZ, CF10 3PA, CF10 3PD, CF10 3PG, CF10 3PL, CF10 3PN, CF10 3PW, CF10 3QA, CF10 3QB, CF10 3QE, CF10 3QG, CF10 3QH, CF10 3QU, CF10 3RA, CF10 3RB, CF10 3RL, CF10 3RQ, CF10 3SE, CF10 3TN, CF10 3TQ, CF10 3TW, CF10 3UB, CF10 3UH, CF10 3UZ, CF10 3WA, CF10 3WG, CF10 3WL, CF10 3WT, CF10 3WU, CF10 3XG, CF10 3YB, CF10 3ZZ, CF2 4AH, CF2 4AW, CF2 4AY, CF2 4AZ",331,309,22
W00010131,CF1,"CF1 1SL, CF1 1WP, CF1 2EG, CF1 2EJ, CF1 2TL, CF1 4DZ, CF1 4EU, CF1 4EW, CF1 4EY, CF1 4HA, CF1 4HJ, CF1 4HL, CF1 4HQ, CF1 4HX, CF1 4UR, CF1 4US, CF10 2ED, CF10 2EE, CF10 2EP, CF10 2EQ, CF10 2FE, CF10 2FY, CF10 2GY, CF10 2HA, CF10 2HE, CF10 2HG, CF10 2HJ, CF10 2HL, CF10 2HR, CF10 2HS, CF10 2HT, CF10 2HU, CF10 2HW, CF10 2NB, CF10 2TH, CF10 2UA, CF10 2WT, CF95 1AA, CF95 1AB, CF95 1AD, CF95 1AE, CF95 1AF, CF95 1AG, CF95 1AS",346,334,12
W00010130,CF1,"CF1 1LB, CF1 1LG, CF1 1RT, CF1 1RU, CF1 1SR, CF1 1WE, CF1 2QG, CF1 3AB, CF1 3BU, CF1 3BW, CF1 3BY, CF1 3BZ, CF1 3DA, CF1 3DB, CF1 3DD, CF1 3DE, CF1 3DL, CF1 3DN, CF1 3DP, CF1 3DQ, CF1 3DW, CF1 3JE, CF1 3JJ, CF1 3JL, CF1 3LA, CF1 3LD, CF1 3LG, CF1 3LJ, CF1 3LL, CF1 3LN, CF1 3LT, CF1 3PD, CF1 3PE, CF1 3PH, CF1 3PZ, CF1 3QZ, CF1 3RD, CF1 3RE, CF1 3RH, CF1 3RJ, CF1 3RN, CF1 3RT, CF1 3RY, CF1 3RZ, CF1 3SB, CF1 3SD, CF1 3SG, CF1 3SJ, CF1 3SN, CF1 3SP, CF1 3SQ, CF1 3ST, CF1 3SU, CF1 3SY, CF1 3SZ, CF1 3TJ, CF1 3TP, CF1 3UA, CF1 3UB, CF1 3UE, CF1 3UF, CF1 3UG, CF1 3UJ, CF1 3UL, CF1 3UR, CF1 3US, CF1 3UT, CF1 3UU, CF1 3UW, CF1 3UX, CF1 3UY, CF1 3UZ, CF1 3WA, CF1 3WB, CF1 3WD, CF1 3WE, CF1 3WH, CF1 3WJ, CF1 3WP, CF1 3YZ, CF1 4BG, CF1 4BL, CF1 4BN, CF1 4DN, CF1 4ET, CF1 4EX, CF1 4EZ, CF1 4NL, CF1 4PA, CF1 4PE, CF1 4PF, CF1 4PJ, CF1 4PS, CF1 4PW, CF1 4QA, CF1 4SR, CF1 4UX, CF1 4UY, CF10 2AT, CF10 2AU, CF10 2AX, CF10 2BD, CF10 2BE, CF10 2BG, CF10 2BH, CF10 2BJ, CF10 2GL, CF10 2GP, CF10 2HD, CF10 2HF, CF10 2HH, CF10 2HQ, CF10 2NX, CF10 2PA, CF10 2PS, CF10 2TD, CF10 2TN, CF10 2TT, CF10 2TW, CF10 2TY, CF10 2XQ, CF10 2ZA, CF10 3AB, CF10 3AD, CF10 3AL, CF10 3AR, CF10 3AW, CF10 3AY, CF10 3BF, CF10 3BQ, CF10 3BR, CF10 3BU, CF10 3BW, CF10 3BX, CF10 3BY, CF10 3BZ, CF10 3DD, CF10 3DE, CF10 3DF, CF10 3DJ, CF10 3DL, CF10 3DN, CF10 3DP, CF10 3DR, CF10 3FN, CF10 3GA, CF10 3GE, CF10 3GL, CF10 3LN, CF10 3PE, CF10 3RE, CF10 3RJ, CF10 3RS, CF10 3RX, CF10 3SB, CF10 3SG, CF10 3SR, CF10 3SX, CF10 3UD, CF10 3UE, CF10 3UR, CF10 3ZE, CF10 3ZF, CF2 1SA, CF2 1SB, CF2 1SH, CF2 1SQ, CF2 1TT, CF2 3AF, CF24 0SH",435,403,32
W00009569,CF1,"CF1 8DP, CF1 8EB, CF1 8ED, CF1 8EG, CF1 8EY, CF1 8EZ, CF1 8GA, CF11 6DY, CF11 6ED, CF11 6EG, CF11 6EZ",295,263,32
W00009590,CF1,"CF1 9HF, CF1 9JB, CF1 9LN, CF1 9LP, CF1 9PG, CF1 9PH, CF1 9PJ, CF1 9PL, CF1 9UX, CF1 9UY, CF1 9UZ, CF1 9WA, CF1 9WB, CF1 9WD, CF1 9WE, CF1 9YS, CF11 9HF, CF11 9HG, CF11 9HH, CF11 9HP, CF11 9PG",253,178,75
W00010556,CF1,"CF1 8UJ, CF11 8FF, CF11 8GA, CF11 8GB, CF11 8GD, CF11 8GG, CF11 8GH, CF11 8GL, CF11 8GN, CF11 8PJ, CF5 1AX, CF5 1BH, CF5 1UA, CF5 1UD, CF5 1UF, CF5 1UG, CF5 1UH, CF5 1UL, CF5 1UZ, CF5 1WE, CF5 1WF, CF5 1WG, CF5 1WH, CF5 1WP, CF5 1WT, CF5 1WY, CF5 1XA, CF5 1XD, CF5 1XE, CF5 1XF, CF5 1XH, CF5 1XN, CF5 1XQ, CF5 1XR, CF5 1XS, CF5 1XT, CF5 1XW, CF5 1XZ, CF5 1YD, CF5 1YE, CF5 1YG, CF5 1YH, CF5 1YR, CF5 1YS, CF5 1YU, CF5 1ZA, CF5 1ZB, CF5 1ZD, CF5 1ZE, CF5 1ZJ, CF5 1ZQ, CF5 1ZR, CF5 1ZS, CF5 1ZU, CF5 1ZW, CF5 1ZX, CF5 2SG, CF5 2UB, CF5 2UE, CF5 2UG, CF5 2UP, CF5 2UQ, CF5 2UR, CF5 2US, CF5 2UT, CF5 2WA, CF5 2WD, CF5 2WE, CF5 2WF, CF5 2WG, CF5 2WH, CF5 2WN, CF5 2WQ, CF5 2WR, CF5 2WT, CF5 2WU, CF5 2WW, CF5 2WX, CF5 2WY, CF5 2WZ, CF5 2XA, CF5 2XB, CF5 2XD, CF5 2XF, CF5 2XG, CF5 2XT, CF5 2XZ, CF5 2YS, CF5 2YU, CF5 2ZR, CF5 3WB, CF5 3WR, CF5 3WS, CF5 3WY, CF5 3WZ, CF5 3XD, CF5 3XJ, CF5 3YA, CF5 3YB, CF5 3YD, CF5 3YE, CF5 3YF, CF5 3YJ, CF5 3YL, CF5 3YQ, CF5 3YR, CF5 3YS, CF5 3YT, CF5 3YU, CF5 3YX, CF5 3YY, CF5 4WA, CF5 4WD, CF5 4WE, CF5 4WF, CF5 4WR, CF5 4XB, CF5 4XL, CF5 4XS, CF5 4XW, CF5 4YA, CF5 4YB, CF5 4YE, CF5 4YJ, CF5 4YL, CF5 4YQ, CF5 4YT, CF5 4YU, CF5 4ZR, CF5 5WS, CF5 5WX, CF5 5XG, CF5 5XH, CF5 5XQ, CF5 5XW, CF5 5XX, CF5 5XZ, CF5 5YA, CF5 5YB, CF5 5YD, CF5 5YL, CF5 5YN, CF5 5YQ, CF5 5YZ, CF5 5ZA, CF5 5ZG, CF5 5ZP, CF5 5ZR, CF5 5ZY, CF5 6WA, CF5 6WB, CF5 6WE, CF5 6WF, CF5 6WJ, CF5 6WN, CF5 6WP, CF5 6WS, CF5 6WT, CF5 6WU, CF5 6WW, CF5 6WX, CF5 6WY, CF5 6WZ, CF5 6XS, CF5 6XT, CF5 6XU, CF5 6YF, CF5 6YH, CF5 6YL, CF5 6YP, CF5 6YU, CF5 6YW, CF5 6ZX, CF5 9AA, CF5 9AB, CF5 9AD, CF5 9AE, CF5 9AF, CF5 9AG, CF5 9AH, CF5 9AJ, CF5 9AL, CF5 9AN, CF5 9AP, CF5 9AQ, CF5 9AR, CF5 9AS, CF5 9AT, CF5 9AU, CF5 9AW, CF5 9AX, CF5 9AY, CF5 9AZ, CF5 9BA, CF5 9BB, CF5 9BD, CF5 9BE, CF5 9BF, CF5 9BG, CF5 9BH, CF5 9BJ, CF5 9BL, CF5 9BN, CF5 9BP, CF5 9BQ, CF5 9BR, CF5 9BS, CF5 9BT, CF5 9BU, CF5 9BW, CF5 9BX, CF5 9BY, CF5 9BZ, CF5 9DA, CF5 9DB, CF5 9DD, CF5 9DE, CF5 9DF, CF5 9DG, CF5 9DH, CF5 9DJ, CF5 9DL, CF5 9DN, CF5 9DP, CF5 9DQ, CF5 9DR, CF5 9DS, CF5 9DT, CF5 9DU, CF5 9DW, CF5 9DX, CF5 9DY, CF5 9DZ, CF5 9EA, CF5 9EB, CF5 9ED, CF5 9EE, CF5 9EF, CF5 9EG, CF5 9EH, CF5 9EJ, CF5 9EL, CF5 9EN, CF5 9EP, CF5 9EQ, CF5 9ER, CF5 9ES, CF5 9ET, CF5 9EU, CF5 9EW, CF5 9EX, CF5 9EY, CF5 9FA, CF5 9FB, CF5 9FD, CF5 9FE, CF5 9FF, CF5 9FG, CF5 9FH, CF5 9FJ, CF5 9FL, CF5 9FN, CF5 9FP, CF5 9FQ, CF5 9FR, CF5 9FS, CF5 9FT, CF5 9FU, CF5 9FW, CF5 9FX, CF5 9FY, CF5 9FZ, CF5 9GA, CF5 9GB, CF5 9GD, CF5 9GE, CF5 9GF, CF5 9GG, CF5 9GH, CF5 9GJ, CF5 9GL, CF5 9GN, CF5 9GP, CF5 9GQ, CF5 9GR, CF5 9GS, CF5 9GT, CF5 9GU, CF5 9GW, CF5 9GX, CF5 9GZ, CF5 9HA",204,151,53
W00010560,CF1,"CF1 8AN, CF11 8AE, CF11 8AJ, CF11 8AL, CF11 8AN",274,247,27
W00009573,CF1,"CF1 8EJ, CF1 8EL, CF1 8EN, CF1 8EP, CF1 8EQ, CF1 8ER, CF1 8LB, CF1 8SD, CF11 6EJ, CF11 6EL, CF11 6ES, CF11 6EU, CF11 6EX, CF11 6HZ",349,328,21
W00010124,CF1,"CF1 6HA, CF1 6HB, CF1 6SL, CF10 5FZ, CF10 5GA, CF10 5GB, CF10 5GE, CF10 5GG, CF10 5GQ, CF10 5HF",269,252,17
W00009589,CF1,"CF1 9DF, CF1 9EN, CF1 9EP, CF1 9ER, CF1 9HJ, CF1 9HQ, CF1 9HR, CF1 9SZ, CF1 9YN, CF11 9DH, CF11 9EN, CF11 9EP, CF11 9ER, CF11 9FD, CF11 9FT, CF11 9NP",264,206,58
W00009588,CF1,"CF1 9DT, CF1 9DU, CF1 9HA, CF1 9SB, CF1 9UA, CF1 9YA, CF1 9YE, CF1 9YQ, CF1 9YU, CF11 9AW, CF11 9AZ, CF11 9DN, CF11 9DR, CF11 9DT, CF11 9DU, CF11 9EW, CF11 9EX, CF11 9RA, CF11 9RH, CF11 9SB, CF11 9SD, CF11 9TH",305,266,39
W00009587,CF1,"CF1 9HS, CF1 9HT, CF1 9HU, CF1 9HX, CF1 9HY, CF1 9HZ, CF1 9JD, CF1 9JE, CF1 9JF, CF1 9JN, CF1 9JZ, CF1 9PN, CF1 9PP, CF1 9YW, CF1 9ZD, CF11 9HJ, CF11 9HN, CF11 9HQ, CF11 9HR, CF11 9HT, CF11 9HU, CF11 9JZ",246,182,64
W00009591,CF1,"CF1 9DB, CF1 9DD, CF1 9DE, CF1 9DG, CF1 9DN, CF1 9EF, CF1 9EG, CF1 9EJ, CF11 9EB, CF11 9EF, CF11 9EJ, CF11 9EL",299,248,51
W00009586,CF1,"CF1 9NT, CF1 9YP, CF1 9YX, CF11 9ET, CF11 9EU, CF11 9FA, CF11 9FF, CF11 9NN, CF11 9NQ, CF11 9NR, CF11 9PA, CF11 9PD, CF11 9PE, CF11 9PF, CF11 9PU, CF11 9YP",320,258,62
W00009583,CF1,"CF1 9EQ, CF1 9ES, CF1 9ET, CF1 9EU, CF1 9FR, CF1 9NU, CF1 9NW, CF1 9PA, CF1 9RQ, CF1 9UF, CF11 9EQ, CF11 9ES, CF11 9EY, CF11 9NT, CF11 9QB, CF11 9QL",315,216,99
W00009582,CF1,"CF1 9JA, CF1 9JH, CF1 9JJ, CF11 9HS, CF11 9JA, CF11 9JB, CF11 9JD, CF11 9JH, CF11 9PL, CF11 9PN",281,225,56
W00009581,CF1,"CF1 9PQ, CF1 9QA, CF1 9UP, CF1 9UW, CF11 9NW, CF11 9PQ, CF11 9PR, CF11 9PS, CF11 9PX, CF11 9QE, CF11 9QN, CF11 9SN, CF11 9UP",280,220,60
W00009580,CF1,"CF1 9LQ, CF1 9LR, CF1 9RU, CF1 9RX, CF11 9LB, CF11 9LN, CF11 9LP, CF11 9LQ, CF11 9LR, CF11 9LS, CF11 9PH, CF11 9PJ, CF11 9QH, CF11 9QP, CF11 9UY, CF11 9XR",289,241,48
W00009579,CF1,"CF1 9JG, CF1 9JX, CF1 9JY, CF1 9LA, CF11 9JY, CF11 9LA, CF11 9NU",192,163,29
W00009578,CF1,"CF1 9JR, CF1 9JU, CF11 9JG, CF11 9JP, CF11 9JR, CF11 9JU, CF11 9JW, CF11 9JX, CF11 9PP, CF11 9QJ",276,196,80
W00009577,CF1,"CF1 9JS, CF1 9JW, CF11 9JE, CF11 9JF, CF11 9JJ, CF11 9JN, CF11 9JS",247,179,68
W00009576,CF1,"CF1 9JL, CF1 9JP, CF1 9JQ, CF1 9JT, CF1 9LB, CF1 9LE, CF11 9FR, CF11 9HX, CF11 9HY, CF11 9HZ, CF11 9JL, CF11 9JQ, CF11 9JT, CF4 3AU, CF5 2AX, CF5 2AY, CF5 2YX, CF5 2YY, CF5 2YZ, CF5 2ZQ",270,232,38
W00009584,CF1,"CF1 9PY, CF1 9QE, CF11 9PW, CF11 9PY, CF11 9PZ, CF11 9QA, CF11 9QD",279,205,74
W00009630,CF1,"CF1 5SG, CF2 2BB, CF2 2BE, CF2 2BF, CF2 2BG, CF2 2BJ, CF2 2BL, CF2 2DR, CF2 2DT, CF2 2DU, CF2 2DX, CF2 2DY, CF2 2DZ, CF2 2ED, CF2 2EE, CF2 2EF, CF2 2EG, CF2 2EJ, CF2 2EL, CF2 2EQ, CF24 2BB, CF24 2BE, CF24 2BS, CF24 2DQ, CF24 2DS, CF24 2DU, CF24 2EJ, CF24 5DA, CF24 5DB, CF24 5EA, CF24 5EQ, CF24 5EZ, CF24 5FX, CF24 5JA",343,302,41
W00009592,CF1,"CF1 9HD, CF1 9HE, CF1 9RP, CF1 9SN, CF1 9SU, CF1 9SW, CF1 9UH, CF1 9XL, CF1 9XP, CF1 9XR, CF1 9YB, CF11 9AY, CF11 9BU, CF11 9FB, CF11 9HD, CF11 9HE, CF11 9HW, CF11 9LE, CF11 9LF, CF11 9LG, CF11 9LH, CF11 9LJ, CF11 9LL, CF11 9LZ, CF11 9RW, CF11 9SA, CF11 9SU, CF11 9SW, CF11 9SY, CF11 9SZ, CF11 9TD, CF11 9UQ, CF11 9WJ, CF11 9XX, CF11 9YX",283,218,65
W00009572,CF1,"CF1 1ET, CF1 8UR, CF11 6AB, CF11 6AF, CF11 6AH, CF11 6AN, CF11 6AP, CF11 6AR, CF11 6RL, CF24 4XB",336,306,30
W00009597,CF1,"CF1 5UF, CF1 9AL, CF1 9AP, CF1 9BX, CF1 9BZ, CF1 9DA, CF1 9DJ, CF1 9DW, CF1 9DX, CF1 9DY, CF1 9EB, CF1 9ED, CF1 9EE, CF1 9EH, CF1 9NA, CF1 9NB, CF1 9ND, CF1 9NE, CF1 9RY, CF1 9TB, CF1 9TD, CF1 9TE, CF1 9TN, CF1 9TP, CF1 9TQ, CF1 9TS, CF1 9TT, CF1 9TX, CF1 9UG, CF1 9XQ, CF1 9YL, CF11 9AH, CF11 9AJ, CF11 9AL, CF11 9AP, CF11 9BF, CF11 9BZ, CF11 9DA, CF11 9DW, CF11 9DX, CF11 9EE, CF11 9EH, CF11 9EZ, CF11 9ND, CF11 9NE, CF11 9TN, CF11 9TP, CF11 9TS, CF11 9UH, CF11 9YL",349,303,46
W00009596,CF1,"CF1 9BQ, CF1 9BS, CF1 9DH, CF1 9UQ, CF11 9BP, CF11 9BQ, CF11 9BX",267,191,76
W00009595,CF1,"CF1 6PN, CF1 9BL, CF1 9BP, CF1 9BR, CF1 9BT, CF1 9BU, CF1 9BW, CF1 9BY, CF1 9HB, CF1 9HP, CF1 9LJ, CF1 9LL, CF1 9RA, CF1 9RD, CF1 9RN, CF1 9RW, CF1 9RZ, CF1 9SA, CF1 9SE, CF1 9SJ, CF1 9SY, CF1 9XF, CF1 9XH, CF1 9XX, CF1 9YF, CF1 9YG, CF1 9YJ, CF11 9BR, CF11 9BS, CF11 9BT, CF11 9BW, CF11 9BY, CF11 9DJ, CF11 9ED, CF11 9FG, CF11 9FL, CF11 9FU, CF11 9GA, CF11 9GB, CF11 9HA, CF11 9HB, CF11 9NB, CF11 9TZ, CF11 9WH, CF11 9XB, CF11 9XF",351,240,111
W00009594,CF1,"CF1 9EL, CF1 9NL, CF1 9NP, CF1 9NR, CF1 9NX, CF1 9NY, CF1 9NZ, CF11 9EA, CF11 9EG, CF11 9NL, CF11 9NS, CF11 9NX",282,214,68
W00010127,CF1,"CF1 1SZ, CF1 1TW, CF1 5EU, CF1 5LT, CF1 5LW, CF1 5QG, CF1 5QP, CF1 5QY, CF1 5TA, CF1 5TF, CF1 5TG, CF1 5TH, CF1 5TL, CF1 5TQ, CF1 5TS, CF1 5UR, CF1 5UW, CF1 5YB, CF1 5YG, CF1 5YU, CF1 6AA, CF1 6AB, CF1 6AF, CF1 6AG, CF1 6AH, CF1 6AJ, CF1 6AL, CF1 6AN, CF1 6AQ, CF1 6AW, CF1 6BT, CF1 6BU, CF1 6BW, CF1 6NA, CF1 6NB, CF1 6ND, CF1 6NE, CF1 6NG, CF1 6NQ, CF1 6NR, CF1 6NZ, CF1 6PF, CF1 6PG, CF1 6RT, CF1 6TJ, CF1 6TY, CF10 4AX, CF10 4GA, CF10 4NU, CF10 4PA, CF10 4PL, CF10 4PZ, CF10 4QH, CF10 4RP, CF10 4RS, CF10 4WZ, CF10 4XT, CF10 4XU, CF10 5AA, CF10 5AB, CF10 5AD, CF10 5AF, CF10 5AG, CF10 5AH, CF10 5AJ, CF10 5AL, CF10 5AN, CF10 5AQ, CF10 5AW, CF10 5AY, CF10 5BN, CF10 5BP, CF10 5BU, CF10 5BW, CF10 5BX, CF10 5BZ, CF10 5EQ, CF10 5ER, CF10 5RT, CF10 5SA, CF10 5SB, CF10 5SD, CF10 5SE, CF10 5SF, CF10 5SG, CF10 5TE, CF10 5TN, CF10 5TW, CF10 5UB, CF2 2TP, CF2 2TR, CF2 2TS, CF2 2TY, CF2 2TZ, CF2 2UA, CF2 2UB, CF2 2UD, CF2 2UE, CF2 2UP, CF2 2UR, CF2 2WA, CF24 5UP, CF99 1NA, CF99 1SN",250,207,43
W00005835,CF1,"CF1 5QF, CF11 8JQ, CF11 8TQ, CF11 8TW, CF11 8UQ, CF11 8UW, CF6 1NB, CF6 1ND, CF6 1NF, CF6 1NG, CF6 1PR, CF6 1PT, CF6 1PU, CF6 1PW, CF6 1PX, CF6 1PY, CF64 1ND, CF64 1PT, CF64 2NB, CF64 2NF, CF64 2NP, CF64 2NQ, CF64 2PP, CF64 2PR, CF64 2PU, CF64 2PW, CF64 2PX, CF64 2PY",232,212,20
W00010600,CF1,"CF1 8DH, CF1 8DJ, CF1 8TX, CF1 8UH, CF1 8XD, CF11 8DH, CF11 8FB, CF11 8FW, CF11 8GF, CF5 1WB",269,212,57
W00010519,CF1,"CF1 2FL, CF1 2FN, CF1 2FU, CF1 2UR, CF2 1EU, CF2 1EW, CF2 1NA, CF2 1NB, CF24 0NB, CF24 2FL, CF24 2FU",612,558,54
W00009593,CF1,"CF1 9DL, CF1 9DS, CF1 9HG, CF1 9HH, CF1 9HL, CF1 9HN, CF1 9HW, CF1 9SL, CF1 9UE, CF1 9UJ, CF1 9UL, CF1 9UN, CF1 9UR, CF1 9US, CF1 9UT, CF1 9UU, CF1 9XB, CF1 9XD, CF1 9XS, CF1 9XT, CF1 9XU, CF1 9XY, CF1 9YD, CF1 9YH, CF1 9YR, CF1 9YT, CF1 9YY, CF1 9YZ, CF11 9DB, CF11 9DD, CF11 9DE, CF11 9LD, CF11 9UR, CF11 9UT, CF11 9UW, CF11 9XW, CF11 9XZ, CF11 9ZR",245,187,58
W00009570,CF1,"CF1 8RQ, CF1 8RR, CF1 8RT, CF1 8RU, CF1 8RW, CF1 8RX, CF1 8RY, CF1 8SA, CF1 8SB, CF1 8SR, CF1 8UT, CF11 6AE, CF11 6AJ, CF11 6AL, CF11 6AW, CF11 6AX, CF11 6BA, CF11 6BB",421,395,26
W00009571,CF1,"CF1 8EF, CF1 8EH, CF1 8HX, CF11 6EB, CF11 6EE, CF11 6EF, CF11 6FA, CF11 6HX, CF11 6JD, CF11 6JL",344,316,28
W00010612,CF1,"CF1 8BT, CF1 8TP, CF1 8UQ, CF1 8XQ, CF11 8DG, CF11 8DJ, CF11 8FA, CF11 8FD, CF11 8FN, CF11 8FT, CF11 8PN",216,158,58
W00010635,CF1,"CF1 1SY, CF1 5HL, CF1 5HW, CF1 5HX, CF1 5HY, CF1 5HZ, CF1 6UR, CF10 5HJ, CF10 5HX, CF10 5TX",193,179,14
W00010633,CF1,"CF1 3BB, CF2 4DB, CF2 4DP, CF2 4DR, CF2 4ED, CF24 4BJ, CF24 4EA, CF24 4EB, CF24 4FX",481,458,23
W00010630,CF1,"CF1 1XG, CF11 6WA, CF2 3BX, CF2 3JD, CF2 3JJ, CF2 3LH, CF2 3UX, CF2 3UZ, CF2 3WA, CF2 3WB, CF2 3WE, CF2 3WF, CF2 3WG, CF2 3WH, CF2 3WJ, CF2 3WL, CF2 3WN, CF2 3XL, CF2 3XP, CF2 3XY, CF2 3XZ, CF2 3YD, CF2 3YE, CF2 3YG, CF2 4RJ, CF2 4RU, CF24 3BS, CF24 3BT, CF24 3BX, CF24 3EU, CF24 3JA, CF24 3UX, CF24 3UZ",512,469,43
W00010537,CF1,"CF1 5BA, CF1 5BB, CF1 5BD, CF1 5BE, CF1 5EG, CF1 5EW, CF1 5LN, CF1 5QW, CF10 4AL, CF10 4AP, CF10 4BA, CF10 4BB, CF10 4BE, CF10 4BF, CF10 4BP, CF10 4DX, CF10 4DY, CF10 4EP, CF10 4EY, CF10 4HB, CF10 4HD, CF10 4HE, CF10 4HF, CF10 4HG, CF10 4SF, CF10 4TT, CF24 5JP, CF24 5NG",214,205,9
W00010541,CF1,"CF1 1SQ, CF1 1TG, CF1 1TR, CF1 1UQ, CF1 1WZ, CF1 1YB, CF1 1YF, CF1 1YL, CF1 4SP, CF1 5AA, CF1 5AB, CF1 5AD, CF1 5AE, CF1 5AF, CF1 5AG, CF1 5AH, CF1 5AJ, CF1 5AL, CF1 5AN, CF1 5AP, CF1 5AQ, CF1 5AR, CF1 5AS, CF1 5AT, CF1 5AU, CF1 5AW, CF1 5AX, CF1 5AY, CF1 5BQ, CF1 5BR, CF1 5DB, CF1 5DD, CF1 5DE, CF1 5DF, CF1 5DG, CF1 5DH, CF1 5DJ, CF1 5DL, CF1 5DN, CF1 5DP, CF1 5DQ, CF1 5DR, CF1 5DS, CF1 5DT, CF1 5DU, CF1 5DW, CF1 5DX, CF1 5DY, CF1 5DZ, CF1 5HA, CF1 5HB, CF1 5HE, CF1 5HJ, CF1 5HT, CF1 5QA, CF1 5QN, CF1 5QQ, CF1 5QR, CF1 5QZ, CF1 5RA, CF1 5RD, CF1 5RE, CF1 5RJ, CF1 5RL, CF1 5RN, CF1 5RS, CF1 5RT, CF1 5RU, CF1 5RW, CF1 5RX, CF1 5RY, CF1 5TP, CF1 5TW, CF1 5TX, CF1 6JE, CF1 6TX, CF1 6TZ, CF1 6UL, CF1 6UN, CF1 7NF, CF1 7NG, CF1 7NY, CF10 1TP, CF10 1TR, CF10 4DG, CF10 5AT, CF10 5AZ, CF10 5BA, CF10 5BF, CF10 5BH, CF10 5BT, CF10 5DA, CF10 5DB, CF10 5DD, CF10 5DE, CF10 5DF, CF10 5DG, CF10 5DH, CF10 5DJ, CF10 5DL, CF10 5DN, CF10 5DQ, CF10 5DR, CF10 5DS, CF10 5DT, CF10 5DU, CF10 5DW, CF10 5DX, CF10 5DY, CF10 5EG, CF10 5EH, CF10 5EJ, CF10 5FX, CF10 5GP, CF10 5HA, CF10 5HB, CF10 5HH, CF10 5HT, CF10 5JQ, CF10 5JZ, CF10 5NB, CF10 5ND, CF10 5PD, CF10 5PE, CF10 5PP, CF10 5PQ, CF10 5RA, CF10 5RD, CF10 5RF, CF10 5RJ, CF10 5RS, CF10 5RY, CF10 5SP, CF10 5TG, CF10 5TR, CF10 5TY, CF10 5XL, CF10 5ZA",793,745,48
W00010542,CF1,"CF1 5UX, CF1 5UY, CF1 5UZ, CF1 5WA, CF1 5WB, CF1 5WD, CF1 5WE, CF1 5WF, CF1 5WG, CF1 5WH, CF1 5WJ, CF1 5WL, CF1 5WN, CF1 5WP, CF1 5WQ, CF1 5WR, CF1 5WS, CF2 2HA, CF2 2HB, CF2 2HD, CF2 2HE, CF2 2HF, CF2 2HG, CF2 2HH, CF2 2HJ, CF2 2RX, CF2 2SN, CF2 2TH, CF2 2XA, CF2 2XD, CF2 2XE, CF2 2XG, CF2 2XH, CF2 2XJ, CF2 2XQ, CF2 2YR, CF2 2YS, CF24 2PQ, CF24 2RX, CF24 5HD, CF24 5HJ, CF24 5PH, CF24 5SB, CF24 5SD, CF24 5UX, CF24 5WE, CF24 5XD, CF24 5XQ, CF24 5YH, CF24 5YL, CF24 5ZH, CF24 5ZY",174,169,5
W00010639,CF1,"CF1 2FY, CF10 2EY, CF10 2EZ, CF2 1EY, CF2 1EZ, CF2 1FL, CF2 1FP, CF24 2FT, CF24 2FY",338,318,20
W00010208,CF1,"CF1 1DW, CF1 1EL, CF1 1EP, CF1 1EQ, CF1 1EW, CF1 1EX, CF1 1EY, CF1 1EZ, CF1 1FA, CF1 1FB, CF1 1FD, CF1 1FE, CF1 1FF, CF1 1FG, CF1 1FH, CF1 1FJ, CF1 1FL, CF1 1FN, CF1 1GR, CF1 1JJ, CF1 1JW, CF1 1LW, CF1 1LX, CF1 1LY, CF1 1NF, CF1 1NH, CF1 1NL, CF1 1NQ, CF1 1NW, CF1 1PF, CF1 1PN, CF1 1PP, CF1 1PR, CF1 1PT, CF1 1PX, CF1 1QE, CF1 1QT, CF1 1TA, CF1 1TS, CF1 1TZ, CF1 1UG, CF1 1UJ, CF1 1WB, CF1 1WF, CF1 1WQ, CF1 1WR, CF1 1WT, CF1 1WX, CF1 1WY, CF1 2AD, CF1 2AE, CF1 2AF, CF1 2AJ, CF1 2AP, CF1 2DT, CF1 2DU, CF1 2EB, CF1 2ED, CF1 2EF, CF1 2EH, CF1 2EQ, CF1 2FA, CF1 2FB, CF1 2FD, CF1 2FE, CF1 2GH, CF1 2GJ, CF1 2GS, CF1 2PF, CF1 2PR, CF1 2ST, CF1 2SZ, CF1 2TA, CF1 2TE, CF1 2TQ, CF1 2UW, CF1 2UY, CF1 5DA, CF1 6NU, CF10 1AD, CF10 1AE, CF10 1AJ, CF10 1AP, CF10 1DW, CF10 1EG, CF10 1EL, CF10 1EN, CF10 1EP, CF10 1EQ, CF10 1EW, CF10 1EX, CF10 1EZ, CF10 1FA, CF10 1FD, CF10 1FE, CF10 1FF, CF10 1FG, CF10 1FH, CF10 1FJ, CF10 1FL, CF10 1FN, CF10 1FP, CF10 1FQ, CF10 1FS, CF10 1FT, CF10 1GD, CF10 1GH, CF10 1GR, CF10 1JJ, CF10 1LL, CF10 1NG, CF10 1NL, CF10 1NQ, CF10 1PF, CF10 1PH, CF10 1PN, CF10 1PP, CF10 1PR, CF10 1PS, CF10 1PW, CF10 1RF, CF10 1RH, CF10 1SA, CF10 1SJ, CF10 1TL, CF10 1TZ, CF10 2EN, CF10 2FB, CF10 2FL, CF10 2FP, CF10 2FQ, CF10 2JH, CF10 2XA, CF24 3UJ",191,178,13
W00010121,CF1,"CF1 1DP, CF1 1DU, CF1 1DX, CF1 1DY, CF1 1DZ, CF1 1ED, CF1 1JT, CF1 1LF, CF1 1LH, CF1 1LJ, CF1 1LP, CF1 1LS, CF1 1ND, CF1 1NP, CF1 1PA, CF1 1PZ, CF1 1QF, CF1 1QL, CF1 1QN, CF1 1QP, CF1 1QQ, CF1 1QS, CF1 1QX, CF1 1RG, CF1 1SH, CF1 1TT, CF1 2AA, CF1 2AB, CF1 2AG, CF1 2AH, CF1 2AL, CF1 2AN, CF1 2AT, CF1 2AU, CF1 2AX, CF1 2BG, CF1 2BH, CF1 2BJ, CF1 2BU, CF1 2BX, CF1 2BY, CF1 2BZ, CF1 2DQ, CF1 2PA, CF1 2PD, CF1 2PL, CF1 2PN, CF1 2PQ, CF1 2PS, CF1 2PT, CF1 2PU, CF1 2QU, CF1 2QX, CF1 2RR, CF1 2SN, CF1 2SS, CF1 2YA, CF1 2YD, CF1 2YF, CF1 2YG, CF1 2YL, CF1 2YN, CF1 2YP, CF1 2YR, CF1 2YS, CF1 2ZD, CF1 4JD, CF1 4UA, CF1 4UB, CF1 5RH, CF10 1AA, CF10 1AB, CF10 1AF, CF10 1AG, CF10 1AH, CF10 1AL, CF10 1AN, CF10 1AT, CF10 1AU, CF10 1BH, CF10 1DX, CF10 1DY, CF10 1DZ, CF10 1EB, CF10 1ED, CF10 1EH, CF10 1EU, CF10 1FR, CF10 1GB, CF10 1GE, CF10 1GS, CF10 1JD, CF10 1JE, CF10 1LF, CF10 1NA, CF10 1NX, CF10 1PA, CF10 1PD, CF10 1PL, CF10 1QX, CF10 1RE, CF10 1RU, CF10 1SF, CF10 1TD, CF10 1TE, CF10 1TT, CF10 1UG, CF10 1UN, CF10 1UU, CF10 1WA, CF10 1WB, CF10 1WD, CF10 1WE, CF10 1WF, CF10 1WQ, CF10 1WW, CF10 1WX, CF10 1XA, CF10 1XE, CF10 1XU, CF10 1XY, CF10 1YB, CF10 1YE",180,167,13
W00009575,CF1,"CF1 7QL, CF1 7QN, CF1 8RA, CF1 8RB, CF1 8RD, CF1 8RF, CF1 8RH, CF1 8RJ, CF1 8RN, CF1 8RP, CF1 8RS, CF1 8RZ, CF1 8SE, CF1 8SF, CF1 8SS, CF11 6AA, CF11 6AD, CF11 6AZ, CF11 6BF, CF11 6BS, CF11 6QL, CF11 6QN, CF11 6UL, CF11 6WT, CF11 6WY",147,140,7
W00009053,CF1,"CF1 1UR, CF5 3AW, CF5 3AX, CF5 3BE, CF5 3XA",182,157,25
W00009090,CF1,"CF1 7BR, CF1 7BS, CF1 7DD, CF1 7DT, CF1 7DU, CF11 7DD, CF11 7DF, CF11 7DJ, CF11 7DT, CF11 7DU",370,318,52
W00009091,CF1,"CF1 7DH, CF1 7DN, CF11 7DP, CF11 7DQ, CF11 7DR, CF11 7DX, CF11 7EJ, CF11 7HE",369,351,18
W00010115,CF1,"CF1 1UY, CF10 3QN, CF2 3AH, CF2 3AJ, CF2 3AP, CF2 3AW, CF2 3TJ, CF2 4AA, CF2 4AF, CF2 4AG, CF2 4AJ, CF2 4AL, CF2 4AN, CF2 4AS, CF2 4AT, CF2 4AU, CF2 4AX, CF2 4XA, CF2 4XD, CF2 4XE, CF2 4YE, CF2 4YF, CF2 4YN, CF2 4YR, CF2 4YT, CF2 4YY, CF24 4AF, CF24 4AG, CF24 4AJ, CF24 4AY, CF24 4AZ, CF24 4BF, CF24 4DS, CF24 4SN, CF24 4XA, CF24 4YE",896,775,121
W00010118,CF1,"CF1 3ER, CF10 3EH, CF10 3EJ, CF10 3EU, CF10 3LB, CF2 4HL, CF2 4HQ",332,317,15
W00009094,CF1,"CF1 8BL, CF1 8BN, CF11 8AX, CF11 8BJ, CF11 8BL, CF11 8BN, CF11 8DN, CF11 8EJ, CF11 8NB",235,212,23
W00009095,CF1,"CF1 7NH, CF1 7PX, CF1 7PZ, CF1 7QS, CF1 7RU, CF1 7RW, CF1 7RX, CF11 6BN, CF11 6NJ, CF11 6PA, CF11 6PB, CF11 6PT, CF11 6PU, CF11 6PX, CF11 6QD, CF11 6QS, CF11 6RU, CF11 6RW, CF11 6RX, CF11 6YA, CF11 6YG",383,350,33
W00009096,CF1,"CF1 7AE, CF1 7BE, CF11 7AE, CF11 7AZ, CF11 7BB, CF11 7BD, CF11 7BG, CF11 7BL, CF11 7BT",432,369,63
W00008912,CF1,"CF1 3ED, CF1 3EE, CF1 3EG, CF1 3EH, CF1 3EJ, CF1 3EN, CF1 3ES, CF1 3SR, CF1 3TG, CF10 3DT, CF10 3DU, CF10 3DY, CF10 3EB, CF10 3ED, CF10 3EE, CF10 3EG, CF10 3EN, CF10 3UP, CF2 4DW, CF2 4EA, CF2 4HH, CF2 4HP, CF2 4HS, CF2 4HX, CF2 4JJ, CF2 4JL, CF2 4JU, CF24 4HP, CF24 4HQ",537,486,51
W00009097,CF1,"CF1 1AA, CF1 1AB, CF1 1BU, CF1 7HR, CF1 7NA, CF1 7NB, CF1 7NJ, CF1 7NQ, CF1 7NR, CF1 7NS, CF1 7NU, CF1 7NW, CF1 7PA, CF1 7PB, CF1 7PD, CF1 7PE, CF1 7PF, CF1 7PG, CF1 7PH, CF1 7PR, CF1 7PT, CF1 7PU, CF1 7YG, CF11 6NA, CF11 6NQ, CF11 6NR, CF11 6NU, CF11 6NW, CF11 6NX, CF11 6PE, CF11 6PF, CF11 6PG, CF11 6PH",323,281,42
W00009099,CF1,"CF1 7BH, CF1 7BJ, CF11 7AF, CF11 7AG, CF11 7AH, CF11 7AJ, CF11 7AR, CF11 7BH, CF11 7BJ",281,221,60
W00009100,CF1,"CF1 1RB, CF1 1RF, CF1 1US, CF1 2QY, CF1 4QX, CF1 4UT, CF1 5TJ, CF1 6NN, CF1 6PA, CF1 6PB, CF1 6QA, CF1 6QD, CF1 7EA, CF1 7EB, CF1 7ED, CF1 7HJ, CF1 7HL, CF1 7LW, CF1 7NN, CF1 7QA, CF1 7QB, CF1 7RN, CF1 7TN, CF1 7TP, CF1 7TT, CF1 7TU, CF1 7TW, CF1 7TZ, CF1 7UB, CF1 7UD, CF1 7UE, CF1 7UL, CF1 7UP, CF1 7UR, CF1 7US, CF1 7UT, CF1 7UU, CF1 7UW, CF1 7UY, CF1 7WA, CF1 7WB, CF1 7WD, CF1 7WE, CF1 7WF, CF1 7WG, CF1 7WH, CF1 7WJ, CF1 7WL, CF1 7WN, CF1 7WP, CF1 7WQ, CF1 7WR, CF1 7WS, CF1 7WW, CF1 7XJ, CF1 7YN, CF1 7YR, CF1 7YT, CF1 7YZ, CF1 8AF, CF1 8AG, CF1 8AJ, CF1 8AQ, CF1 8AW, CF1 8BA, CF1 8BB, CF1 8BD, CF1 8BE, CF1 8BF, CF1 8TB, CF1 8TE, CF1 8TG, CF1 8TQ, CF1 8TR, CF1 8TT, CF1 8UA, CF1 8UB, CF1 8UD, CF1 8UE, CF1 8UF, CF1 8UG, CF1 8XB, CF1 8XE, CF1 8XF, CF1 8XH, CF1 8XJ, CF1 8XL, CF1 8XP, CF1 8XS, CF1 8XT, CF1 8XX, CF1 8XY, CF1 9UB, CF10 1BP, CF10 1EJ, CF10 1HE, CF10 1JL, CF10 1LG, CF10 1QA, CF10 1QZ, CF10 1SG, CF10 1SH, CF10 1SP, CF10 1SS, CF10 1ST, CF10 1SW, CF10 1TB, CF10 1TX, CF10 1UA, CF10 1UH, CF10 1UP, CF10 1UW, CF10 1UX, CF10 1WJ, CF10 1XB, CF10 1XF, CF10 1XG, CF10 1XH, CF10 1XJ, CF10 1XL, CF10 1XQ, CF10 1XS, CF10 1XT, CF10 1YA, CF10 1YD, CF10 1YF, CF10 1YG, CF10 1YH, CF10 1YJ, CF10 1YL, CF10 1YN, CF10 1YP, CF10 1YQ, CF10 1YR, CF10 1YS, CF10 1YT, CF10 1YU, CF10 1YX, CF10 1YY, CF10 1YZ, CF10 1ZR, CF10 1ZS, CF10 1ZY, CF10 2LP, CF10 2QU, CF10 2RY, CF10 2UL, CF10 2WB, CF10 2WD, CF10 2WE, CF10 2WG, CF10 2WJ, CF10 2WP, CF10 2WQ, CF10 2WX, CF10 2XF, CF10 2XH, CF10 2XU, CF10 2XY, CF10 2XZ, CF10 2YA, CF10 2YB, CF10 2YD, CF10 2YE, CF10 2YF, CF10 2YG, CF10 2YH, CF10 2YJ, CF10 2YN, CF10 2YP, CF10 2YQ, CF10 2YU, CF10 2ZP, CF10 2ZR, CF10 3BT, CF10 3TA, CF10 3TB, CF10 3TE, CF10 3TL, CF10 3TS, CF10 3TT, CF10 3TU, CF10 3TX, CF10 3TY, CF10 3UA, CF10 3UF, CF10 3UG, CF10 3UJ, CF10 3UL, CF10 3US, CF10 3UW, CF10 3UX, CF10 3UY, CF10 3WB, CF10 3WD, CF10 3WE, CF10 3WF, CF10 3WH, CF10 3WJ, CF10 3WN, CF10 3WP, CF10 3WQ, CF10 3WW, CF10 3WX, CF10 3XA, CF10 3XB, CF10 3XD, CF10 3XE, CF10 3XF, CF10 3XH, CF10 3XJ, CF10 3XL, CF10 3XN, CF10 3XP, CF10 3XQ, CF10 3XR, CF10 3XS, CF10 3XT, CF10 3XU, CF10 3XW, CF10 3XX, CF10 3XY, CF10 3XZ, CF10 3YA, CF10 3YD, CF10 3YE, CF10 3YF, CF10 3YG, CF10 3YH, CF10 3YJ, CF10 3YL, CF10 3YN, CF10 3YP, CF10 3YQ, CF10 3YR, CF10 3YS, CF10 3YT, CF10 3YU, CF10 3YW, CF10 3YX, CF10 3YY, CF10 3YZ, CF10 3ZA, CF10 3ZB, CF10 3ZG, CF10 3ZH, CF10 3ZJ, CF10 3ZL, CF10 3ZN, CF10 3ZP, CF10 3ZR, CF10 3ZS, CF10 3ZT, CF10 3ZU, CF10 3ZW, CF10 3ZX, CF10 4WB, CF10 4WD, CF10 4WE, CF10 4WF, CF10 4WH, CF10 4WJ, CF10 4WL, CF10 4WN, CF10 4WP, CF10 4WQ, CF10 4WR, CF10 4WS, CF10 4WU, CF10 4WY, CF10 4XE, CF10 4XG, CF10 4XJ, CF10 4XP, CF10 4XR, CF10 4XW, CF10 4YB, CF10 4YF, CF10 4YH, CF10 4YJ, CF10 4YL, CF10 4YN, CF10 4YQ, CF10 4YR, CF10 4YS, CF10 4YT, CF10 4YU, CF10 4YW, CF10 4YX, CF10 4YZ, CF10 4ZF, CF10 4ZL, CF10 4ZN, CF10 4ZP, CF10 4ZQ, CF10 4ZU, CF10 4ZW, CF10 5PB, CF10 5UD, CF10 5WA, CF10 5WB, CF10 5WD, CF10 5WE, CF10 5WF, CF10 5WJ, CF10 5WN, CF10 5WP, CF10 5WQ, CF10 5WR, CF10 5WU, CF10 5WX, CF10 5WY, CF10 5WZ, CF10 5XA, CF10 5XB, CF10 5XD, CF10 5XE, CF10 5XF, CF10 5XG, CF10 5XH, CF10 5XQ, CF10 5XR, CF10 5XU, CF10 5XW, CF10 5XX, CF10 5XY, CF10 5XZ, CF10 5YA, CF10 5YB, CF10 5YD, CF10 5YE, CF10 5YF, CF10 5YH, CF10 5YL, CF10 5YN, CF10 5YQ, CF10 5YR, CF10 5YS, CF10 5YT, CF10 5YU, CF10 5YW, CF10 5YX, CF10 5YY, CF10 5YZ, CF10 5ZB, CF10 5ZD, CF10 5ZE, CF10 5ZF, CF10 5ZJ, CF10 5ZQ, CF10 5ZR, CF10 5ZU, CF10 5ZX, CF10 5ZY, CF11 0WD, CF11 0WZ, CF11 0YB, CF11 0YQ, CF11 0YT, CF11 0YW, CF11 1AA, CF11 1AB, CF11 1AD, CF11 1AE, CF11 1AG, CF11 1AH, CF11 1AJ, CF11 1AL, CF11 1AN, CF11 1AP, CF11 1AQ, CF11 1AR, CF11 1AS, CF11 1AT, CF11 1AU, CF11 1AW, CF11 1AX, CF11 1AY, CF11 1AZ, CF11 1BA, CF11 1BB, CF11 1BD, CF11 1BE, CF11 1BF, CF11 1BG, CF11 1BH, CF11 1BJ, CF11 1BL, CF11 1BN, CF11 1BP, CF11 1BQ, CF11 1BR, CF11 1BS, CF11 1BT, CF11 1BU, CF11 1BW, CF11 1BX, CF11 1BY, CF11 1BZ, CF11 1DA, CF11 1DB, CF11 1DD, CF11 1DE, CF11 1DF, CF11 1DG, CF11 1DH, CF11 1DJ, CF11 1DL, CF11 1DN, CF11 1DP, CF11 1DQ, CF11 1DR, CF11 1DS, CF11 1DT, CF11 1DU, CF11 1DW, CF11 1DX, CF11 1DY, CF11 1DZ, CF11 1EA, CF11 1EB, CF11 1ED, CF11 1EE, CF11 1EF, CF11 1EG, CF11 1EH, CF11 1EJ, CF11 1EL, CF11 1EN, CF11 1EP, CF11 1EQ, CF11 1ER, CF11 1ES, CF11 1ET, CF11 1EU, CF11 1EW, CF11 1EX, CF11 1EY, CF11 1EZ, CF11 1FA, CF11 1FB, CF11 1FD, CF11 1FE, CF11 1FF, CF11 1FG, CF11 1FH, CF11 1FJ, CF11 1FL, CF11 1FN, CF11 1FP, CF11 1FQ, CF11 1FR, CF11 1FS, CF11 1FT, CF11 1FU, CF11 1FW, CF11 1FX, CF11 1FY, CF11 1FZ, CF11 1GA, CF11 1GB, CF11 1GD, CF11 1GE, CF11 1GF, CF11 1GG, CF11 1GH, CF11 1GJ, CF11 1GL, CF11 1GN, CF11 1GP, CF11 1GQ, CF11 1GR, CF11 1GS, CF11 1GT, CF11 1GU, CF11 1GW, CF11 1GX, CF11 1GY, CF11 1GZ, CF11 1HA, CF11 1HB, CF11 1HD, CF11 1HE, CF11 1HF, CF11 1HG, CF11 1HH, CF11 1HJ, CF11 1HL, CF11 1HN, CF11 1HP, CF11 1HQ, CF11 1HR, CF11 1HS, CF11 1HT, CF11 1HU, CF11 1HW, CF11 1HX, CF11 1HY, CF11 1HZ, CF11 1JA, CF11 1JB, CF11 1JD, CF11 1JE, CF11 1JF, CF11 1JG, CF11 1JH, CF11 1JJ, CF11 1JL, CF11 1JN, CF11 1JP, CF11 1JQ, CF11 1JR, CF11 1JS, CF11 1JT, CF11 1JU, CF11 1JW, CF11 1JX, CF11 1JY, CF11 1JZ, CF11 1LA, CF11 1LB, CF11 1LD, CF11 1LE, CF11 1LF, CF11 1LG, CF11 1LH, CF11 1LJ, CF11 1LL, CF11 1LN, CF11 1LP, CF11 1LQ, CF11 1LR, CF11 1LS, CF11 1LT, CF11 1LU, CF11 1LW, CF11 1LX, CF11 1LY, CF11 1LZ, CF11 1NA, CF11 1NB, CF11 1ND, CF11 1NE, CF11 1NF, CF11 1NG, CF11 1NH, CF11 1NJ, CF11 1NL, CF11 1NN, CF11 1NP, CF11 1NQ, CF11 1NR, CF11 1NS, CF11 1NT, CF11 1NU, CF11 1NW, CF11 1NX, CF11 1NY, CF11 1NZ, CF11 1PA, CF11 1PB, CF11 1PD, CF11 1PE, CF11 1PF, CF11 1PG, CF11 1PH, CF11 1PJ, CF11 1PL, CF11 1PN, CF11 1PP, CF11 1PQ, CF11 1PR, CF11 1PS, CF11 1PT, CF11 1PU, CF11 1PW, CF11 1PX, CF11 1PY, CF11 1PZ, CF11 1QA, CF11 1QB, CF11 1QD, CF11 1QE, CF11 1QF, CF11 1QG, CF11 1QH, CF11 1QJ, CF11 1QL, CF11 1QN, CF11 1QP, CF11 1QQ, CF11 1QR, CF11 1QS, CF11 1QT, CF11 1QU, CF11 1QW, CF11 1QX, CF11 1QY, CF11 1QZ, CF11 1RA, CF11 1RB, CF11 1RD, CF11 1RE, CF11 1RF, CF11 1RG, CF11 1RH, CF11 1RJ, CF11 1RL, CF11 1RN, CF11 1RP, CF11 1RQ, CF11 1RR, CF11 1RS, CF11 1RT, CF11 1RU, CF11 1RW, CF11 1RX, CF11 1RY, CF11 1RZ, CF11 1SA, CF11 1SB, CF11 1SD, CF11 1SE, CF11 1SF, CF11 1SH, CF11 1SJ, CF11 1SL, CF11 1SN, CF11 1SP, CF11 1SQ, CF11 1SR, CF11 1SS, CF11 1ST, CF11 1SU, CF11 1SW, CF11 1SX, CF11 1SY, CF11 1SZ, CF11 1TA, CF11 1TB, CF11 1TD, CF11 1TE, CF11 1TF, CF11 1TG, CF11 1TH, CF11 1TJ, CF11 1TL, CF11 1TN, CF11 1TP, CF11 1TQ, CF11 1TR, CF11 1TS, CF11 1TT, CF11 1TU, CF11 1TW, CF11 1TX, CF11 1TY, CF11 1TZ, CF11 1UA, CF11 1UB, CF11 1UD, CF11 1UE, CF11 1UF, CF11 1UG, CF11 1UH, CF11 1UJ, CF11 1UL, CF11 1UN, CF11 1UP, CF11 1UQ, CF11 1UR, CF11 1US, CF11 1UT, CF11 1UU, CF11 1UW, CF11 1UX, CF11 1UY, CF11 1UZ, CF11 1WA, CF11 1WB, CF11 1WD, CF11 1WE, CF11 1WF, CF11 1WG, CF11 1WH, CF11 1WJ, CF11 1WL, CF11 1WN, CF11 1WP, CF11 1WQ, CF11 1WR, CF11 1WS, CF11 1WT, CF11 1WU, CF11 1WW, CF11 1WY, CF11 1WZ, CF11 1XA, CF11 1XB, CF11 1XD, CF11 1XE, CF11 1XF, CF11 1XG, CF11 1XH, CF11 1XJ, CF11 1XL, CF11 1XN, CF11 1XP, CF11 1XQ, CF11 1XR, CF11 1XS, CF11 1XT, CF11 1XU, CF11 1XW, CF11 1XX, CF11 1XY, CF11 6JR, CF11 6UU, CF11 6WB, CF11 6WF, CF11 6WN, CF11 6WX, CF11 6WZ, CF11 6XB, CF11 6XF, CF11 6XH, CF11 6XJ, CF11 6XZ, CF11 6YE, CF11 6YF, CF11 6YL, CF11 6YN, CF11 6YP, CF11 6YQ, CF11 6YR, CF11 6YS, CF11 6YT, CF11 6YU, CF11 6YW, CF11 6YX, CF11 6ZR, CF11 6ZY, CF11 7WB, CF11 7WD, CF11 7WE, CF11 7WH, CF11 7WJ, CF11 7WL, CF11 7WP, CF11 7WR, CF11 7WS, CF11 7WT, CF11 7WW, CF11 7XD, CF11 7XH, CF11 7XP, CF11 7YA, CF11 7YD, CF11 7YE, CF11 7YG, CF11 7YP, CF11 7YQ, CF11 7YR, CF11 7YS, CF11 7YU, CF11 7YY, CF11 7ZQ, CF11 7ZR, CF11 8AB, CF11 8AQ, CF11 8AT, CF11 8AW, CF11 8BA, CF11 8BB, CF11 8BE, CF11 8BS, CF11 8BT, CF11 8DL, CF11 8DP, CF11 8ED, CF11 8EQ, CF11 8EY, CF11 8EZ, CF11 8HB, CF11 8JF, CF11 8JP, CF11 8LR, CF11 8NN, CF11 8PD, CF11 8PF, CF11 8PG, CF11 8PU, CF11 8PZ, CF11 8QY, CF11 8RD, CF11 8SE, CF11 8SR, CF11 8ST, CF11 8TA, CF11 8TJ, CF11 8TL, CF11 8TN, CF11 8TR, CF11 8TU, CF11 8TY, CF11 8TZ, CF11 8UA, CF11 8UB, CF11 8UE, CF11 8UL, CF11 8UY, CF11 8WD, CF11 8WF, CF11 8WH, CF11 8WQ, CF11 8WU, CF11 8XA, CF11 8XE, CF11 8XH, CF11 8XL, CF11 8XN, CF11 8XT, CF11 8XZ, CF11 8YA, CF11 8YB, CF11 8YD, CF11 8YE, CF11 8YF, CF11 8YG, CF11 8YH, CF11 8YJ, CF11 8YL, CF11 8YP, CF11 8YR, CF11 8YS, CF11 8YU, CF11 8YX, CF11 8YY, CF11 8YZ, CF11 8ZA, CF11 8ZD, CF11 8ZE, CF11 8ZF, CF11 8ZG, CF11 8ZH, CF11 8ZJ, CF11 8ZL, CF11 8ZN, CF11 8ZP, CF11 8ZQ, CF11 8ZR, CF11 8ZS, CF11 8ZT, CF11 8ZU, CF11 8ZW, CF11 8ZX, CF11 8ZY, CF11 8ZZ, CF11 9AX, CF11 9RU, CF11 9UB, CF11 9UJ, CF11 9UL, CF11 9WA, CF11 9WB, CF11 9WD, CF11 9WE, CF11 9WF, CF11 9WG, CF11 9WL, CF11 9WN, CF11 9WP, CF11 9WR, CF11 9WS, CF11 9WT, CF11 9WU, CF11 9WW, CF11 9XA, CF11 9XD, CF11 9XE, CF11 9XN, CF11 9XP, CF11 9XQ, CF11 9XS, CF11 9XU, CF11 9YA, CF11 9YB, CF11 9YD, CF11 9YE, CF11 9YG, CF11 9YH, CF11 9YJ, CF11 9YN, CF11 9YQ, CF11 9YR, CF11 9YS, CF11 9YT, CF11 9YW, CF11 9YY, CF11 9YZ, CF11 9ZA, CF11 9ZF, CF11 9ZH, CF11 9ZJ, CF11 9ZU, CF11 9ZW, CF11 9ZY, CF24 0BN, CF24 0BX, CF24 0EE, CF24 0FF, CF24 0FH, CF24 0FJ, CF24 0FL, CF24 0SX, CF24 0TR, CF24 0TU, CF24 0TX, CF24 0UD, CF24 0UF, CF24 0UH, CF24 0UJ, CF24 0UL, CF24 0UN, CF24 0UP, CF24 0UU, CF24 0UW, CF24 0UX, CF24 0WA, CF24 0WD, CF24 0WE, CF24 0WG, CF24 0WJ, CF24 0WP, CF24 0WQ, CF24 0WS, CF24 0WU, CF24 0WW, CF24 0XA, CF24 0XB, CF24 0XD, CF24 0XE, CF24 0XF, CF24 0XG, CF24 0XH, CF24 0XL, CF24 0XN, CF24 0XP, CF24 0XQ, CF24 0XS, CF24 0XT, CF24 0XU, CF24 0XW, CF24 0XZ, CF24 0YA, CF24 0YD, CF24 0YE, CF24 0YF, CF24 0YH, CF24 0YJ, CF24 0YL, CF24 0YN, CF24 0YQ, CF24 0YR, CF24 0YS, CF24 0YU, CF24 0YW, CF24 0YX, CF24 0ZD, CF24 0ZL, CF24 0ZN, CF24 0ZP, CF24 0ZS, CF24 0ZW, CF24 1WD, CF24 1WG, CF24 1XD, CF24 1XT, CF24 1YA, CF24 1YD, CF24 1YG, CF24 1YH, CF24 1YJ, CF24 1YL, CF24 1YP, CF24 1YR, CF24 1YU, CF24 1ZA, CF24 1ZN, CF24 1ZR, CF24 1ZY, CF24 2WD, CF24 2WE, CF24 2WF, CF24 2WR, CF24 2WY, CF24 2WZ, CF24 2XN, CF24 2XR, CF24 2XT, CF24 2YB, CF24 2YF, CF24 2YH, CF24 2YJ, CF24 2YN, CF24 2YP, CF24 2YQ, CF24 2YR, CF24 2YS, CF24 2YT, CF24 2YU, CF24 2YW, CF24 2YZ, CF24 2ZA, CF24 2ZQ, CF24 2ZR, CF24 2ZW, CF24 2ZY, CF24 3SU, CF24 3TA, CF24 3TB, CF24 3TD, CF24 3TE, CF24 3TF, CF24 3TG, CF24 3TH, CF24 3TU, CF24 3UB, CF24 3UE, CF24 3UF, CF24 3WE, CF24 3WF, CF24 3WG, CF24 3WH, CF24 3WN, CF24 3WP, CF24 3WQ, CF24 3WR, CF24 3WS, CF24 3WT, CF24 3WU, CF24 3WW, CF24 3WX, CF24 3XD, CF24 3XE, CF24 3XF, CF24 3XH, CF24 3XN, CF24 3XP, CF24 3XR, CF24 3XT, CF24 3XU, CF24 3XW, CF24 3XX, CF24 3XY, CF24 3XZ, CF24 3YA, CF24 3YB, CF24 3YD, CF24 3YE, CF24 3YL, CF24 3YU, CF24 3ZA, CF24 3ZB, CF24 3ZD, CF24 3ZE, CF24 3ZH, CF24 3ZN, CF24 3ZQ, CF24 3ZR, CF24 3ZT, CF24 3ZU, CF24 3ZW, CF24 3ZY, CF24 4UJ, CF24 4UN, CF24 4WA, CF24 4WB, CF24 4WD, CF24 4WJ, CF24 4WL, CF24 4WN, CF24 4WR, CF24 4WW, CF24 4WY, CF24 4XD, CF24 4XE, CF24 4XF, CF24 4XH, CF24 4XJ, CF24 4XL, CF24 4XS, CF24 4XU, CF24 4XZ, CF24 4YB, CF24 4YG, CF24 4YH, CF24 4YR, CF24 4YT, CF24 4YY, CF24 4YZ, CF24 4ZA, CF24 4ZR, CF24 4ZT, CF24 5UE, CF24 5WT, CF24 5XA, CF24 5XR, CF24 5YA, CF24 5YB, CF24 5YD, CF24 5YE, CF24 5YS, CF24 5YU, CF24 5YW, CF24 5YX, CF24 5ZE, CF24 5ZU, CF91 1WX, CF91 1WY, CF91 1WZ, CF91 1XN, CF91 5AA, CF91 5AB, CF91 5AD, CF91 5AE, CF91 5AF, CF91 5AG, CF91 5AH, CF91 5AJ, CF91 5AL, CF91 5AN, CF91 5AP, CF91 5AQ, CF91 5AR, CF91 5AS, CF91 5AT, CF91 5AU",387,348,39
W00009101,CF1,"CF1 7AA, CF1 7AB, CF1 7AP, CF1 7AU, CF1 7XA, CF11 7AD, CF11 7AP, CF11 7AT, CF11 7AU, CF11 7LX, CF11 7LZ, CF11 7XA, CF11 7XW",439,406,33
W00009102,CF1,"CF1 7TF, CF1 8AA, CF1 8BG, CF1 8BJ, CF1 8TD, CF11 8AA, CF11 8AG, CF11 8AY, CF11 8BG, CF11 8BH, CF11 8HD, CF11 8LA",262,233,29
W00009104,CF1,"CF1 7AT, CF1 7HS, CF1 7LB, CF1 7NL, CF1 7NT, CF1 7NX, CF1 7YA, CF1 7YB, CF11 6FS, CF11 6NL, CF11 6NN, CF11 6NP, CF11 6NT, CF11 7HJ, CF11 7HT, CF11 7JQ, CF11 7JX, CF11 7LY, CF11 7PL",508,472,36
W00009105,CF1,"CF1 7AN, CF1 7AZ, CF1 7HT, CF1 7JP, CF1 7JR, CF1 7JS, CF1 7JW, CF1 7JX, CF1 7JY, CF1 7LD, CF1 7LX, CF1 7LY, CF1 7LZ, CF1 7NZ, CF1 7UA, CF1 7UN, CF1 7XD, CF1 7XE, CF1 7XF, CF1 7XH, CF1 7XL, CF1 7XN, CF1 7XP, CF1 7XQ, CF1 7XW, CF1 7YF, CF1 7YP, CF1 7YY, CF11 6FR, CF11 7JS, CF11 7JY, CF11 7LB, CF11 7LD, CF11 7LW",430,379,51
W00009106,CF1,"CF1 7AD, CF1 7AF, CF1 7AQ, CF1 7LU, CF11 7AQ, CF11 7AW, CF11 7LP, CF11 7LT, CF11 7LU",365,323,42
W00009107,CF1,"CF1 7LL, CF1 7LQ, CF1 7LS, CF1 7LT, CF11 7HL, CF11 7LL, CF11 7LS",346,295,51
W00009098,CF1,"CF1 7BA, CF1 7BD, CF1 7BF, CF1 7BG, CF1 7BL, CF11 7AA, CF11 7AB, CF11 7AN, CF11 7BA",371,331,40
W00009108,CF1,"CF1 7ER, CF1 7ES, CF1 7EZ, CF1 7FA, CF1 7FB, CF1 7FE, CF1 7GX, CF1 7HD, CF11 7BW, CF11 7EZ, CF11 7HD, CF11 7LF, CF11 7LH, CF11 7XS",279,230,49
W00009983,CF1,"CF1 7SW, CF1 8HW, CF1 8JL, CF1 8RE, CF1 8RL, CF11 6BH, CF11 6DD, CF11 6DL, CF11 6QT, CF11 6SG, CF11 6YH, CF11 6YY, CF11 7BE, CF11 9WQ",599,564,35
W00008888,CF1,"CF1 9PS, CF1 9PX, CF1 9QD, CF1 9QG, CF11 9QF, CF11 9QG, CF5 1EB, CF5 1SD, CF5 1SE",229,200,29
W00008816,CF1,"CF1 5JH, CF1 5JJ, CF1 5JL, CF1 5UD, CF1 6NT, CF10 5HR, CF10 5HY, CF10 5JF, CF10 5JG, CF10 5JH, CF10 5JJ, CF10 5JL, CF10 5JN, CF10 5JP, CF10 5UZ",395,388,7
W00008811,CF1,"CF1 5BU, CF1 5BW, CF1 5BX, CF1 5BY, CF1 5BZ, CF1 5HD, CF10 4AW, CF10 4BD, CF10 4BU, CF10 4BW, CF10 4BX, CF10 4DU, CF10 4EN, CF10 4LN",237,213,24
W00008855,CF1,"CF1 9NN, CF1 9NQ, CF1 9PT, CF1 9PU, CF1 9PW, CF1 9PZ, CF1 9QB, CF1 9QF, CF11 9PT, CF5 1AY, CF5 1FH, CF5 1FJ, CF5 1QL",306,235,71
W00008807,CF1,"CF1 5LD, CF1 6BA, CF1 6BD, CF1 6BE, CF1 6BG, CF1 6BH, CF1 6BJ, CF1 6BL, CF1 6BN, CF1 6BP, CF1 6BQ, CF1 6BR, CF1 6BS, CF1 6BY, CF1 6BZ, CF1 6DH, CF1 6DN, CF1 6DP, CF1 6DQ, CF1 6DS, CF1 6EA, CF1 6EB, CF1 6ED, CF1 6EE, CF1 6EL, CF1 6EQ, CF1 6EU, CF1 6EY, CF1 6EZ, CF1 6HQ, CF1 6NP, CF1 6QB, CF1 6QF, CF1 6QH, CF1 6QL, CF1 6QN, CF1 6QP, CF1 6QQ, CF1 6QR, CF1 6QS, CF1 6QT, CF1 6QU, CF1 6QY, CF1 6QZ, CF1 6RA, CF1 6RB, CF1 6RD, CF1 6RJ, CF1 6RP, CF1 6RQ, CF1 6RU, CF1 6RW, CF1 6RX, CF1 6SF, CF1 6SP, CF1 6SU, CF1 6TH, CF1 6UA, CF1 6UG, CF1 6UY, CF1 6YA, CF1 6YB, CF1 6YD, CF1 6YE, CF1 6YF, CF1 6YG, CF1 6YH, CF1 6YJ, CF1 6YL, CF1 6YN, CF1 6YP, CF1 6YQ, CF1 6YR, CF1 6YS, CF1 6YT, CF1 6YU, CF1 6YW, CF1 6YX, CF1 6YZ, CF10 5BD, CF10 5BE, CF10 5BG, CF10 5BJ, CF10 5BL, CF10 5BQ, CF10 5BR, CF10 5BS, CF10 5DP, CF10 5EB, CF10 5ED, CF10 5EF, CF10 5EL, CF10 5EW, CF10 5EY, CF10 5EZ, CF10 5FH, CF10 5FJ, CF10 5FQ, CF10 5FR, CF10 5FW, CF10 5HD, CF10 5QL, CF10 5QP, CF10 5QR, CF10 5SU",434,386,48
W00008829,CF1,"CF1 1TU, CF5 5AA, CF5 5AB, CF5 5AD, CF5 5AE, CF5 5AG, CF5 5AR, CF5 5AS, CF5 5BF, CF5 5XA, CF5 5XY",455,405,50
W00008804,CF1,"CF1 6HH, CF1 6HL, CF1 6HR, CF1 6HS, CF1 6HT, CF1 6HU, CF1 6HW, CF1 6HX, CF1 6HY, CF1 6HZ, CF1 6JB, CF1 6JD, CF1 6TS, CF1 6UQ, CF10 5DZ, CF10 5ET, CF10 5FB, CF10 5GF, CF10 5GJ, CF10 5GR, CF10 5GS, CF10 5GT, CF10 5GU, CF10 5GY, CF10 5GZ, CF10 5JY, CF10 5UQ, CF10 5UY",474,425,49
W00008803,CF1,"CF1 1LU, CF1 3TQ, CF1 5LJ, CF1 5LL, CF1 5UE, CF1 6AD, CF1 6AE, CF1 6DJ, CF1 6DL, CF1 6DR, CF1 6DT, CF1 6EN, CF1 6EP, CF1 6ER, CF1 6ES, CF1 6ET, CF1 6EW, CF1 6EX, CF1 6HD, CF1 6HE, CF1 6HG, CF1 6NY, CF1 6PP, CF1 6PQ, CF1 6PT, CF1 6QJ, CF1 6QX, CF1 6RN, CF1 6SA, CF1 6SB, CF1 6SD, CF1 6SE, CF1 6SH, CF1 6ST, CF1 6SW, CF1 6SX, CF1 6UU, CF10 5AE, CF10 5AR, CF10 5AS, CF10 5BB, CF10 5BY, CF10 5EE, CF10 5EN, CF10 5EP, CF10 5ES, CF10 5EX, CF10 5FL, CF10 5FT, CF10 5GD, CF10 5GL, CF10 5LJ, CF10 5LL, CF10 5LN, CF10 5NA, CF10 5QQ",359,336,23
W00008861,CF1,"CF1 8BW, CF1 8DD, CF11 8BW, CF11 8BZ, CF11 8DD",365,323,42
W00008817,CF1,"CF1 5HP, CF1 5HR, CF1 5JD, CF1 5JN, CF1 5JP, CF1 5JR, CF1 5JS, CF1 5JT, CF1 5JU, CF1 5JX, CF1 5JY, CF1 5JZ, CF1 6US, CF10 5HQ, CF10 5JB, CF10 5JD, CF10 5JT, CF10 5JU, CF10 5LP",340,330,10
W00008864,CF1,"CF1 9NH, CF1 9PB, CF11 9NF, CF11 9NG, CF11 9NH, CF11 9PB, CF5 1AZ, CF5 1QB, CF5 1QD, CF5 1QF, CF5 1QG, CF5 1QH",290,235,55
W00008877,CF1,"CF1 8HG, CF1 8HJ, CF1 9AN, CF1 9AQ, CF1 9NF, CF1 9NJ, CF11 8HJ, CF5 1GW, CF5 1JB, CF5 1NR, CF5 1NW, CF5 1NX, CF5 1NY, CF5 1NZ, CF5 1WD, CF5 1WR, CF5 1WW, CF5 1WX, CF5 1XX",308,228,80
W00008878,CF1,"CF1 8DL, CF5 1LQ, CF5 1LY, CF5 1LZ, CF5 1PR, CF5 1PT, CF5 1PU, CF5 1WL",402,302,100
W00009982,CF1,"CF1 1SA, CF1 1SD, CF1 1SF, CF1 1SG, CF1 1SP, CF1 1SS, CF1 1ST, CF1 1SW, CF1 2FF, CF1 2FG, CF1 2FH, CF1 2FJ, CF1 2FP, CF1 2FQ, CF1 2FR, CF1 2RY, CF1 2TR, CF1 2TU, CF1 2TW, CF1 2TX, CF1 2TY, CF1 2UH, CF1 2UN, CF1 2XJ, CF10 4FB, CF10 4FD, CF10 4FF, CF10 4FG, CF10 4FP, CF10 4FQ, CF10 4FR, CF2 1BD, CF2 1BE, CF2 1BG, CF2 1BL, CF2 1BT, CF2 1BW, CF2 1BY, CF2 1BZ, CF2 1DB, CF2 1DD, CF2 1DE, CF2 1DZ, CF2 1EA, CF2 1EB, CF2 1ED, CF2 1EE, CF2 1EF, CF2 1EG, CF2 1EH, CF2 1EJ, CF2 1EL, CF2 1EN, CF2 1ER, CF2 1JS, CF2 1JT, CF2 1SD, CF2 1SE, CF2 1SG, CF2 1ST, CF2 1SU, CF2 1SX, CF2 1SY, CF2 1TD, CF2 1TE, CF2 1TF, CF2 1TG, CF2 1UG, CF2 1UJ, CF2 1US, CF2 1UT, CF2 1UY, CF2 1UZ, CF2 1WA, CF2 1WB, CF2 1WD, CF2 1WE, CF2 1WF, CF2 1WG, CF2 1WH, CF2 1WJ, CF2 1WL, CF2 1WN, CF2 1WP, CF2 1WQ, CF24 0AH, CF24 0AL, CF24 0AN, CF24 0AP, CF24 0BA, CF24 0BD, CF24 0BE, CF24 0BG, CF24 0BL, CF24 0DB, CF24 0EA, CF24 0EB, CF24 0EF, CF24 0EL, CF24 0FA, CF24 0FB, CF24 0FG, CF24 0HA, CF24 0NA, CF24 0NE, CF24 0RZ, CF24 0SP, CF24 0SU, CF24 0SW, CF24 0TE, CF24 0TL, CF24 0TN, CF24 0TS, CF24 0TT, CF24 0UG, CF24 0UY, CF24 0YB, CF24 0ZH, CF24 0ZQ, CF24 0ZU, CF24 0ZZ, CF24 2FH, CF24 2FN, CF24 2XB, CF24 2XF",1563,1457,106
W00008881,CF1,"CF1 5QL, CF1 8HF, CF1 8HH, CF1 8HL, CF1 8HN, CF11 6HN, CF11 6HQ, CF11 6QA, CF11 8HF, CF11 8HL, CF5 1PA, CF5 1PF, CF5 1PG, CF5 1PL, CF5 1PX",348,285,63
W00008882,CF1,"CF1 8BX, CF1 8BY, CF1 8HQ, CF1 8HR, CF11 8BX, CF11 8BY, CF11 8EW, CF11 8EX, CF11 8HP, CF11 8HQ, CF11 8HX, CF5 1PQ, CF5 1PY, CF5 1YL, CF5 1YQ, CF5 1YW",356,312,44
W00008818,CF1,"CF1 5HQ, CF1 5HU, CF1 5JA, CF1 5JB, CF1 5JE, CF1 5JF, CF1 5JG, CF1 5JQ, CF1 5JW, CF1 5LA, CF1 5LB, CF1 6AP, CF1 6AR, CF1 6AS, CF1 6AT, CF1 6TE, CF1 6TF, CF1 6TT, CF1 6UE, CF1 6UH, CF1 6UJ, CF10 5FE, CF10 5FF, CF10 5FS, CF10 5JA, CF10 5JE, CF10 5JR, CF10 5JW, CF10 5LA, CF10 5LB, CF10 5UL, CF10 5WG, CF10 5YG, CF10 5YJ, CF10 5YP, CF10 5ZZ",521,493,28
W00008883,CF1,"CF1 8BZ, CF1 8DA, CF1 8DB, CF1 8DE, CF1 8DF, CF11 8DA, CF11 8DB, CF11 8DE, CF11 8DF",280,251,29
W00008884,CF1,"CF1 6TP, CF1 8AB, CF1 8AD, CF1 8AE, CF1 8AH, CF1 8AP, CF1 8AT, CF1 8BH, CF1 8BP, CF1 8BQ, CF1 8BR, CF1 8ST, CF1 8SX, CF1 8TH, CF1 8TJ, CF1 8TL, CF1 8TN, CF1 8UW, CF1 8YS, CF1 8YT, CF1 8YU, CF1 8YX, CF1 8YZ, CF1 9UD, CF11 8AP, CF11 8AZ, CF11 8BD, CF11 8BP, CF11 8BQ, CF11 8BR, CF11 8EG, CF11 8ER, CF11 8PW, CF11 8TP, CF11 8XB",255,233,22
W00008871,CF1,"CF1 9NG, CF5 1GX, CF5 1GY, CF5 1JD, CF5 1JE, CF5 1LJ, CF5 1LR, CF5 1NS, CF5 1QE, CF5 1QS, CF5 1QW, CF5 1RZ, CF5 1XB, CF5 1XP",344,251,93
W00010210,CF1,"CF1 1TP, CF1 1TQ, CF1 5EE, CF1 5EH, CF1 5EY, CF1 5EZ, CF1 5GT, CF1 5LR, CF1 5LS, CF1 5LU, CF1 5LX, CF1 5LY, CF1 5LZ, CF1 5NA, CF1 5NB, CF1 5ND, CF1 5NE, CF1 5NG, CF1 5NH, CF1 5NJ, CF1 5NL, CF1 5NN, CF1 5NP, CF1 5NQ, CF1 5NR, CF1 5NS, CF1 5NU, CF1 5NW, CF1 5NX, CF1 5NY, CF1 5NZ, CF1 5PA, CF1 5PB, CF1 5PD, CF1 5PE, CF1 5PH, CF1 5PJ, CF1 5PS, CF1 5SA, CF1 5SB, CF1 5SL, CF1 5SP, CF1 5SQ, CF1 5TU, CF1 5UG, CF1 5UH, CF1 5UJ, CF1 5UL, CF1 5UN, CF1 5UQ, CF1 5US, CF1 5UT, CF1 5UU, CF10 4DF, CF10 4ED, CF10 4EW, CF10 4EZ, CF10 4LA, CF10 4LB, CF10 4LJ, CF10 4LL, CF10 4LP, CF10 4LQ, CF10 4LR, CF10 4LT, CF10 4LU, CF10 4LW, CF10 4LX, CF10 4LY, CF10 4LZ, CF10 4NP, CF10 4NR, CF10 4SB, CF10 4SP, CF10 4TR, CF10 4TS, CF10 4TZ, CF10 4US, CF10 4UU, CF10 4XZ, CF10 4YP, CF24 5DZ, CF24 5EG, CF24 5EU, CF24 5EW",137,121,16
W00009109,CF1,"CF1 7BP, CF1 7BQ, CF11 7AL, CF11 7BP, CF11 7BQ",190,175,15
W00009111,CF1,"CF1 7AH, CF1 7AJ, CF1 7AY, CF1 7DA, CF1 7DB, CF1 7DE, CF11 7AX, CF11 7DA, CF11 7DB, CF11 7DE",323,280,43
W00009134,CF1,"CF1 7TE, CF1 7TG, CF1 7TH, CF1 7TQ, CF11 6PJ, CF11 6SH, CF11 6TG, CF11 6TH, CF11 8TE",245,192,53
W00009135,CF1,"CF1 7NE, CF1 7QH, CF1 7QW, CF1 7QZ, CF1 7RB, CF11 6QB, CF11 6QH, CF11 6QR, CF11 6QW, CF11 6QZ",377,354,23
W00009136,CF1,"CF1 7PN, CF1 7PY, CF1 7SU, CF1 7TD, CF11 6PP, CF11 6PW, CF11 6PY, CF11 6SR",314,270,44
W00009633,CF1,"CF1 5EA, CF1 5EF, CF1 5SH, CF2 2AD, CF2 2AY, CF2 2AZ, CF2 2BA, CF2 2DG, CF2 2DQ, CF2 2DS, CF24 2AD, CF24 2AS, CF24 2AT, CF24 2AU, CF24 2AW, CF24 2AX, CF24 2BF, CF24 2BP, CF24 2DE, CF24 5EF, CF24 5EH",311,283,28
W00009137,CF1,"CF1 7PP, CF1 7PQ, CF1 7PS, CF1 7PW, CF1 7SR, CF1 7TA, CF11 6NS, CF11 6PQ, CF11 6PR, CF11 6PS",227,180,47
W00006291,CF1,"CF1 1HG, CF7 8DB, CF7 8DE, CF7 8LF, CF7 8LN, CF7 8LP, CF7 8QQ, CF7 8QR, CF7 8XZ, CF7 8YT, CF7 8YU, CF7 8YW, CF7 8YZ, CF72 8DB, CF72 8DE, CF72 8FA, CF72 8FF, CF72 8FJ, CF72 8GX, CF72 8LF, CF72 8LN, CF72 8LP, CF72 8LX, CF72 8QQ, CF72 8QR, CF72 8QY, CF72 8QZ, CF72 8TQ, CF72 8XZ, CF72 8YP, CF72 8YT, CF72 8YU, CF72 8YW, CF72 8YX, CF72 8YY, CF72 8ZP, CF72 8ZR",334,268,66
W00009204,CF1,"CF1 9PR, CF11 9QQ, CF5 1DG, CF5 1EA, CF5 2AA, CF5 2AD, CF5 2AE, CF5 2AR, CF5 2AS, CF5 2YD",242,202,40
W00005765,CF1,"CF1 1RD, CF1 1RE, CF1 1RW, CF1 1RZ, CF1 8AR, CF1 8AS, CF1 8AU, CF1 8AX, CF1 8AY, CF1 8AZ, CF11 8AR, CF11 8AS, CF11 8AU, CF11 8DR, CF6 4HE, CF6 4HF, CF6 4HJ, CF6 4HL, CF6 4HN, CF6 4HP, CF6 4HQ, CF6 4HR, CF6 4HT, CF64 4HE, CF64 4HF, CF64 4HJ, CF64 4HL, CF64 4HN, CF64 4HP, CF64 4HQ, CF64 4HR, CF64 4HT",317,265,52
W00009133,CF1,"CF1 7ND, CF1 7PJ, CF1 8AL, CF11 8AF, CF11 8EB, CF11 8EH, CF11 8NE, CF11 8TB, CF11 8TF",297,273,24
W00009386,CF1,"CF1 1RY, CF23 9AH, CF23 9AN, CF23 9AQ, CF23 9AY, CF23 9BX, CF23 9BY, CF23 9DP, CF23 9DQ, CF23 9DR, CF23 9DS, CF23 9FE, CF23 9UE, CF23 9UF, CF23 9UR, CF23 9UZ, CF23 9WB, CF23 9XE, CF23 9XL, CF23 9XP, CF23 9XR, CF23 9XU, CF23 9XW, CF23 9XX, CF23 9YF, CF23 9YG, CF23 9YP, CF3 7AB, CF3 7AH, CF3 7AQ, CF3 7UD, CF3 7UE, CF3 7UF, CF3 7UN, CF3 7UR, CF3 7UT, CF3 7UY, CF3 7XL, CF3 7XP, CF3 7XT, CF3 7XU, CF3 7XW, CF3 7XX, CF3 7XY, CF3 7XZ, CF3 7YF, CF3 7YG, CF3 7YJ, CF3 7YN, CF3 7YP, CF3 8DT",412,374,38
W00005833,CF1,"CF1 7RR, CF11 8RR, CF6 1LT, CF6 1LW, CF6 1LY, CF6 1LZ, CF64 2JQ, CF64 2LT, CF64 2LW, CF64 2LY, CF64 2LZ, CF64 2NE",375,318,57
W00010230,CF1,"CF1 6JF, CF1 6UB, CF10 5NE, CF10 5NU, CF10 5NW",136,124,12
W00010224,CF1,"CF1 7QP, CF1 7RJ, CF1 7RS, CF1 7RY, CF1 7SB, CF1 7YJ, CF1 7YL, CF11 6RS, CF11 6RY, CF11 6SB, CF11 6SJ",202,180,22
W00010223,CF1,"CF1 3DX, CF1 3DZ, CF1 3EQ, CF1 3TA, CF1 3TB, CF1 3TE, CF1 3TF, CF1 3TL, CF1 3TS, CF1 3TT, CF1 3TU, CF1 3TW, CF1 3TY, CF10 3DH, CF10 3DW, CF10 3DZ, CF10 3EQ, CF10 3EX, CF14 3UA, CF4 3AB",913,847,66
W00010216,CF1,"CF1 5LE, CF1 5LF, CF1 5LG, CF1 5LH, CF1 5LQ, CF1 5UA, CF1 5UB, CF1 5UP, CF1 6NL, CF1 6SJ, CF10 5EA, CF10 5FG, CF10 5FN, CF10 5LD, CF10 5LE, CF10 5LG, CF10 5LH, CF10 5LR, CF10 5QH, CF10 5QY, CF10 5QZ, CF10 5RP, CF10 5RU, CF10 5UA",226,208,18
W00010215,CF1,"CF1 5TN, CF10 4DE, CF10 4DH, CF10 4DL, CF10 4NG, CF10 4UY, CF10 4WG, CF10 4WT, CF10 4YA, CF10 4YD, CF10 4YE, CF10 4YG",219,197,22
W00010120,CF1,"CF1 5TD, CF1 5TE, CF10 4EH, CF10 4GH, CF10 4PB, CF10 4PD, CF10 4PE, CF10 4PH, CF10 4QP, CF10 4RH, CF10 4RU, CF10 4WA",287,262,25
W00010212,CF1,"CF1 3TD, CF1 3UH, CF10 3DX, CF10 3EZ, CF10 3HA",110,107,3
W00009408,CF1,"CF1 1RR, CF2 1RE, CF2 1RF, CF2 1RP, CF2 1RT, CF2 1RY, CF2 1RZ, CF2 1UB, CF23 9AA, CF23 9AB, CF23 9AD, CF23 9AE, CF23 9AF, CF23 9FF, CF23 9FP, CF23 9YA, CF23 9YB, CF23 9YN, CF24 1EW, CF24 1FA, CF24 1GG, CF24 1PT, CF24 1RE, CF24 1RF, CF24 1RL, CF24 1RN, CF24 1RP, CF24 1RQ, CF24 1RT, CF24 1RY, CF24 1RZ, CF24 1TP, CF24 1UB, CF24 1WQ, CF3 7AA, CF3 7AD, CF3 7AE, CF3 7AF, CF3 7AJ, CF3 7AL, CF3 7AN, CF3 7UA, CF3 7UB, CF3 7UG, CF3 7UL, CF3 7YA, CF3 7YB, CF3 7YD, CF3 7YY, CF3 7YZ, CF3 8AA, CF3 8DA, CF3 8DE",248,233,15
W00009110,CF1,"CF1 7AG, CF1 7AR, CF1 7AW, CF1 7AX, CF1 7BN, CF1 7JZ, CF1 7LA, CF1 7LE, CF1 7LJ, CF1 7LN, CF1 7LP, CF1 7LR, CF1 7UF, CF1 7UX, CF1 7XT, CF1 7XU, CF1 7YD, CF1 7YE, CF1 7YQ, CF1 7YU, CF1 7YW, CF1 7YX, CF11 7JZ, CF11 7LE, CF11 7LJ, CF11 7LN, CF11 7LQ, CF11 7LR",374,305,69
W00009132,CF1,"CF1 7BB, CF1 7JA, CF1 7JU, CF1 7QX, CF1 7XX, CF1 7YS, CF11 6JU, CF11 6JW, CF11 6NH, CF11 6QE, CF11 6QX, CF11 6XX",299,278,21
W00009130,CF1,"CF1 7SA, CF1 7SE, CF1 7SP, CF1 7SS, CF1 7SX, CF1 7SZ, CF1 7TJ, CF1 7TL, CF11 6SE, CF11 6TA, CF11 6TB, CF11 6TD, CF11 6TE",262,230,32
W00009112,CF1,"CF1 7HN, CF1 7JB, CF1 7LG, CF1 7NP, CF1 7XY, CF1 7XZ, CF11 7HN, CF11 7JB, CF11 7JD, CF11 7JE, CF11 7LA, CF11 7LG",387,351,36
W00009113,CF1,"CF1 7DF, CF1 7DJ, CF11 7BU, CF11 7BX, CF11 7BY, CF11 7BZ, CF11 7DH",325,272,53
W00009114,CF1,"CF1 7DS, CF1 7DY, CF1 7DZ, CF1 7XB, CF1 7XG, CF11 7AY, CF11 7BR, CF11 7BS, CF11 7DS, CF11 7DY, CF11 7JR, CF11 7XB",408,355,53
W00009115,CF1,"CF1 6RY, CF1 7AL, CF1 7AS, CF11 7AS, CF11 7DZ, CF11 7EA",306,282,24
W00009116,CF1,"CF1 7BT, CF1 7BU, CF1 7BW, CF1 7BX, CF1 7BY, CF1 7BZ, CF1 7DG, CF1 7XS, CF11 7DG, CF11 7DL, CF11 7DN, CF11 7EQ, CF11 7ER, CF11 7HF, CF11 7HH, CF11 7WA, CF11 7WG, CF11 7WN, CF11 7WQ, CF11 7WX, CF11 7XG, CF11 7YB, CF11 7YF, CF11 7YH, CF11 7YJ, CF11 7YL, CF11 7YN",317,252,65
W00009117,CF1,"CF1 7DL, CF1 7DR, CF1 7EQ, CF1 7ET, CF1 7EU, CF1 7EW, CF1 7EX, CF1 7EY, CF1 7HA, CF1 7HB, CF1 7HF, CF1 7HG, CF1 7HH, CF1 7HP, CF1 7JE, CF1 7JF, CF1 7JN, CF1 7LF, CF1 7LH, CF11 7ET, CF11 7EU, CF11 7EW, CF11 7EY, CF11 7HP, CF11 7JF, CF11 7JG, CF11 7NA",447,411,36
W00009118,CF1,"CF1 7DP, CF1 7DQ, CF1 7HE, CF11 7DW, CF11 7ED, CF11 7HA, CF11 7HG, CF11 7HQ, CF11 7JP",248,233,15
W00010119,CF1,"CF1 3EF, CF1 3EL, CF1 3EP, CF1 3ET, CF1 3EU, CF10 3EF, CF10 3EL, CF10 3EP, CF10 3EY, CF10 3UN",660,603,57
W00009131,CF1,"CF1 2TF, CF1 7JT, CF1 7QG, CF1 7QJ, CF1 7RF, CF1 7RH, CF11 6JT, CF11 6NF, CF11 6NG, CF11 6QG, CF11 6QJ, CF11 6RB, CF11 6RH",328,283,45
W00009120,CF1,"CF1 6RZ, CF1 7EE, CF1 7EG, CF1 7EL, CF1 7EN, CF1 7EP, CF1 7HU, CF1 7HX, CF1 7HY, CF1 7JQ, CF11 0JA, CF11 0JL, CF11 7EE, CF11 7EG, CF11 7EL, CF11 7EN, CF11 7EP",374,330,44
W00009123,CF1,"CF1 7SG, CF1 7SN, CF1 7ST, CF11 6SF, CF11 6SL, CF11 6SN, CF11 6SP, CF11 6ST, CF11 6SW, CF11 6TF, CF11 6WD, CF11 6WE, CF11 6WG, CF11 6XD, CF11 6XG, CF11 6XY, CF11 6YB, CF11 6YD",496,432,64
W00009647,CF1,"CF1 1TN, CF1 5EJ, CF1 5EL, CF1 5QS, CF1 5SD, CF1 5SJ, CF1 5TY, CF1 5TZ, CF1 5XB, CF1 5XF, CF1 5XH, CF1 5XL, CF1 5XN, CF1 5XP, CF1 5XS, CF1 5XT, CF1 5XY, CF2 2YA, CF2 2YB, CF2 2YT, CF2 2YU, CF2 2YW, CF2 2YX, CF2 2YY, CF2 2YZ, CF24 5AA, CF24 5AB, CF24 5BH, CF24 5BS, CF24 5ED, CF24 5EE, CF24 5EJ, CF24 5EL, CF24 5EN, CF24 5EP, CF24 5ES, CF24 5ET, CF24 5EX, CF24 5EY, CF24 5FA, CF24 5GT, CF24 5HA, CF24 5HB, CF24 5HE, CF24 5HF, CF24 5HG, CF24 5HH, CF24 5HL, CF24 5HN, CF24 5HP, CF24 5HQ, CF24 5JB, CF24 5JQ, CF24 5JR, CF24 5JS, CF24 5JT, CF24 5JU, CF24 5JW, CF24 5JX, CF24 5LQ, CF24 5NA, CF24 5NB, CF24 5ND, CF24 5NE, CF24 5NN, CF24 5PA, CF24 5PB, CF24 5PD, CF24 5PE, CF24 5PF, CF24 5PG, CF24 5PJ, CF24 5PS, CF24 5RE, CF24 5RR, CF24 5SA, CF24 5SL, CF24 5SP, CF24 5TD, CF24 5TE, CF24 5TF, CF24 5TG, CF24 5TW, CF24 5UA, CF24 5UB, CF24 5WB, CF24 5WF, CF24 5XH, CF24 5YF",358,327,31
W00009125,CF1,"CF1 7SY, CF11 6SX, CF11 6SY, CF11 6SZ, CF11 6TJ, CF11 6TL, CF11 9YU",342,295,47
W00009645,CF1,"CF1 5EB, CF2 2EP, CF2 2ER, CF2 2EW, CF2 2EX, CF2 2EY, CF2 2FY, CF24 2EL, CF24 2EQ, CF24 2ER, CF24 2EW, CF24 2EZ, CF24 5EB, CF24 5ER, CF24 5FB, CF24 5FD, CF24 5FF, CF24 5HS",409,385,24
W00009126,CF1,"CF1 7SH, CF1 7TB, CF1 8HD, CF1 8HE, CF1 8HP, CF1 8HY, CF1 8JE, CF1 8US, CF11 6US, CF11 8EA, CF11 8ES, CF11 8ET, CF11 8JN, CF11 8ND",352,313,39
W00009127,CF1,"CF1 7PL, CF1 7RD, CF1 7RZ, CF1 7SD, CF1 7SF, CF1 7SJ, CF1 7SL, CF1 7SQ, CF11 6PL, CF11 6PN, CF11 6RZ, CF11 6SA, CF11 6SD, CF11 6SQ, CF11 6SS, CF11 6SU",334,293,41
W00009128,CF1,"CF1 7QY, CF1 7RA, CF1 7RE, CF1 7RG, CF1 7YH, CF11 6QY, CF11 6RA, CF11 6RE, CF11 6RF, CF11 6RG, CF11 6RJ",337,296,41
W00009129,CF1,"CF1 7QQ, CF1 7QR, CF1 7QT, CF1 7QU, CF1 7RT, CF10 1UJ, CF11 6DA, CF11 6PD, CF11 6PZ, CF11 6QP, CF11 6QQ, CF11 6QU, CF11 6RD, CF11 6RT, CF11 6YJ",441,405,36
W00009121,CF1,"CF1 7DW, CF1 7DX, CF11 7HB, CF11 7HU, CF11 7HW, CF11 7HX, CF11 7HY, CF11 7JA, CF11 7NF",295,289,6
W00009574,CF1,"CF1 8ES, CF1 8ET, CF1 8EU, CF1 8EW, CF1 8EX, CF1 8HA, CF1 8HZ, CF1 8JA, CF1 8JB, CF11 6EH, CF11 6ET, CF11 6HA, CF11 6HW, CF11 6JA, CF11 6JB",365,318,47
W00008813,CF10,"CF10 4BH, CF10 4BJ, CF10 4BL, CF10 4EQ",248,213,35
W00010186,CF10,"CF10 4BR, CF10 4DP, CF10 4DR, CF10 4DS",181,161,20
W00010204,CF10,"CF10 5NH, CF10 5NL",224,199,25
W00010203,CF10,"CF10 5FP, CF10 5GN, CF10 5GW, CF10 5GX, CF10 5HS",183,169,14
W00010202,CF10,"CF10 5FD, CF10 5NN, CF10 5NP, CF10 5NQ",212,195,17
W00010196,CF10,"CF10 5NX, CF10 5NZ",169,159,10
W00010194,CF10,"CF10 4EB, CF10 4EG, CF10 4EL, CF10 4ET",363,328,35
W00010193,CF10,"CF10 5NT, CF10 5NY",311,284,27
W00010171,CF10,"CF10 4EJ, CF10 4ER, CF10 4ES, CF10 4JA, CF10 4JE, CF10 4UW, CF10 4ZA, CF11 1YB, CF11 1YH, CF11 1YL, CF11 1YN, CF11 1YP, CF11 1YQ, CF11 1YR, CF11 1YS, CF11 1YT, CF11 1YU, CF11 1YW, CF11 1YX, CF11 1YY, CF11 1YZ, CF11 1ZA, CF11 1ZB, CF11 1ZD, CF11 1ZF, CF11 1ZG, CF11 1ZH, CF11 1ZJ, CF11 1ZL, CF11 1ZN, CF11 1ZP, CF11 1ZQ, CF11 1ZR, CF11 1ZS, CF11 1ZU, CF11 1ZW, CF11 1ZX, CF11 1ZY",281,258,23
W00010160,CF10,"CF10 5FY, CF10 5LQ",186,163,23
W00010197,CF10,"CF10 4JB, CF10 4JD, CF10 4JF",189,175,14
W00010137,CF10,"CF10 2FF, CF10 2FG, CF10 2FH, CF10 2FJ, CF10 2TE",328,308,20
W00010133,CF10,"CF10 4RA, CF10 4RB, CF10 4RD, CF10 4RE",310,278,32
W00010129,CF10,"CF10 4BS, CF10 4EA, CF10 4EE, CF10 4EU, CF10 4NL",167,136,31
W00010149,CF11,"CF11 0JB, CF11 0JD, CF11 0JE, CF11 0JP, CF11 0LE, CF11 0LF",335,300,35
W00008870,CF11,"CF11 8PH, CF5 1BE, CF5 1JR, CF5 1JS, CF5 1JU, CF5 1JW, CF5 1JZ, CF5 1LA, CF5 1LB",309,242,67
W00009850,CF11,"CF11 7HR, CF6 6UU, CF63 4AU, CF63 4BB, CF63 4BD, CF63 4BE, CF63 4BF, CF63 4DA, CF63 4DE, CF63 4DH, CF63 4DL",297,272,25
W00008880,CF11,"CF11 6HP, CF11 6HR, CF5 1PB, CF5 1PD, CF5 1PE, CF5 1PH, CF5 1PJ, CF5 1PN, CF5 1PP, CF5 1PZ",366,288,78
W00008893,CF11,"CF11 8GE, CF11 8GJ, CF5 1AA, CF5 1AB, CF5 1AJ, CF5 1AR, CF5 1BP, CF5 2BY, CF5 2BZ",338,269,69
W00009092,CF11,"CF11 7BF, CF11 7FA, CF11 7FB, CF11 7GX, CF11 7PE, CF11 7QA",283,248,35
W00009093,CF11,"CF11 7EB, CF11 7JJ, CF11 7QB, CF11 7QE, CF11 7TQ",347,319,28
W00009119,CF11,"CF11 7BN, CF11 7EX, CF11 7FE, CF11 7HZ, CF11 7JL, CF11 7JN",353,318,35
W00010213,CF11,"CF11 8BU, CF5 1PS",132,123,9
W00010211,CF11,"CF11 0AL, CF11 0AN, CF11 0AP, CF11 0AQ, CF11 0BA, CF11 0SN, CF11 0WW",150,140,10
W00010586,CF11,"CF11 0JX, CF11 0JY, CF11 0JZ, CF11 0SY, CF11 0TA, CF11 0TB",258,237,21
W00010528,CF11,"CF11 8EL, CF11 8EN, CF11 8EP, CF11 8SX",377,324,53
W00010158,CF11,"CF11 0SG, CF11 0SH, CF11 0SJ, CF11 0SW, CF11 0UZ",332,286,46
W00010138,CF11,"CF11 0JN, CF11 0JQ, CF11 0LA, CF11 0LB",350,317,33
W00010649,CF11,"CF11 8AD, CF11 8AH",117,101,16
W00010143,CF11,"CF11 0AS, CF11 0AT, CF11 0AW",273,249,24
W00010167,CF11,"CF11 0JF, CF11 0JG",180,165,15
W00010165,CF11,"CF11 0AX, CF11 0AY, CF11 0AZ, CF11 0SE, CF11 0SF",365,336,29
W00010164,CF11,"CF11 0SA, CF11 0SB, CF11 0SD",214,186,28
W00010574,CF11,"CF11 0JS, CF11 0JT, CF11 0JU, CF11 0JW, CF11 0SP",238,209,29
W00010161,CF11,"CF11 0AU, CF11 0JH, CF11 0JJ, CF11 0LD",288,257,31
W00010636,CF11,"CF11 8DS, CF11 8FE, CF11 8FG, CF11 8FH, CF11 8FJ, CF11 8FL, CF11 8FP, CF11 8FQ, CF11 8FR",255,188,67
W00010546,CF11,"CF11 8FX, CF11 8FY, CF11 8FZ",206,175,31
W00005834,CF11,"CF11 8EF, CF11 8TD, CF6 1LL, CF6 1LN, CF6 1LP, CF6 1NA, CF64 2LL, CF64 2LN, CF64 2LP, CF64 2NA, CF64 2NN",217,199,18
W00009585,CF11,"CF11 9DF, CF11 9DG, CF11 9DL, CF11 9DQ, CF11 9HL",237,182,55
W00009751,CF14,"CF14 2TA, CF14 2TB, CF14 2TG, CF14 2TP, CF14 2TT, CF14 7BF, CF14 7JH, CF14 7JJ, CF14 7JL, CF14 7JN, CF14 7JP, CF14 7JQ, CF14 7JR, CF14 7JS, CF4 7JA, CF4 7JH, CF4 7JJ, CF4 7JL, CF4 7JN, CF4 7YT",423,349,74
W00009259,CF14,"CF14 5PQ, CF14 5PR, CF14 5QF, CF14 5QG, CF4 5PR, CF4 5QG",259,245,14
W00009260,CF14,"CF14 5GJ, CF14 5GL, CF14 5PS, CF14 5PT, CF14 5QD, CF14 5QE, CF14 5UP, CF4 5PT, CF4 5PU, CF4 5QB, CF4 5QD, CF4 5QE, CF4 5QF, CF4 5WF",302,281,21
W00009261,CF14,"CF14 5FA, CF14 5FY, CF14 5LQ, CF14 5LR, CF14 5QH, CF14 5QJ, CF14 5QL, CF14 5QN, CF4 4HR, CF4 5FA, CF4 5LJ, CF4 5LP, CF4 5NU, CF4 5NW",333,291,42
W00009262,CF14,"CF14 0FL, CF14 9FH, CF14 9HD, CF14 9HF, CF14 9JJ",274,240,34
W00009263,CF14,"CF14 9JB, CF14 9JD, CF14 9JF, CF14 9JG, CF14 9JH, CF14 9JL",385,338,47
W00009543,CF14,"CF14 4SL, CF14 4SN, CF14 4SP, CF14 4SQ, CF14 4SR, CF14 4SU, CF14 4SY, CF4 4SL, CF4 4SN, CF4 4SQ, CF4 4SR, CF4 4SY",315,234,81
W00009265,CF14,"CF14 9DS, CF14 9DW, CF14 9HE, CF14 9HH, CF14 9HJ, CF4 9BW, CF4 9BX, CF4 9BY, CF4 9DS, CF4 9DT, CF4 9DU, CF4 9DW, CF4 9DX, CF4 9DY, CF4 9DZ, CF4 9EQ, CF4 9ER, CF4 9HA, CF4 9HB, CF4 9HD, CF4 9HE, CF4 9HF, CF4 9HG, CF4 9HH, CF4 9HJ, CF4 9HL, CF4 9HN, CF4 9HP, CF4 9HQ, CF4 9HR, CF4 9HS, CF4 9HT, CF4 9HU, CF4 9HW, CF4 9HX, CF4 9HY, CF4 9HZ, CF4 9JA, CF4 9JB, CF4 9JD, CF4 9JE, CF4 9JF, CF4 9JG, CF4 9JH, CF4 9JJ, CF4 9JL, CF4 9LA, CF4 9XB, CF4 9XD, CF4 9XE, CF4 9XF, CF4 9XG, CF4 9XH, CF4 9XJ, CF4 9XL, CF4 9XN",263,237,26
W00009258,CF14,"CF14 5PP, CF14 5PY, CF14 5PZ, CF14 5QA, CF14 5QB, CF4 5DX, CF4 5PP, CF4 5PQ, CF4 5PX, CF4 5PZ, CF4 5QA",355,320,35
W00009266,CF14,"CF14 9BS, CF14 9BU, CF14 9BY, CF14 9DU, CF14 9ER, CF14 9FE, CF4 9BT",244,200,44
W00009268,CF14,"CF14 9BW, CF14 9DG, CF14 9DT, CF14 9EQ, CF14 9GB",224,194,30
W00009269,CF14,"CF14 9EA, CF14 9EB, CF14 9HY, CF14 9XG, CF14 9XJ, CF14 9XL, CF14 9YB, CF14 9YE, CF14 9YG, CF14 9YS, CF4 9EA, CF4 9EB, CF4 9EE, CF4 9XA, CF4 9YA, CF4 9YF, CF4 9YH, CF4 9YL, CF4 9YP, CF4 9YQ, CF4 9YR, CF4 9YS, CF4 9YU, CF4 9YW, CF4 9YX, CF4 9YY, CF4 9YZ",260,235,25
W00009270,CF14,"CF14 9AB, CF14 9DX, CF14 9FA, CF14 9FJ, CF14 9FL, CF14 9HS",261,244,17
W00009271,CF14,"CF14 9BT, CF14 9BX, CF14 9DB, CF14 9DE, CF4 9DB, CF4 9DE, CF4 9DF, CF4 9DH, CF4 9DL",217,192,25
W00009272,CF14,"CF14 9BZ, CF14 9DF, CF14 9DL, CF4 9AZ",274,242,32
W00009273,CF14,"CF14 9BB, CF14 9ED, CF14 9GA, CF14 9HR, CF14 9HT, CF14 9HU, CF4 9ED",223,196,27
W00009274,CF14,"CF14 9AQ, CF14 9AT, CF14 9AX, CF14 9BA, CF14 9DP, CF14 9DR, CF14 9HQ, CF4 9AT, CF4 9AX, CF4 9BB",267,240,27
W00009275,CF14,"CF14 5AT, CF14 9BJ, CF14 9BL, CF14 9BN, CF14 9DA, CF14 9DD, CF4 9BL, CF4 9BZ, CF4 9DA, CF4 9DD",233,202,31
W00009267,CF14,"CF14 9EE, CF14 9EF, CF14 9EN, CF14 9EP, CF14 9ET, CF14 9EU, CF14 9HZ, CF4 9EN, CF4 9EP, CF4 9ET, CF4 9EU, CF4 9EW, CF4 9EX",228,198,30
W00009256,CF14,"CF14 0LY, CF14 0NE, CF14 0NN, CF14 0NR, CF14 0NT, CF14 0PB, CF14 5NL, CF4 5LY, CF4 5NE, CF4 5NN, CF4 5NP, CF4 5NR, CF4 5NS, CF4 5NT, CF4 5YW",362,300,62
W00009255,CF14,"CF14 5BP, CF14 5BR, CF14 5HA, CF14 5HB, CF14 5HD, CF4 5BJ, CF4 5BL, CF4 5BP, CF4 5BR",276,236,40
W00009254,CF14,"CF14 5BE, CF14 5DY, CF14 5DZ, CF14 5EA, CF14 5EH, CF14 5ER, CF14 5EX, CF14 5EZ, CF14 5FN, CF14 5LT, CF14 5LU, CF14 5PD, CF14 5QP, CF14 5YU, CF14 5ZD, CF4 5AE, CF4 5DW, CF4 5EA, CF4 5EH, CF4 5LS, CF4 5LT, CF4 5LU, CF4 5NA, CF4 5PD, CF4 5PE, CF4 5PF, CF4 5UT, CF4 5YU, CF4 5ZD",334,293,41
W00009237,CF14,"CF14 3HL, CF14 3HN, CF14 3HP, CF14 3HR, CF14 3HT, CF14 3HW, CF4 1EL, CF4 3HB, CF4 3HL, CF4 3HN, CF4 3HP, CF4 3HQ, CF4 3HT",420,382,38
W00009238,CF14,"CF14 2HU, CF14 2HW, CF14 2HX, CF14 2JA, CF14 2NR, CF14 2NX, CF14 2PE, CF4 2HP, CF4 2HU, CF4 2HW, CF4 2HX, CF4 2HZ, CF4 2NR, CF4 2NX",283,232,51
W00009239,CF14,"CF14 2SN, CF14 2SP, CF14 2SQ, CF14 2SR, CF4 2RX, CF4 2SQ, CF4 2SR",311,282,29
W00009240,CF14,"CF14 2QN, CF14 2QP, CF14 2QQ, CF14 2QR, CF14 2QS, CF14 2QT, CF4 2PA, CF4 2PB, CF4 2PF, CF4 2QN, CF4 2QP, CF4 2QQ, CF4 2QR, CF4 2QS, CF4 2QT, CF4 2QU, CF4 2QW, CF4 2RU",289,249,40
W00009241,CF14,"CF14 0GP, CF14 0WB, CF14 0WD, CF14 0WP, CF14 0WQ, CF14 0WR, CF14 0WT, CF14 0WY, CF14 0WZ, CF14 0YA, CF14 0YD, CF14 0YG, CF14 0YH, CF14 0YJ, CF14 0YL, CF14 0YN, CF14 0YP, CF14 0YQ, CF14 0YR, CF14 0YS, CF14 0YT, CF14 0YU, CF14 0YX, CF14 0YY, CF14 0YZ, CF14 0ZA, CF14 0ZS, CF14 0ZT, CF14 0ZU, CF14 1WR, CF14 1WY, CF14 1YA, CF14 1YB, CF14 1YD, CF14 1YE, CF14 1YF, CF14 1YG, CF14 1YH, CF14 1YL, CF14 1YN, CF14 1YP, CF14 1YQ, CF14 1YR, CF14 1YT, CF14 1YU, CF14 1YX, CF14 1YZ, CF14 1ZG, CF14 1ZQ, CF14 1ZR, CF14 1ZS, CF14 1ZT, CF14 1ZU, CF14 1ZW, CF14 1ZX, CF14 2DL, CF14 2WN, CF14 2WZ, CF14 2YA, CF14 2YB, CF14 2YD, CF14 2YE, CF14 2YF, CF14 2YH, CF14 2YJ, CF14 2YL, CF14 2YN, CF14 2YP, CF14 2YQ, CF14 2YR, CF14 2YS, CF14 2YT, CF14 2YU, CF14 2YW, CF14 2YX, CF14 2YZ, CF14 2ZR, CF14 2ZS, CF14 2ZW, CF14 2ZX, CF14 3TF, CF14 3TG, CF14 3TN, CF14 3TR, CF14 3TS, CF14 3TT, CF14 3TX, CF14 3UE, CF14 3UG, CF14 3UN, CF14 3UP, CF14 3WA, CF14 3WB, CF14 3WD, CF14 3WE, CF14 3WF, CF14 3WR, CF14 3XA, CF14 3XD, CF14 3XH, CF14 3XJ, CF14 3XN, CF14 3XT, CF14 3XZ, CF14 3YA, CF14 3YJ, CF14 3YP, CF14 3YW, CF14 3YX, CF14 3YY, CF14 3YZ, CF14 3ZY, CF14 4TS, CF14 4UA, CF14 4UF, CF14 4UL, CF14 4WP, CF14 4WX, CF14 4WY, CF14 4XD, CF14 4XG, CF14 4XQ, CF14 4XX, CF14 4YA, CF14 4YB, CF14 4YE, CF14 4YF, CF14 4YN, CF14 4YQ, CF14 4YR, CF14 4YT, CF14 4YW, CF14 4YX, CF14 4ZD, CF14 4ZJ, CF14 4ZP, CF14 4ZS, CF14 4ZW, CF14 4ZY, CF14 5BA, CF14 5BG, CF14 5DL, CF14 5DN, CF14 5FU, CF14 5FW, CF14 5GF, CF14 5GG, CF14 5GP, CF14 5GS, CF14 5GT, CF14 5JA, CF14 5LF, CF14 5LG, CF14 5LH, CF14 5LJ, CF14 5LL, CF14 5LN, CF14 5LP, CF14 5QS, CF14 5WA, CF14 5WB, CF14 5WG, CF14 5WN, CF14 5WQ, CF14 5WS, CF14 5WU, CF14 5WW, CF14 5XA, CF14 5XB, CF14 5XG, CF14 5XN, CF14 5XU, CF14 5XW, CF14 5XX, CF14 5YB, CF14 5YE, CF14 5YG, CF14 5YS, CF14 5YT, CF14 5YW, CF14 5YY, CF14 5ZJ, CF14 5ZS, CF14 5ZW, CF14 5ZY, CF14 6WA, CF14 6WB, CF14 6WD, CF14 6WE, CF14 6WF, CF14 6WH, CF14 6WQ, CF14 6XA, CF14 6XZ, CF14 6YG, CF14 6YH, CF14 6YL, CF14 6YN, CF14 6YP, CF14 6YQ, CF14 6YR, CF14 6YT, CF14 6YU, CF14 6YW, CF14 6YY, CF14 6YZ, CF14 6ZB, CF14 6ZE, CF14 6ZG, CF14 6ZQ, CF14 7TX, CF14 7WB, CF14 7WE, CF14 7WY, CF14 7XT, CF14 7XY, CF14 7YA, CF14 7YB, CF14 7YD, CF14 7YE, CF14 7YG, CF14 7YH, CF14 7YJ, CF14 7YL, CF14 7YN, CF14 7YQ, CF14 7YY, CF14 7ZQ, CF14 7ZY, CF14 8AA, CF14 8AB, CF14 8AD, CF14 8AE, CF14 8AF, CF14 8AG, CF14 8AH, CF14 8AL, CF14 8AN, CF14 8AP, CF14 8AQ, CF14 8AR, CF14 8AS, CF14 8AT, CF14 8AU, CF14 8AW, CF14 8AX, CF14 8AY, CF14 8AZ, CF14 8BA, CF14 8BB, CF14 8BD, CF14 8BE, CF14 8BF, CF14 8BG, CF14 8BH, CF14 8BJ, CF14 8BL, CF14 8BN, CF14 8BP, CF14 8BQ, CF14 8BR, CF14 8BS, CF14 8BT, CF14 8BU, CF14 8BW, CF14 8BX, CF14 8BY, CF14 8BZ, CF14 8DA, CF14 8DB, CF14 8DD, CF14 8DE, CF14 8DF, CF14 8DG, CF14 8DH, CF14 8DJ, CF14 8DL, CF14 8DN, CF14 8DP, CF14 8DQ, CF14 8DR, CF14 8DS, CF14 8DU, CF14 8DW, CF14 8DX, CF14 8DY, CF14 8DZ, CF14 8EA, CF14 8EB, CF14 8ED, CF14 8EE, CF14 8EF, CF14 8EG, CF14 8EH, CF14 8EJ, CF14 8EL, CF14 8EN, CF14 8EP, CF14 8EQ, CF14 8ER, CF14 8ES, CF14 8ET, CF14 8EU, CF14 8EW, CF14 8EX, CF14 8EY, CF14 8EZ, CF14 8FA, CF14 8FB, CF14 8FD, CF14 8FE, CF14 8FF, CF14 8FG, CF14 8FJ, CF14 8FL, CF14 8FN, CF14 8FP, CF14 8FQ, CF14 8FR, CF14 8FS, CF14 8FT, CF14 8FU, CF14 8FW, CF14 8FX, CF14 8FY, CF14 8FZ, CF14 8GA, CF14 8GB, CF14 8GD, CF14 8GE, CF14 8GF, CF14 8GG, CF14 8GH, CF14 8GJ, CF14 8GL, CF14 8GN, CF14 8GP, CF14 8GQ, CF14 8GR, CF14 8GS, CF14 8GT, CF14 8GU, CF14 8GW, CF14 8GX, CF14 8GY, CF14 8GZ, CF14 8HA, CF14 8HB, CF14 8HD, CF14 8HE, CF14 8HF, CF14 8HG, CF14 8HH, CF14 8HJ, CF14 8HL, CF14 8HN, CF14 8HP, CF14 8HQ, CF14 8HR, CF14 8HS, CF14 8HT, CF14 8HU, CF14 8HW, CF14 8HX, CF14 8HY, CF14 8HZ, CF14 8JA, CF14 8JB, CF14 8JD, CF14 8JE, CF14 8JF, CF14 8JG, CF14 8JH, CF14 8JJ, CF14 8JL, CF14 8JN, CF14 8JP, CF14 8JQ, CF14 8JR, CF14 8JS, CF14 8JT, CF14 8JU, CF14 8JW, CF14 8JX, CF14 8JY, CF14 8JZ, CF14 8LA, CF14 8LB, CF14 8LD, CF14 8LE, CF14 8LF, CF14 8LG, CF14 8LH, CF14 8LJ, CF14 8LL, CF14 8LN, CF14 8LP, CF14 8LQ, CF14 8LR, CF14 8LS, CF14 8LT, CF14 8LU, CF14 8LW, CF14 8LX, CF14 8LY, CF14 8LZ, CF14 8NA, CF14 8NB, CF14 8ND, CF14 8NG, CF14 8NH, CF14 8NJ, CF14 8NL, CF14 8NN, CF14 8NP, CF14 8NQ, CF14 8NR, CF14 8NS, CF14 8NT, CF14 8NU, CF14 8NW, CF14 8NX, CF14 8NY, CF14 8NZ, CF14 8PA, CF14 8PB, CF14 8PD, CF14 8PE, CF14 8PF, CF14 8PG, CF14 8PH, CF14 8PJ, CF14 9WA, CF14 9WB, CF14 9WD, CF14 9WH, CF14 9WP, CF14 9WT, CF14 9XA, CF14 9XD, CF14 9XE, CF14 9XF, CF14 9XN, CF14 9XP, CF14 9XU, CF14 9YA, CF14 9YD, CF14 9YF, CF14 9YH, CF14 9YJ, CF14 9YL, CF14 9YN, CF14 9YP, CF14 9YQ, CF14 9YR, CF14 9YT, CF14 9YU, CF14 9YW, CF14 9YX, CF14 9YY, CF14 9YZ, CF14 9ZR, CF14 9ZS, CF14 9ZY, CF4 5DN, CF4 5JA, CF4 5LF, CF4 5LG, CF4 5LH, CF4 5LL, CF4 5LN, CF4 5LQ, CF4 5LR, CF4 5PS, CF4 5QN, CF4 5QP, CF4 5QS, CF4 5QT, CF4 5QZ, CF4 5WJ, CF4 5WN, CF4 5WU, CF4 5ZJ, CF4 5ZW",315,289,26
W00009242,CF14,"CF14 9DY, CF14 9EZ, CF14 9HL, CF14 9HN, CF4 9EY, CF4 9EZ, CF4 9FA, CF4 9FB, CF4 9FD, CF4 9FE, CF4 9FF, CF4 9FG, CF4 9FH, CF4 9GA, CF4 9GY, CF4 9GZ",331,289,42
W00009243,CF14,"CF14 9BQ, CF14 9BR, CF14 9EX, CF14 9EY, CF14 9FB, CF14 9FD, CF14 9FG, CF14 9JE, CF14 9LA, CF4 9BQ, CF4 9BS, CF4 9BU, CF4 9EL",326,283,43
W00009244,CF14,"CF14 9DZ, CF14 9EW, CF14 9HW, CF14 9HX",257,212,45
W00009245,CF14,"CF14 9AA, CF14 9FF, CF14 9FN, CF14 9FP, CF14 9UE, CF4 5BH",452,378,74
W00009246,CF14,"CF14 9EG, CF14 9EH, CF14 9EJ, CF14 9EL, CF14 9FR, CF14 9HG, CF4 9EF, CF4 9EG, CF4 9EH, CF4 9EJ",338,288,50
W00009247,CF14,"CF14 9BG, CF14 9BH, CF14 9BP, CF14 9DQ, CF14 9LB, CF4 9BG, CF4 9BH, CF4 9BJ, CF4 9BN, CF4 9BP, CF4 9BR, CF4 9DG, CF4 9DJ, CF4 9DP, CF4 9DQ",300,257,43
W00009248,CF14,"CF14 9AG, CF14 9AN, CF14 9AP, CF14 9AU, CF14 9HP, CF4 9AN, CF4 9AU, CF4 9BA",281,253,28
W00009249,CF14,"CF14 0BG, CF14 0RA, CF14 0RY, CF14 0SA, CF14 0SB, CF14 0SE, CF14 0TY, CF14 0XA, CF14 0XB, CF14 0XQ, CF4 5JE, CF4 5RA, CF4 5RY, CF4 5SB, CF4 5TY, CF4 5XA, CF4 5XB, CF4 5XH, CF4 5XL, CF4 5XQ, CF4 5XT, CF4 5XU, CF4 5XX",297,247,50
W00009250,CF14,"CF14 5BX, CF14 5BY, CF14 5BZ, CF14 5DF, CF14 5DG, CF14 5EE, CF14 5EG, CF14 5GB, CF14 5QT, CF14 5ST, CF14 5WY, CF14 5XT, CF14 5YH, CF14 5YR, CF14 5ZU, CF4 5BW, CF4 5BY, CF4 5DA, CF4 5DF, CF4 5DG, CF4 5EF, CF4 5YN",274,243,31
W00009251,CF14,"CF14 0NG, CF14 0NP, CF14 0NQ, CF14 0NS, CF14 0RF, CF14 0RH, CF14 0YW, CF14 5PA, CF4 5NQ, CF4 5RF, CF4 5RG, CF4 5RH",373,307,66
W00009252,CF14,"CF14 0NJ, CF14 5DW, CF14 5LZ, CF14 5NA, CF14 5NB, CF14 5ND, CF14 5NG, CF14 5NH, CF14 5UT, CF14 5UY, CF14 5UZ, CF14 5YX, CF4 5LZ, CF4 5NG, CF4 5NH, CF4 5PA, CF4 5TS, CF4 5UU, CF4 5UY, CF4 5UZ, CF4 5YX",406,337,69
W00009253,CF14,"CF14 5DU, CF14 5DX, CF14 5GH, CF14 5PB, CF14 5PH, CF14 5PU, CF14 5PW, CF14 5PX, CF14 5QQ, CF14 5RA, CF14 5WF, CF14 5WJ, CF14 5WZ, CF14 5YP, CF14 5YQ, CF4 1YB, CF4 1YE, CF4 1YG, CF4 1YN, CF4 5DJ, CF4 5DU, CF4 5DY, CF4 5DZ, CF4 5NJ, CF4 5NL, CF4 5PN, CF4 5PW, CF4 5PY, CF4 5WZ, CF4 5YP, CF4 5YQ, CF4 5YR",297,261,36
W00009276,CF14,"CF14 0GA, CF14 0GB, CF14 0JE, CF14 5AS, CF14 5AW, CF14 5AX, CF14 5DS, CF14 9DN, CF4 5GA, CF4 5GB, CF4 5UP, CF4 5UQ, CF4 5UR, CF4 5XP, CF4 9DN",339,278,61
W00009236,CF14,"CF14 2PN, CF14 2PP, CF14 2RS, CF14 2RT, CF14 2SL, CF14 2SS, CF4 2PN, CF4 2PP, CF4 2PW, CF4 2RS, CF4 2RT, CF4 2RY, CF4 2SS",355,314,41
W00009277,CF14,"CF14 9AD, CF14 9AE, CF14 9AF, CF14 9AH, CF4 9AA, CF4 9AB, CF4 9AE, CF4 9AF, CF4 9AG, CF4 9AH, CF4 9PW",265,233,32
W00009279,CF14,"CF14 5AF, CF14 5JT, CF14 5LA, CF14 9AR, CF14 9AW, CF4 9AQ, CF4 9AW, CF4 9DR",262,231,31
W00010199,CF14,"CF14 5AY, CF14 5BD, CF14 5DP, CF14 5DR, CF14 5ED, CF14 5EP, CF14 5ES, CF14 5FH, CF14 5FJ, CF14 5FP, CF14 5FQ, CF14 5FT, CF14 5FX, CF14 5FZ, CF14 5GN, CF14 5GR, CF14 5QX, CF14 5QZ, CF14 5SH, CF14 5TS, CF14 5UN, CF14 5XS, CF14 5XZ, CF14 5YA, CF14 5YD, CF14 5YF, CF14 5YJ, CF14 5YZ, CF14 5ZA, CF14 5ZB, CF14 5ZE, CF14 5ZG, CF14 5ZH, CF14 5ZL, CF14 5ZN, CF14 5ZP, CF14 5ZX, CF4 5DP, CF4 5DR, CF4 5DS, CF4 5DT, CF4 5ED, CF4 5EE, CF4 5EG, CF4 5HT, CF4 5JB, CF4 5LE, CF4 5PG, CF4 5PH, CF4 5PJ, CF4 5PL, CF4 5TR, CF4 5TX, CF4 5TZ, CF4 5UN, CF4 5WA, CF4 5WB, CF4 5WD, CF4 5WE, CF4 5WG, CF4 5WH, CF4 5WP, CF4 5WR, CF4 5WT, CF4 5WW, CF4 5WX, CF4 5WY, CF4 5XS, CF4 5XZ, CF4 5YA, CF4 5YB, CF4 5YD, CF4 5YE, CF4 5YF, CF4 5YJ, CF4 5YY, CF4 5YZ, CF4 5ZB, CF4 5ZE, CF4 5ZG, CF4 5ZH, CF4 5ZL, CF4 5ZN, CF4 5ZP, CF4 5ZQ, CF4 5ZX",251,225,26
W00009490,CF14,"CF14 0PF, CF23 8NA, CF23 8NB, CF23 8ND, CF23 8RQ, CF23 8RR, CF3 9YG",457,406,51
W00009724,CF14,"CF14 1LX, CF14 1LY, CF14 1NA, CF14 1ND, CF14 1NE, CF14 1NF, CF14 1NG, CF14 1NJ, CF14 1NL, CF14 1PF, CF14 1PJ, CF14 1PL, CF14 1PN, CF4 1LX, CF4 1LY, CF4 1NH, CF4 1PJ, CF4 1PL, CF4 1PN, CF4 2XG",330,224,106
W00009725,CF14,"CF14 1AW, CF14 1AX, CF14 1AZ, CF14 1BA, CF14 1BB, CF14 1BD, CF14 6BG, CF4 1AW, CF4 1BA, CF4 1BB, CF4 1BD, CF4 1BE",312,220,92
W00009727,CF14,"CF14 1EA, CF14 1HB, CF14 1HD, CF14 1HG, CF14 1HP, CF14 1HQ, CF4 1DX, CF4 1DY, CF4 1EA, CF4 1EE, CF4 1EF, CF4 1HP, CF4 1HQ, CF4 1XJ",283,237,46
W00010190,CF14,"CF14 4NN, CF14 4NQ, CF14 4PP, CF14 4UW",291,260,31
W00010176,CF14,"CF14 5BF, CF14 5DQ, CF14 5EQ, CF14 5ET, CF14 5EU, CF14 5EW, CF14 5FD",356,309,47
W00010162,CF14,"CF14 4NZ, CF14 4PH, CF14 4PJ, CF14 4PL, CF14 4PN, CF4 4PB, CF4 4PD, CF4 4PJ",262,235,27
W00010151,CF14,"CF14 5EY, CF14 5FB, CF14 5FE, CF14 5FF",326,292,34
W00009728,CF14,"CF14 1NP, CF14 1NX, CF14 1NY, CF14 1NZ, CF14 2NW, CF14 2NZ, CF4 1DE, CF4 1LD, CF4 1NA, CF4 1NB, CF4 1ND, CF4 1NE, CF4 1NF, CF4 1NG, CF4 1NP, CF4 1NQ, CF4 1NS, CF4 1NX, CF4 1NY, CF4 1PT, CF4 2NW, CF4 2NZ",303,271,32
W00009729,CF14,"CF14 1HE, CF14 1HF, CF14 1HR, CF14 1JR, CF14 1JX, CF14 1JY, CF4 1DZ, CF4 1EB, CF4 1ED, CF4 1HF, CF4 1HR, CF4 1HS, CF4 1JR, CF4 1JY",276,240,36
W00009730,CF14,"CF14 1DW, CF14 1DX, CF14 1EE, CF14 1EZ, CF14 1HA, CF14 1LD, CF14 1LE, CF14 1QL, CF14 1QP, CF14 1SB, CF4 1LE, CF4 1QN, CF4 1QP, CF4 1QQ, CF4 1SA, CF4 1SB, CF4 1SD",234,205,29
W00010135,CF14,"CF14 4NL, CF14 4NP, CF14 4NT, CF4 4UB, CF4 4UD, CF4 4UE, CF4 4UG, CF4 4UH, CF4 4UJ, CF4 4UN",369,324,45
W00009731,CF14,"CF14 1EB, CF14 1ED, CF14 1EJ, CF14 1HS, CF14 1HT, CF4 1EJ, CF4 1HT, CF4 1RA, CF4 1RU",248,218,30
W00009732,CF14,"CF14 1BZ, CF14 1DY, CF14 1DZ, CF14 1EF, CF14 1RA, CF14 1RB, CF14 1RU, CF14 1RX, CF4 1RB, CF4 1RG, CF4 1RH, CF4 1RX, CF4 1RY",206,183,23
W00010363,CF14,"CF14 6AY, CF14 6QG, CF14 6QU, CF14 6SJ, CF14 6SN, CF4 6SL",170,138,32
W00009733,CF14,"CF14 1HH, CF14 1HJ, CF14 1HL, CF14 1JZ, CF4 1DW, CF4 1EQ, CF4 1HA, CF4 1HB, CF4 1HD",286,227,59
W00010587,CF14,"CF14 6AZ, CF14 6TN, CF14 6TP, CF14 6TQ, CF14 9UA, CF14 9UG, CF14 9WZ, CF4 5UA, CF4 6TQ, CF4 9AD, CF8 1NB, CF8 1ND, CF83 1NB, CF83 1ND",451,354,97
W00010589,CF14,"CF14 5FR, CF14 5FS",101,101,0
W00009723,CF14,"CF14 2BH, CF14 2BL, CF14 2BN, CF14 2BP, CF14 2BW, CF14 2DH, CF14 2DJ, CF14 2EF, CF14 2HF, CF4 2BH, CF4 2BP, CF4 2BQ, CF4 2BS, CF4 2BT, CF4 2BU, CF4 2BW, CF4 2DH, CF4 2DJ, CF4 2DL, CF4 2XN",278,187,91
W00009722,CF14,"CF14 2AN, CF14 2AT, CF14 2AY, CF14 2TD, CF14 2TE, CF14 7BQ, CF14 7WZ, CF14 7XA, CF14 7XD, CF4 2AN, CF4 7AA, CF4 7AR, CF4 7BQ",274,195,79
W00009280,CF14,"CF14 5AB, CF14 5AD, CF14 5AP, CF14 5AQ, CF14 5AR, CF14 5AU, CF4 5AB, CF4 5AD, CF4 5AQ, CF4 5AR, CF4 5AS, CF4 5AT, CF4 5AU, CF4 5AW, CF4 5AX, CF4 5BF",310,268,42
W00009281,CF14,"CF14 5AG, CF14 5AH, CF14 5AL, CF14 5JR, CF14 5JS",365,321,44
W00009282,CF14,"CF14 5HJ, CF14 5JZ, CF14 9AS, CF14 9BE, CF4 5HJ, CF4 5LA, CF4 9AR, CF4 9AS, CF4 9BE",274,247,27
W00009283,CF14,"CF14 5HL, CF14 5HP, CF14 5HQ, CF14 5HR, CF14 5HS, CF4 5HQ, CF4 5HR, CF4 5HS",303,247,56
W00009284,CF14,"CF14 5AJ, CF14 5AN, CF14 5BN, CF14 5JJ, CF14 5JP, CF14 5JQ, CF4 5AH, CF4 5AJ, CF4 5AL, CF4 5AN, CF4 5JH, CF4 5JR, CF4 5JS",301,272,29
W00009285,CF14,"CF14 5JG, CF14 5JH, CF14 5JX, CF14 5JY, CF14 5LB, CF4 5AF, CF4 5AG, CF4 5JJ, CF4 5JT, CF4 5JX, CF4 5JY, CF4 5JZ, CF4 5LB",315,260,55
W00009286,CF14,"CF14 5AA, CF14 5AE, CF14 5AZ, CF14 5DB, CF14 5EF, CF14 5JL, CF14 5LS, CF14 5YL, CF4 5AA, CF4 5BA, CF4 5DE, CF4 5FB, CF4 5FD, CF4 5FF, CF4 5FT, CF4 5FU, CF4 5FW, CF4 5FY, CF4 5FZ, CF4 5TU, CF4 5TW, CF4 5WL, CF4 5WQ, CF4 5WS, CF4 5YG, CF4 5YH, CF4 5YL, CF4 5YS, CF4 5YT, CF4 5ZR, CF4 5ZS, CF4 5ZT, CF4 5ZU, CF4 5ZY",265,236,29
W00009287,CF14,"CF14 0PN, CF14 0RB, CF14 0RG, CF14 0RJ, CF14 0RL, CF14 0RN, CF14 0RZ, CF14 0SD, CF2 6QW, CF4 5EW, CF4 5RN, CF4 5RZ, CF4 5SD, CF4 5SE",272,237,35
W00009278,CF14,"CF14 5HN, CF14 9AJ, CF14 9AL, CF14 9AY, CF14 9BD, CF4 9AJ, CF4 9AL, CF4 9AP, CF4 9AY, CF4 9BD",235,224,11
W00009288,CF14,"CF14 5HH, CF14 5JD, CF14 5JU, CF14 5JW, CF14 5LD, CF4 5HH, CF4 5JD, CF4 5JU, CF4 5LD",314,281,33
W00009290,CF14,"CF14 5BL, CF14 5HE, CF14 5HF, CF14 5HG, CF14 5JF, CF14 5JN, CF4 5HE, CF4 5HF, CF4 5HG, CF4 5HL, CF4 5HP, CF4 5JG, CF4 5JN, CF4 5JW",293,253,40
W00009291,CF14,"CF14 5BU, CF14 5DA, CF14 5DD, CF14 5DE, CF14 5DH, CF14 5DT, CF14 5YN, CF4 5DB, CF4 5DD, CF4 5DH, CF4 5JL, CF4 5JQ",210,195,15
W00009292,CF14,"CF14 0RD, CF14 0RE, CF14 5HU, CF14 5RD, CF14 5UU, CF14 5UW, CF14 5UX, CF4 5AP, CF4 5HU, CF4 5HY, CF4 5RB, CF4 5RD, CF4 5RE, CF4 5RJ, CF4 5RL, CF4 5SA, CF4 5UW, CF4 5UX",333,290,43
W00010232,CF14,"CF14 3AB, CF14 3AJ, CF2 4HN, CF2 4XL, CF2 4XN, CF2 4XP, CF24 4HJ, CF24 4HN, CF24 4LD, CF24 4LU, CF24 4XN, CF24 4XP",97,66,31
W00009719,CF14,"CF14 6UP, CF15 7JT, CF15 7JU, CF15 7JW, CF15 7JX, CF15 7JY, CF15 7JZ, CF15 7YZ, CF15 7ZP, CF15 7ZQ, CF15 7ZY, CF4 7JT, CF4 7JU, CF4 7JX, CF4 7JY, CF4 7JZ, CF4 7UB, CF4 7UZ, CF4 7WA, CF4 7WB, CF4 7WD, CF4 7WE, CF4 7WF, CF4 7WG, CF4 7WZ, CF4 7XG, CF4 7XH, CF4 7XR, CF4 7XT, CF4 7XY, CF4 7YD, CF4 7YE, CF4 7YL, CF4 7YU, CF4 7YW, CF4 7YX, CF4 7YZ, CF4 7ZA, CF4 7ZB",309,286,23
W00010222,CF14,"CF14 5EB, CF14 5EJ, CF14 5EL, CF14 5EN, CF14 6PF, CF4 5EJ, CF4 5EL, CF4 5EN, CF4 5HA, CF4 5HB, CF4 5HD",319,250,69
W00010218,CF14,"CF14 4NS, CF14 4PG, CF14 4QE, CF4 4PH, CF4 4PL, CF4 4QL, CF4 4UX",212,177,35
W00010214,CF14,"CF14 4NF, CF14 4NG, CF14 4NH, CF14 5FG, CF14 5FL, CF14 5XY, CF4 5XY",269,237,32
W00009289,CF14,"CF14 5BJ, CF14 5BQ, CF14 5BS, CF14 5BT, CF14 5BW, CF4 5BG, CF4 5BN, CF4 5BQ, CF4 5BS, CF4 5BT, CF4 5BU, CF4 5BX, CF4 5BZ, CF4 5JP",273,259,14
W00009734,CF14,"CF14 1LR, CF14 1LS, CF14 1NW, CF14 2NT, CF14 2NU, CF4 1LB, CF4 1LS, CF4 1NZ, CF4 2NT, CF4 2NU",226,190,36
W00009235,CF14,"CF14 2JH, CF14 2JJ, CF14 2JL, CF14 2JN, CF14 2JP, CF14 2JQ, CF14 2XT, CF4 2FB, CF4 2FF, CF4 2HY, CF4 2JB, CF4 2JE, CF4 2JF, CF4 2JG, CF4 2JH, CF4 2JJ, CF4 2JL, CF4 2JN, CF4 2JP, CF4 2JQ, CF4 2JR, CF4 2LW, CF4 2LX, CF4 2LZ, CF4 2NA, CF4 2NB, CF4 2XT, CF4 2XU, CF4 2XX, CF4 2YA, CF4 2YG, CF4 2YH, CF4 2YJ, CF4 2YL, CF4 2YR, CF4 2YS, CF4 2YT, CF4 2YU, CF4 2YW, CF4 2YY, CF4 2ZD, CF4 2ZT",316,260,56
W00009233,CF14,"CF14 1EL, CF14 3HJ, CF14 3HQ, CF14 3HU, CF4 1EG, CF4 3HJ, CF4 3HU, CF4 3HW",327,290,37
W00009142,CF14,"CF14 1TW, CF14 1UB, CF14 1UD, CF14 1US, CF14 4QR, CF14 4QS, CF14 4QU, CF4 4QR, CF4 4QS, CF4 4QU, CF4 4QX",204,176,28
W00009143,CF14,"CF14 4BP, CF14 4DG, CF14 4DJ, CF14 4EE, CF4 4EF",284,229,55
W00009144,CF14,"CF14 1RH, CF14 1RJ, CF14 1TS, CF14 1TT, CF14 1UN, CF14 1UP, CF14 1UR, CF4 1RJ, CF4 1TT, CF4 1TW, CF4 1UB, CF4 1UD, CF4 1UN, CF4 1US",265,232,33
W00009145,CF14,"CF14 1TU, CF14 1UA, CF14 4QQ, CF14 4QW, CF14 4QX, CF14 4RA, CF4 4QD, CF4 4QP, CF4 4QQ, CF4 4QW, CF4 4QY",289,250,39
W00009146,CF14,"CF14 3QH, CF14 3RA, CF14 3RF, CF14 3RH, CF14 3YU, CF14 4AW, CF14 4AY, CF14 4EN, CF14 4EP, CF23 5QB, CF4 3QJ, CF4 3QN, CF4 3RA, CF4 3RE, CF4 3RF, CF4 3RG, CF4 3RH, CF4 3RL, CF4 3UD, CF4 3UF, CF4 4BS, CF4 4EG, CF4 4EJ, CF4 4EL, CF4 4EN, CF4 4EP, CF4 4EQ",317,250,67
W00009147,CF14,"CF14 1RR, CF14 1RS, CF14 1RT, CF14 1UQ, CF14 4AE, CF14 4QA, CF14 4QY, CF14 4XA, CF4 1TU, CF4 1UA, CF4 1UQ, CF4 1UR, CF4 4QB, CF4 4QH, CF4 4XA, CF4 4XB, CF4 4XD, CF4 4XG, CF4 4XL, CF4 4XU",279,243,36
W00009148,CF14,"CF14 3QJ, CF14 3QL, CF14 3QN, CF14 3RE, CF14 3RL",116,106,10
W00009149,CF14,"CF14 3XW, CF14 4AS, CF14 4BA, CF14 4BD, CF14 4BH, CF14 4DP, CF14 4DQ, CF4 4BD, CF4 4BP, CF4 4BQ, CF4 4DJ, CF4 4DP, CF4 4DQ, CF4 4JN, CF4 4XS",361,298,63
W00009150,CF14,"CF14 4AG, CF14 4AT, CF14 4AU, CF14 4BE, CF14 4BG, CF14 4DA, CF4 4AS, CF4 4AT, CF4 4AU, CF4 4BE, CF4 4BH",341,297,44
W00009151,CF14,"CF14 1DF, CF14 1RG, CF14 1RW, CF14 1SD, CF14 4AA, CF14 4AB, CF14 4AD, CF14 4AH, CF14 4AJ, CF4 1RR, CF4 1RS, CF4 1RT, CF4 1RW, CF4 4AE, CF4 4AG, CF4 4AH, CF4 4DA, CF4 4JL, CF4 4JP, CF4 4QA, CF4 4QG, CF4 4XE",317,278,39
W00009152,CF14,"CF14 3BP, CF14 4AF, CF14 4AL, CF14 4AX, CF14 4DL, CF14 4DN, CF14 4EB, CF14 4US, CF14 4YJ, CF4 3BP, CF4 4AN, CF4 4AQ, CF4 4AR, CF4 4DF, CF4 4EB, CF4 4US, CF4 4UU, CF4 4YA, CF4 4YB, CF4 4YD, CF4 4YE, CF4 4YF, CF4 4YG, CF4 4YH, CF4 4YJ, CF4 4YL, CF4 4YN, CF4 4YQ, CF4 4YT, CF4 4YU, CF4 4YW",338,288,50
W00009153,CF14,"CF14 4AN, CF14 4AP, CF14 4AQ, CF14 4AR, CF14 4DD, CF4 4AP, CF4 4DB, CF4 4DD, CF4 4DE, CF4 4DL, CF4 4DN, CF4 4EA",297,273,24
W00009154,CF14,"CF14 3QY, CF14 3QZ, CF14 3RB, CF14 3RD, CF14 4EQ, CF14 4ER, CF14 4FR, CF14 4UJ, CF14 4WZ, CF14 4XN, CF14 4XW, CF14 4XZ, CF14 4YS, CF14 4YU, CF2 5PQ, CF2 5PT, CF2 5PU, CF4 3QW, CF4 3QY, CF4 3QZ, CF4 3RB, CF4 3RD, CF4 4ER, CF4 4FR, CF4 4XN, CF4 4XW",398,328,70
W00009155,CF14,"CF14 3PJ, CF14 3PL",184,167,17
W00009156,CF14,"CF14 4HB, CF14 4HD, CF14 4HG, CF14 4HJ, CF14 4HZ, CF4 4HZ",254,219,35
W00009157,CF14,"CF14 4HE, CF14 4HH, CF14 4HY, CF14 4JS, CF14 4LB, CF14 4LD, CF14 4NJ, CF14 4PD, CF14 4TT, CF14 4UH, CF14 4UZ, CF14 4WA, CF14 4XP, CF14 4XR, CF14 4YP, CF4 4HE, CF4 4HG, CF4 4HH, CF4 4HY, CF4 4JS, CF4 4LB, CF4 4LD, CF4 4UZ, CF4 4WA, CF4 4WZ, CF4 4XJ, CF4 4XR",478,417,61
W00009159,CF14,"CF14 4PT, CF14 4PZ, CF14 4QF, CF14 4QJ, CF14 4QL, CF14 4QT, CF14 4SD, CF14 4SF, CF14 4SG, CF14 4XH, CF4 4NS, CF4 4NT, CF4 4QF, CF4 4SE, CF4 4SF, CF4 4SG, CF4 4SH, CF4 4UY, CF4 4XH, CF4 4XP, CF4 4XQ",427,393,34
W00009141,CF14,"CF14 4NR, CF14 4PW, CF14 4PY, CF14 4QB, CF14 4QD, CF14 4QH, CF14 4QN, CF14 4QP, CF4 4NR, CF4 4NU, CF4 4NX, CF4 4PE, CF4 4PF, CF4 4PG, CF4 4PN, CF4 4QE, CF4 4QN, CF4 4XF",457,412,45
W00009140,CF14,"CF14 4JL, CF14 4JP, CF14 4NU, CF14 4NW, CF14 4NX, CF14 4NY, CF14 4QG, CF14 4QZ, CF14 4XE, CF14 4XF, CF4 4NW, CF4 4NY, CF4 4PA, CF4 4QZ, CF4 4UP, CF4 4YP, CF4 4YR, CF4 4YS",387,322,65
W00009139,CF14,"CF14 4DB, CF14 4DE, CF14 4DF, CF14 4DH, CF14 4EA, CF14 4ED, CF14 4XT, CF14 4XY, CF4 4BG, CF4 4DG, CF4 4DH, CF4 4ED, CF4 4EE, CF4 4XT, CF4 4XX",282,256,26
W00009138,CF14,"CF14 4LW, CF14 4LY, CF14 4NB, CF14 4ND, CF14 4NE, CF4 4LS, CF4 4LW, CF4 4LY",303,255,48
W00008902,CF14,"CF14 3QU, CF14 3QW, CF14 3QX, CF2 4PL, CF2 4PY, CF2 4QG, CF2 5HH, CF2 5HN, CF24 4PL, CF24 4PY, CF24 4QE, CF24 4QF, CF24 4QG, CF24 4QP, CF24 4RB, CF4 3QX",544,477,67
W00008919,CF14,"CF14 3JL, CF14 3UH, CF14 3YE, CF24 4LA, CF24 4LB, CF4 3LW, CF4 3LX, CF4 3PL, CF4 3PN, CF4 3PP, CF4 3PR, CF4 3UH, CF4 3UQ, CF4 3YE, CF4 3YR, CF4 3YS",263,242,21
W00008925,CF14,"CF14 3JS, CF2 4PW, CF2 4QB, CF24 4HW, CF24 4JA, CF24 4JW, CF24 4JY, CF24 4JZ, CF24 4LF, CF4 3JL",434,387,47
W00008951,CF14,"CF14 0LX, CF14 0ND, CF14 0NW, CF14 0NY, CF14 0NZ, CF4 5LX, CF4 5NB, CF4 5ND, CF4 5NY, CF4 5NZ, CF4 5PB",399,329,70
W00008957,CF14,"CF14 0LW, CF14 0NB, CF14 0NF, CF14 0NU, CF14 0NX, CF14 4HS, CF14 4HT, CF2 6PX, CF2 6PY, CF23 6PX, CF4 5LW, CF4 5NF, CF4 5NX",323,293,30
W00009073,CF14,"CF14 3AT, CF14 3AX, CF14 3AY, CF14 3DY, CF14 3EB, CF14 3EE, CF14 3EF, CF14 3EG, CF14 3HH, CF14 3TD, CF4 3BN, CF4 3DX, CF4 3DY, CF4 3EB, CF4 3EE, CF4 3HH, CF4 3XS, CF4 3XW",392,341,51
W00009074,CF14,"CF14 3PP, CF14 3PS, CF14 3PT, CF14 3PU, CF14 3YS, CF4 3PJ, CF4 3PQ",363,314,49
W00009075,CF14,"CF14 3BT, CF14 3BU, CF14 3BW, CF14 3BZ, CF4 3BR, CF4 3JN, CF4 3LZ, CF4 3NA, CF4 3SL, CF4 3SR, CF4 3TD, CF4 3TF, CF4 3TG, CF4 3TH, CF4 3TJ, CF4 3TL, CF4 3TN, CF4 3TP, CF4 3TR, CF4 3TS, CF4 3TT, CF4 3TU, CF4 3TW, CF4 3TX",340,275,65
W00009160,CF14,"CF14 4BN, CF14 4HA, CF14 4HF, CF14 4HP, CF14 4HU, CF14 4HW, CF14 4HX, CF4 4HA, CF4 4HP, CF4 4HW, CF4 4HX, CF4 5QH, CF4 5QJ, CF4 5QL",329,280,49
W00009077,CF14,"CF14 3LA, CF14 3LD, CF14 3LG, CF4 3JY, CF4 3JZ, CF4 3LB, CF4 3LD, CF4 3LF, CF4 3LG",340,282,58
W00009081,CF14,"CF14 3BJ, CF14 3BX, CF14 3BY, CF14 3DA, CF14 3DD, CF14 3LB, CF14 3XQ, CF4 3BX, CF4 3DA, CF4 3DL",297,257,40
W00009082,CF14,"CF14 3NF, CF14 3NG, CF14 3NH, CF14 3NT, CF14 3NU, CF14 3NW, CF14 3NX, CF4 3NW, CF4 3NX",373,319,54
W00009084,CF14,"CF14 3BE, CF14 3BF, CF14 3BG, CF14 3BN, CF14 3BQ, CF14 3DH, CF14 3JR, CF14 3JU, CF14 3XR, CF4 3BQ, CF4 3JR, CF4 3JU, CF4 3JW, CF4 3NE, CF4 3NF, CF4 3NG, CF4 3NH, CF4 3NT, CF4 3NU",291,248,43
W00009085,CF14,"CF14 3JQ, CF14 3ND, CF14 3NE, CF14 3NJ, CF14 3NP, CF14 3NR, CF14 3NY, CF4 3NP, CF4 3XB, CF4 3XL, CF4 3XN, CF4 3XQ, CF4 3XT, CF4 3XU, CF4 3XX, CF4 3XZ, CF4 3YA, CF4 3YB",427,367,60
W00009086,CF14,"CF14 3JW, CF14 3JX, CF14 3JY, CF14 3JZ, CF4 3JP, CF4 3JQ, CF4 3JX, CF4 3LA, CF4 3NB, CF4 3NY",329,261,68
W00009087,CF14,"CF14 3QA, CF14 3QD, CF14 3QF, CF14 3QG, CF4 3NN, CF4 3NQ, CF4 3QA, CF4 3QF, CF4 3QG, CF4 3QH",372,301,71
W00009088,CF14,"CF14 3AD, CF14 3AE, CF14 3AL, CF14 3AU, CF14 3BH, CF14 3BR, CF14 3BS, CF14 3DB, CF14 3DE, CF14 3JN, CF14 3JP, CF14 3JT, CF14 3LZ, CF14 3NA, CF14 3NB, CF14 3UB, CF14 3UD, CF14 3UW, CF14 3UZ, CF14 3XB, CF14 3XG, CF14 3YB, CF14 3YD, CF14 3YF, CF14 3YH, CF14 3YL, CF14 3YN, CF14 3YQ, CF14 3YR, CF14 3ZA, CF4 3BS, CF4 3BT, CF4 3BU, CF4 3BW, CF4 3BZ, CF4 3DB, CF4 3JT, CF4 3LY, CF4 3ND, CF4 3NJ, CF4 3NL, CF4 3NR, CF4 3PS, CF4 3PT, CF4 3PW, CF4 3QD, CF4 3UA, CF4 3UB, CF4 3UE, CF4 3UG, CF4 3UN, CF4 3UP, CF4 3UR, CF4 3US, CF4 3UT, CF4 3UU, CF4 3UW, CF4 3UX, CF4 3UY, CF4 3UZ, CF4 3WA, CF4 3WB, CF4 3WD, CF4 3WE, CF4 3XE, CF4 3XF, CF4 3XG, CF4 3XH, CF4 3XJ, CF4 3YD, CF4 3YG, CF4 3YH, CF4 3YJ, CF4 3YL, CF4 3YN, CF4 3YP, CF4 3YW",472,414,58
W00009089,CF14,"CF14 3PQ, CF14 3PY, CF14 3QB, CF14 3QE, CF4 3PY, CF4 3PZ",335,295,40
W00009080,CF14,"CF14 3LW, CF14 3LX, CF14 3LY, CF14 3PH, CF14 3PN, CF14 3PR, CF14 3PW, CF14 3PX, CF14 3UQ, CF4 3PU, CF4 3PX, CF4 3QB, CF4 3QE, CF4 3YF, CF4 3YQ",393,355,38
W00009234,CF14,"CF14 2HL, CF14 2LN, CF14 2LW, CF14 2LX, CF14 2LY, CF14 2NB, CF4 2HG, CF4 2LH, CF4 2LL, CF4 2LN",238,194,44
W00009161,CF14,"CF14 1TZ, CF14 1UF, CF14 1UG, CF14 1UH, CF14 1UJ, CF14 1UU, CF14 4SB, CF4 1UF, CF4 1UT, CF4 4SB, CF4 6AA, CF4 6AB",393,343,50
W00009163,CF14,"CF14 4LT, CF14 4LU, CF14 4LX, CF14 4LZ, CF14 4NA, CF14 4UU, CF4 4HB, CF4 4HD, CF4 4HF, CF4 4HU, CF4 4LU, CF4 4LX, CF4 4LZ",315,236,79
W00009216,CF14,"CF14 2FB, CF14 2FF, CF14 2FY, CF14 2FZ, CF14 2HA, CF14 2HE, CF14 2LP, CF14 2LZ, CF14 2NA, CF4 2FD, CF4 2FY, CF4 2FZ, CF4 2HA, CF4 2HB, CF4 2HD, CF4 2HE, CF4 2HF, CF4 2LP, CF4 2LU, CF4 2LY",336,284,52
W00009217,CF14,"CF14 2RX, CF14 2RY, CF14 2RZ, CF14 2SA, CF14 3HB, CF14 3HY, CF4 3HR",260,233,27
W00009218,CF14,"CF14 2HY, CF14 2JG, CF14 2JY, CF14 2QH, CF14 2QJ, CF14 2QL, CF4 2QH, CF4 2QJ, CF4 2QL",292,256,36
W00009219,CF14,"CF14 2HZ, CF14 2JB, CF14 2JD, CF14 2JE, CF14 2JF, CF14 2JZ, CF4 2JA, CF4 2JD",255,204,51
W00009220,CF14,"CF14 2HJ, CF14 2PB, CF14 2PD, CF14 2PG, CF14 2PH, CF14 2PJ, CF4 2PD, CF4 2PE, CF4 2PL",319,283,36
W00009221,CF14,"CF14 2RW, CF14 2SB, CF14 2SE, CF14 2SG, CF14 2SJ, CF4 2RW, CF4 2RZ, CF4 2SA, CF4 2SB, CF4 2SE, CF4 2SP, CF4 3XY",340,298,42
W00009222,CF14,"CF14 2PA, CF14 2QU, CF14 2QW, CF14 2RA, CF14 2RU, CF14 2SH, CF14 2ST, CF4 2PH, CF4 2PJ, CF4 2SH, CF4 2SL, CF4 2XA",264,253,11
W00009223,CF14,"CF14 2QF, CF14 2QY, CF14 2SD, CF14 2SF, CF4 2QF, CF4 2SD, CF4 2SG, CF4 2SJ, CF4 2SN",326,285,41
W00009224,CF14,"CF14 2QG, CF14 2QX, CF14 2QZ, CF14 2RB, CF14 2RD, CF4 2QX, CF4 2QY, CF4 2QZ, CF4 2RA, CF4 2RB, CF4 2RD, CF4 2SF, CF4 2ST",295,263,32
W00009225,CF14,"CF14 2BB, CF14 2EZ, CF14 2FA, CF14 2FP, CF14 2FQ, CF14 2FR, CF14 2FS, CF14 2HD, CF14 2XE, CF4 2EF, CF4 2EG, CF4 2EJ, CF4 2FE, CF4 2FQ, CF4 2FR",301,237,64
W00009226,CF14,"CF14 2HS, CF14 2HT, CF14 2LA, CF14 2LE, CF14 2LG, CF14 2XD, CF14 2XP, CF14 2XX, CF14 2YG, CF14 2ZA, CF4 1NW, CF4 2HQ, CF4 2HR, CF4 2HS, CF4 2HT, CF4 2LA, CF4 2LD, CF4 2LE, CF4 2LG, CF4 2LJ, CF4 2NS",321,294,27
W00009227,CF14,"CF14 2FD, CF14 2FE, CF14 2FG, CF14 2FH, CF14 2LR, CF14 2LS, CF14 2LU, CF4 1NJ, CF4 2FH, CF4 2HN",257,211,46
W00009228,CF14,"CF14 2FT, CF14 2FU, CF14 2FX, CF14 2GA, CF4 2FJ, CF4 2FP, CF4 2FS, CF4 2FT, CF4 2FU, CF4 2FW, CF4 2FX",254,207,47
W00009229,CF14,"CF14 2AZ, CF14 2FJ, CF14 2FL, CF14 2FN, CF14 2FW, CF14 2XF, CF4 2FA, CF4 2FG, CF4 2FL, CF4 2FN, CF4 2LR, CF4 2LS, CF4 2XD, CF4 2XE, CF4 2XF",350,249,101
W00009230,CF14,"CF14 2LB, CF14 2LH, CF14 2LJ, CF14 2LL, CF14 2LQ, CF14 2LT, CF4 2HL, CF4 2LB, CF4 2LF, CF4 2LQ, CF4 2LT, CF4 2YB, CF4 2YD, CF4 2YE, CF4 2YF, CF4 2YN, CF4 2YP, CF4 2YQ",341,314,27
W00009231,CF14,"CF14 2PL, CF14 2PQ, CF14 2PR, CF14 2PS, CF14 2PX, CF4 2NY, CF4 2PG, CF4 2PQ, CF4 2PR, CF4 2PS, CF4 2PT, CF4 2PU, CF4 2PX, CF4 2PY, CF4 2PZ",244,222,22
W00009232,CF14,"CF14 1EP, CF14 3HS, CF14 3HX, CF4 1EP, CF4 1HN, CF4 1JW, CF4 3HS, CF4 3HX, CF4 3HY",333,297,36
W00009215,CF14,"CF14 2HQ, CF14 2HR, CF14 2LD, CF14 2LF, CF14 2NL, CF14 2NN, CF14 2NS, CF14 2NY, CF14 2PF, CF4 1LR",280,261,19
W00009214,CF14,"CF14 2ND, CF14 2PT, CF14 2PU, CF14 2PW, CF14 2PY, CF14 2PZ, CF4 1JL, CF4 1JT, CF4 1JU, CF4 2ND, CF6 4HU, CF64 4HU",250,222,28
W00009184,CF14,"CF14 0FJ, CF14 0SU, CF14 0SZ, CF14 0TA, CF14 0TB, CF14 0TD, CF14 0TE, CF14 0TF, CF14 0TH, CF14 0TJ, CF14 5GZ, CF4 5FE, CF4 5FG, CF4 5FH, CF4 5FJ, CF4 5FL, CF4 5FN, CF4 5FP, CF4 5FQ, CF4 5FR, CF4 5FS, CF4 5FX, CF4 5GE, CF4 5GF, CF4 5GG, CF4 5GH, CF4 5GJ, CF4 5GL, CF4 5GN, CF4 5GP, CF4 5GQ, CF4 5GR, CF4 5GS, CF4 5GT, CF4 5GU, CF4 5GZ, CF4 5SY, CF4 5SZ, CF4 5TB, CF4 5TD, CF4 5TG",299,261,38
W00009183,CF14,"CF14 0RR, CF14 0RS, CF14 0RT, CF14 0TQ, CF14 0UP, CF4 5RR, CF4 5RS, CF4 5RT, CF4 5RU, CF4 5RW, CF4 5RX, CF4 5TQ",411,357,54
W00009164,CF14,"CF14 4HL, CF14 4HN, CF14 4JU, CF14 4JW, CF14 4LS, CF4 4HJ, CF4 4HN, CF4 4LT",320,259,61
W00009165,CF14,"CF14 1SR, CF14 1SS, CF14 6BP, CF14 6BQ, CF4 1SR, CF4 1SS, CF4 1UG, CF4 6AD, CF4 6AF, CF4 6BQ",262,220,42
W00009166,CF14,"CF14 1ST, CF14 1SW, CF14 1TD, CF14 1TF, CF14 1TG, CF14 1TX, CF14 1TY, CF4 1ST, CF4 1SW, CF4 1TZ, CF4 1UL",301,258,43
W00009168,CF14,"CF14 1RP, CF14 1RQ, CF14 1SY, CF14 1SZ, CF14 1TA, CF14 6BN, CF14 6DF, CF4 1RQ, CF4 1SY, CF4 1TA, CF4 6BJ, CF4 6BP, CF4 6BY",233,208,25
W00009169,CF14,"CF14 3RG, CF14 3RJ, CF14 4GH, CF14 4HQ, CF14 4HR, CF2 5QF, CF2 5QG, CF2 5QH, CF2 5QJ, CF2 5QL, CF23 5QA, CF23 5QJ, CF23 5QL, CF4 3QL, CF4 3RJ, CF4 4HS, CF4 4HT",341,283,58
W00009170,CF14,"CF14 4BL, CF14 4BR, CF14 4BS, CF14 4EG, CF14 4EH, CF14 4EJ, CF14 4EL, CF4 4BN, CF4 4EH, CF4 4HQ, CF4 4NA, CF4 4NB",299,247,52
W00009171,CF14,"CF14 1TH, CF14 1UE, CF14 1UL, CF14 1UT, CF14 4PQ, CF14 4PR, CF14 4SA, CF14 6AB, CF4 1UH, CF4 1UJ, CF4 4SA, CF4 4SD",510,469,41
W00009172,CF14,"CF14 1RL, CF14 1RN, CF14 1SU, CF14 1TB, CF14 1TE, CF4 1SU, CF4 1SZ, CF4 1TD, CF4 1TE, CF4 1TF, CF4 1TG, CF4 1TS, CF4 1TX, CF4 1TY, CF4 1UE",300,262,38
W00009162,CF14,"CF14 4JR, CF14 4JY, CF14 4JZ, CF14 4LA, CF14 4PB, CF4 4HL, CF4 4JR, CF4 4JU, CF4 4JW, CF4 4JZ, CF4 4LA",266,216,50
W00009173,CF14,"CF14 4BJ, CF14 4BQ, CF14 4BT, CF14 4EF, CF14 4JQ, CF14 4JT, CF4 4BJ, CF4 4BL, CF4 4BR, CF4 4BT, CF4 4NE",245,215,30
W00009175,CF14,"CF14 0GD, CF14 0GE, CF14 0GF, CF14 0JB, CF14 0UF, CF14 0UJ, CF14 0UL, CF14 9UB, CF14 9UD, CF4 5UB, CF4 5UD, CF4 5UF, CF4 5UL",326,269,57
W00009176,CF14,"CF14 0AT, CF14 0BD, CF14 0BE, CF14 0EP, CF14 0TP, CF14 0UD, CF14 0UE, CF4 5BB, CF4 5BD, CF4 5BE, CF4 5TP",353,309,44
W00009177,CF14,"CF14 0AE, CF14 0SJ, CF14 0SL, CF14 0SQ, CF14 0SS, CF14 0ST, CF14 0SX, CF14 0SY, CF14 0TR, CF14 0TW, CF14 0TX, CF4 5SH, CF4 5SJ, CF4 5SP, CF4 5SQ, CF4 5SS, CF4 5ST, CF4 5SX, CF4 5TA",320,274,46
W00009178,CF14,"CF14 0SR, CF14 0US, CF14 0WH, CF14 0XD, CF14 0XE, CF14 0XF, CF14 0XG, CF14 0XJ, CF14 0XN, CF14 0XS, CF14 0XZ, CF4 5SR, CF4 5SU, CF4 5SW, CF4 5TJ, CF4 5TN, CF4 5XN, CF4 5XW",243,210,33
W00009179,CF14,"CF14 0TL, CF14 0TN, CF14 0UQ, CF14 0UR, CF14 0XP, CF14 0XR, CF4 5EU, CF4 5TL, CF4 5XJ, CF4 5XR",319,284,35
W00009180,CF14,"CF14 0AZ, CF14 0EQ, CF14 0ES, CF14 0ET, CF14 0EW, CF14 0EX, CF14 0EY, CF14 0EZ, CF14 0FZ, CF14 0GQ, CF14 0SF, CF14 0TT, CF14 0XH, CF14 0XL, CF14 0YB, CF14 0YE, CF14 0YF, CF4 5EP, CF4 5EQ, CF4 5ES, CF4 5ET, CF4 5EX, CF4 5EY, CF4 5EZ, CF4 5SF, CF4 5TT, CF4 5US, CF4 5XD, CF4 5XE, CF4 5XF, CF4 5XG",335,290,45
W00009181,CF14,"CF14 0AA, CF14 0AB, CF14 0AD, CF14 0AF, CF14 0AG, CF14 0AH, CF14 0AJ, CF14 0AN, CF14 0ER, CF14 0PE, CF14 0PQ, CF14 0RQ, CF14 0SG, CF14 0SH, CF14 0SN, CF14 0SP, CF14 0SW, CF14 0TS, CF14 0TU, CF23 6XL, CF4 5ER, CF4 5RP, CF4 5RQ, CF4 5SG, CF4 5SL, CF4 5SN",517,462,55
W00009182,CF14,"CF14 0AY, CF14 0EU, CF14 0GU, CF14 0RU, CF14 0RW, CF14 0RX, CF14 0TG, CF14 0UG, CF14 0UH, CF14 0UN, CF4 5AY, CF4 5AZ, CF4 5GD, CF4 5TE, CF4 5TF, CF4 5TH, CF4 5UE, CF4 5UG, CF4 5UH, CF4 5UJ",306,274,32
W00009174,CF14,"CF14 4JN, CF14 4JX, CF14 4PA, CF14 4PE, CF14 4PF, CF14 4UN, CF14 4XL, CF14 4XU, CF14 4YD, CF14 4YG, CF14 4YH, CF14 4YL, CF4 4JQ, CF4 4JT, CF4 4JX, CF4 4JY, CF4 4ND, CF4 4NZ, CF4 4UA, CF4 4UF, CF4 4UL, CF4 4UQ, CF4 4UT, CF4 4UW",328,272,56
W00010597,CF14,"CF14 5BB, CF14 5BH, CF14 5DJ, CF4 5DL",214,202,12
W00009264,CF14,"CF14 9AZ, CF14 9DH, CF14 9DJ, CF14 9ES, CF14 9HA, CF14 9HB, CF4 5ZF, CF4 9ES",287,255,32
W00009526,CF14,"CF14 6HR, CF14 6HS, CF14 6HT, CF14 6HU, CF14 6HW, CF14 6HX, CF14 6HY, CF14 6JA, CF4 6HP, CF4 6HS, CF4 6HT, CF4 6HW, CF4 6HX, CF4 6HY, CF4 6HZ, CF4 6JA, CF4 6JB",367,305,62
W00009556,CF14,"CF14 6TR, CF14 6TS, CF14 6TW, CF14 6UF, CF14 6UN, CF14 6UQ, CF14 6UR, CF14 6UT, CF4 6SF, CF4 6SG, CF4 6TP, CF4 6TR, CF4 6TS, CF4 6TU, CF4 6UR",315,264,51
W00009555,CF14,"CF14 6QD, CF14 6QF, CF14 6QH, CF14 6QJ, CF4 6QD, CF4 6QE, CF4 6QF, CF4 6QH, CF4 6QJ",253,219,34
W00009554,CF14,"CF14 6QB, CF14 6QL, CF14 6QN, CF14 6QT, CF4 5HN, CF4 6QB, CF4 6QL, CF4 6QN, CF4 6QT",235,204,31
W00009553,CF14,"CF14 6SH, CF14 6SL, CF14 6SP, CF14 6SQ, CF14 6SU, CF14 6SY, CF4 6QG, CF4 6SJ, CF4 6SN, CF4 6SP, CF4 6ST, CF4 6SU, CF4 6SW, CF4 6SX",281,255,26
W00009552,CF14,"CF14 6AA, CF14 6AD, CF14 6AF, CF14 6AH, CF14 6BJ, CF14 6BL, CF14 6BY, CF14 6BZ, CF4 6AH, CF4 6AR, CF4 6AT, CF4 6AW, CF4 6BL, CF4 6BZ, CF4 6DA, CF4 6DH",234,209,25
W00009551,CF14,"CF14 6BB, CF14 6BD, CF14 6BH, CF14 6BS, CF14 6BT, CF14 6BU, CF14 6BX, CF4 6BB, CF4 6BD, CF4 6BE, CF4 6BG, CF4 6BH, CF4 6BS, CF4 6BT, CF4 6BU, CF4 6BW, CF4 6BX, CF4 6DG, CF4 6DJ",261,234,27
W00009550,CF14,"CF14 6AE, CF14 6BW, CF14 6DA, CF14 6DB, CF14 6DD, CF14 6DE, CF14 6DG, CF14 6DH, CF14 6DJ, CF4 6AE, CF4 6AG, CF4 6AQ, CF4 6AS, CF4 6DB, CF4 6DD, CF4 6DE",254,223,31
W00009735,CF14,"CF14 1DL, CF14 1EG, CF14 1HU, CF14 1HW, CF14 1HX, CF14 3BA, CF4 1DF, CF4 1DL, CF4 1HU, CF4 1HW, CF4 1HX, CF4 1HY, CF4 1HZ, CF4 4AA, CF4 4AB, CF4 4AD, CF4 4AF, CF4 4AJ, CF4 4AL",521,474,47
W00009549,CF14,"CF14 4SE, CF14 4SH, CF14 4SJ, CF14 6AW, CF4 4SJ, CF4 6AU, CF4 6AX",314,264,50
W00009548,CF14,"CF14 1BE, CF14 1BF, CF14 1BG, CF14 1BH, CF14 6EL, CF4 1BQ, CF4 1BR, CF4 1BW, CF4 6EL, CF4 6YB",272,229,43
W00009525,CF14,"CF14 6US, CF14 7TJ, CF14 7TL, CF14 7TR, CF14 7TS, CF14 7TT, CF14 7TU, CF4 6UQ, CF4 6US, CF4 6XJ, CF4 6XL, CF4 6XR, CF4 6XS, CF4 6XU, CF4 6XZ",303,256,47
W00009527,CF14,"CF14 6HP, CF14 6SA, CF14 6SD, CF14 6SF, CF14 6UE, CF14 6UG, CF14 6UH, CF14 6UJ, CF14 6UL, CF14 6UU, CF4 6JX, CF4 6SA, CF4 6SB, CF4 6SD, CF4 6SE, CF4 6UA, CF4 6UD, CF4 6UG, CF4 6UH, CF4 6UJ, CF4 6UL, CF4 6UN, CF4 6UT, CF4 6UU, CF4 6WB, CF4 6WD, CF4 6WE, CF4 6WF, CF4 6WG, CF4 6WH",322,278,44
W00009528,CF14,"CF14 6LB, CF14 6LF, CF14 6LN, CF14 6RL, CF14 6RN, CF4 6LB, CF4 6LF, CF4 6LG, CF4 6RE, CF4 6RJ",252,226,26
W00009529,CF14,"CF14 7HE, CF14 7HH, CF14 7HL, CF14 7HP, CF14 7HQ, CF4 6UP, CF4 6XQ, CF4 6XT, CF4 7HP, CF4 7HQ",334,296,38
W00009530,CF14,"CF14 7HA, CF14 7HN, CF14 7HR, CF14 7TE, CF14 7TN, CF14 7TP, CF14 7TQ, CF4 6XE",255,223,32
W00009531,CF14,"CF14 7HB, CF14 7HD, CF14 7HF, CF14 7HG, CF14 7HJ, CF14 7TD, CF4 6XD, CF4 6XN, CF4 6XP, CF4 7HA, CF4 7HB, CF4 7HD, CF4 7HE, CF4 7HF, CF4 7HG, CF4 7HH, CF4 7HJ, CF4 7HL, CF4 7HN, CF4 7HR, CF4 7HS, CF4 7HT, CF4 7HU, CF4 7HW, CF4 7HX, CF4 7HY, CF4 7HZ",264,224,40
W00009547,CF14,"CF14 4SS, CF14 6AG, CF14 6AJ, CF14 6AL, CF14 6AN, CF14 6AX, CF4 4SS, CF4 4ST, CF4 6AL, CF4 6AN, CF4 6AP",266,236,30
W00007425,CF14,"CF14 0LB, CF14 0LE, CF3 6AA, CF3 6LP, CF3 6XR, CF3 6XX, CF3 9XP, CF3 9XQ, CF3 9XR, CF3 9XT, CF3 9XX, CF3 9YH, CF8 3DD, CF8 3DE, CF8 3EB, CF83 3DD, CF83 3DE, CF83 3EB, NP1 8UA, NP1 8UB, NP1 8UD, NP1 8UE, NP1 8UF, NP1 8UG, NP1 8UH, NP10 8GA, NP10 8GB, NP10 8GD, NP10 8GE, NP10 8GF, NP10 8GG, NP10 8GH, NP10 8GL",451,392,59
W00009532,CF14,"CF14 6JB, CF14 6JU, CF14 6JW, CF14 6JX, CF14 6LD, CF14 6LE, CF4 6JZ, CF4 6LJ, CF4 6RP",305,277,28
W00009533,CF14,"CF14 6JY, CF14 6JZ, CF14 6LA, CF14 6LH, CF14 6RP, CF14 6RQ, CF4 6JY, CF4 6LH, CF4 6RL, CF4 6RN, CF4 6RQ",248,216,32
W00009534,CF14,"CF14 6NG, CF14 6PL, CF14 6PN, CF14 6PP, CF14 6PQ, CF4 6NH, CF4 6NL, CF4 6PN, CF4 6PP, CF4 6PQ",193,175,18
W00009750,CF14,"CF14 1AN, CF14 1AQ, CF14 1PW, CF14 1QD, CF14 1QE, CF14 1QF, CF14 1RF, CF14 1WA, CF14 1WH, CF14 1WL, CF14 1WZ, CF14 2XL, CF14 6BE, CF14 6BR, CF14 6DL, CF4 1AN, CF4 1QE, CF4 1QF, CF4 1RF, CF4 1RN, CF4 1RP, CF4 1YY, CF4 1YZ, CF4 2XL, CF4 6BN, CF4 6BR, CF4 6DF",275,247,28
W00009749,CF14,"CF14 7AA, CF14 7AB, CF14 7AD, CF14 7AR, CF14 7AS, CF4 7AB, CF4 7AD, CF4 7AF, CF4 7AS",354,251,103
W00010641,CF14,"CF14 3NL, CF14 3NN, CF14 3NS, CF14 3YT, CF4 3YT, CF4 3YU, CF4 3YX, CF4 3ZA, CF4 4XY, CF4 4XZ",545,454,91
W00010640,CF14,"CF14 3AG, CF14 3AH, CF14 3BL, CF14 3DR, CF14 3DS, CF14 3DU, CF14 3EH, CF4 3BL, CF4 3EH, CF4 3LE, CF4 3XR",356,325,31
W00009737,CF14,"CF14 1JL, CF14 1JN, CF14 1JP, CF14 1JQ, CF14 1JS, CF14 1JT, CF14 1LB, CF14 2NP, CF4 1HJ, CF4 1HL, CF4 1JN, CF4 1JP, CF4 1JQ, CF4 1JS, CF4 1JZ, CF4 1LA",276,242,34
W00009738,CF14,"CF14 1HN, CF14 1JU, CF14 1JW, CF14 1LA, CF4 1HG, CF4 1HH, CF4 1JX",266,238,28
W00009739,CF14,"CF14 7EH, CF14 7EL, CF14 7EN, CF14 7EQ, CF14 7ER, CF14 7ES, CF4 7EL, CF4 7EN, CF4 7EP, CF4 7EQ, CF4 7ER, CF4 7ES",329,271,58
W00009501,CF14,"CF14 0HY, CF14 0PJ, CF14 0RP, CF23 8AA, CF23 8AB, CF23 8AU, CF23 8BA, CF23 8BB, CF23 8DA, CF23 8FN, CF23 8GL, CF23 8GS, CF23 8LZ, CF23 8NL, CF23 8PA, CF23 8PN, CF23 8PS, CF23 8PW, CF23 8PX, CF23 8RA, CF23 8RB, CF23 8RD, CF23 8RH, CF23 8RL, CF23 8RP, CF23 8RS, CF23 8RT, CF23 8RU, CF23 8RW, CF23 8RX, CF23 8WD, CF23 8WE, CF23 8WF, CF23 8WG, CF23 8WH, CF23 8WL, CF23 8WU, CF23 8XG, CF23 8XH, CF3 9YQ",367,321,46
W00009740,CF14,"CF14 7DP, CF14 7DR, CF14 7EB, CF14 7ED, CF14 7EE, CF14 7EF, CF14 7ET, CF14 7EW, CF14 7HY, CF14 7XE, CF14 7XF, CF14 7XS, CF14 7XZ, CF14 7YF, CF14 7YP, CF14 7YR, CF14 7YS, CF14 7YT, CF14 7YU, CF14 7ZB, CF4 7EB, CF4 7ED, CF4 7EE, CF4 7EH, CF4 7ET, CF4 7EW, CF4 7GY, CF4 7GZ, CF4 7XE, CF4 7XF, CF4 7XN, CF4 7XP, CF4 7XS, CF4 7XZ, CF4 7YR, CF4 7YS",449,377,72
W00009736,CF14,"CF14 1EQ, CF14 1HY, CF14 1HZ, CF14 1YW, CF4 1HE, CF4 1XS, CF4 1YA, CF4 1YU, CF4 1YW, CF4 1YX",297,259,38
W00010549,CF14,"CF14 3BB, CF14 3LE, CF14 3LF, CF14 3XP, CF4 3XP",263,242,21
W00009741,CF14,"CF14 7EG, CF14 7EJ, CF14 7EP, CF14 7EU, CF14 7EX, CF14 7EY, CF14 7TB, CF14 7TH, CF4 6XA, CF4 6XB, CF4 6XF, CF4 6XH, CF4 6XW, CF4 6XX, CF4 6XY, CF4 7EG, CF4 7EJ, CF4 7EU, CF4 7EX, CF4 7EZ",331,259,72
W00009517,CF14,"CF14 6LP, CF14 6NP, CF14 6NQ, CF14 6NR, CF14 6NS, CF14 6NT, CF4 6LL",275,229,46
W00009742,CF14,"CF14 7BT, CF14 7BX, CF14 7BZ, CF14 7DB, CF14 7DE, CF14 7TG, CF14 7UB, CF14 7WF, CF14 7WG, CF14 7XG, CF14 7XH, CF4 7BZ, CF4 7DA, CF4 7DB",263,227,36
W00009535,CF14,"CF14 6LL, CF14 6NJ, CF14 6NL, CF14 6PH, CF14 6RA, CF14 6RB, CF14 6RD, CF4 6LN, CF4 6NJ, CF4 6PL, CF4 6RB, CF4 6RD, CF4 6RG",253,231,22
W00009518,CF14,"CF14 6AQ, CF14 6AR, CF14 6AS, CF14 6AT, CF14 6AU",273,238,35
W00009520,CF14,"CF14 6SB, CF14 6SE, CF14 6SG, CF14 6TT, CF14 6TU, CF4 6SH, CF4 6TT, CF4 6TW",289,251,38
W00009743,CF14,"CF14 7BJ, CF14 7BU, CF14 7BY, CF14 7DA, CF14 7DD, CF14 7DF, CF4 7BU, CF4 7BY, CF4 7DD",303,269,34
W00009521,CF14,"CF14 6QA, CF14 6QP, CF14 6QQ, CF14 6QR, CF14 6RH, CF14 6ZA, CF4 6QA, CF4 6QP, CF4 6QQ, CF4 6QR",295,271,24
W00009522,CF14,"CF14 6LG, CF14 6QE, CF14 6RE, CF14 6RJ, CF14 6SR, CF14 6SS, CF4 6SR, CF4 6SS",272,241,31
W00009744,CF14,"CF14 7BG, CF14 7DS, CF14 7DT, CF14 7DU, CF14 7DW, CF14 7DX, CF14 7DY, CF14 7DZ, CF14 7EA, CF4 7DS, CF4 7DT, CF4 7DU, CF4 7DW, CF4 7DX, CF4 7DY, CF4 7DZ, CF4 7EA, CF4 7EF",234,207,27
W00009745,CF14,"CF14 7AL, CF14 7AQ, CF14 7BS, CF14 7BW, CF14 7TA, CF14 7TF, CF4 6XG, CF4 7AL, CF4 7AN, CF4 7AP, CF4 7AW, CF4 7BS, CF4 7BT, CF4 7BW, CF4 7BX",260,210,50
W00009746,CF14,"CF14 1AY, CF14 7AG, CF14 7AH, CF14 7AJ, CF14 7AN, CF14 7AP, CF14 7BH, CF4 1AY, CF4 1BG, CF4 1BH, CF4 1BJ, CF4 1BL, CF4 1BP, CF4 7AJ",298,233,65
W00010572,CF14,"CF14 3NQ, CF14 3PZ",139,107,32
W00009747,CF14,"CF14 7AF, CF14 7AW, CF14 7AX, CF14 7AZ, CF14 7BA, CF14 7BD, CF4 7AG, CF4 7AH",254,197,57
W00009748,CF14,"CF14 7AE, CF14 7AT, CF14 7AU, CF14 7AY, CF14 7BB, CF14 7BE, CF14 7BL, CF14 7BN, CF14 7BP, CF14 7BR, CF14 7EZ, CF4 7AE, CF4 7BA, CF4 7BB, CF4 7BD, CF4 7BE, CF4 7BN, CF4 7BP, CF4 7BR",209,173,36
W00009519,CF14,"CF14 6LJ, CF14 6ST, CF14 6SW, CF14 6SX, CF14 6SZ, CF4 6SQ, CF4 6SY, CF4 6SZ",224,202,22
W00009536,CF14,"CF14 6HJ, CF14 6JN, CF14 6JQ, CF14 6JS, CF14 6JT, CF14 6YB, CF14 6YD, CF14 6YJ, CF14 6YS, CF14 6YX, CF4 6JQ, CF4 6JR, CF4 6JT, CF4 6JU, CF4 6JW, CF4 6LA, CF4 6LD, CF4 6LE, CF4 6NP, CF4 6WA, CF4 6YD, CF4 6YG, CF4 6YH, CF4 6YN, CF4 6YQ, CF4 6YU, CF4 6YW, CF4 6YY",258,226,32
W00009524,CF14,"CF14 6PE, CF14 6PG, CF14 6PJ, CF14 6PR, CF14 6QS, CF14 6RF, CF14 6RG, CF4 5JF, CF4 5ZA, CF4 6PE, CF4 6PG, CF4 6PH, CF4 6PJ, CF4 6PR, CF4 6QS, CF4 6RF, CF4 6RH",264,234,30
W00009538,CF14,"CF14 1BJ, CF14 1BL, CF14 1BN, CF14 1BP, CF14 1BQ, CF14 1BR, CF14 6EN, CF14 6ES, CF4 1BN, CF4 6EN, CF4 6ER, CF4 6ES",205,194,11
W00009753,CF14,"CF14 1AD, CF14 1AF, CF14 1AL, CF14 1AS, CF14 1AT, CF14 1AU, CF14 1BW, CF14 1BX, CF4 1AL, CF4 1AX, CF4 1AZ, CF4 6DL",198,156,42
W00009537,CF14,"CF14 6ER, CF14 6HE, CF14 6HN, CF14 6HQ, CF14 6HZ, CF4 6EF, CF4 6HE, CF4 6HJ, CF4 6HN, CF4 6HQ, CF4 6HR, CF4 6HU, CF4 6JN, CF4 6JS",234,199,35
W00009542,CF14,"CF14 6EA, CF14 6ED, CF14 6EE, CF14 6EF, CF14 6EG, CF14 6HL, CF4 6EA, CF4 6EB, CF4 6ED, CF4 6EE, CF4 6EG, CF4 6HH",245,182,63
W00009541,CF14,"CF14 6DY, CF14 6EB, CF14 6HA, CF14 6HB, CF14 6HD, CF14 6HF, CF14 6HG, CF14 6HH, CF14 6JL, CF14 6JP, CF14 6LQ, CF14 6YF, CF4 6HD, CF4 6HF, CF4 6HL, CF4 6JJ, CF4 6JL, CF4 6JP",268,219,49
W00009754,CF14,"CF14 1DN, CF14 1DP, CF14 1DQ, CF14 1DR, CF14 1PP, CF14 1PR, CF4 1DQ, CF4 1PP",178,166,12
W00009540,CF14,"CF14 6LU, CF14 6LW, CF14 6LY, CF14 6LZ, CF14 6NB, CF14 6NF, CF14 6PB, CF14 6PD, CF14 6YE, CF4 5EB, CF4 6LW, CF4 6LZ, CF4 6ND, CF4 6NG, CF4 6NQ, CF4 6NX, CF4 6PB, CF4 6PD, CF4 6RA, CF4 6YE",281,219,62
W00010498,CF14,"CF14 3AF, CF14 3AS, CF14 3AW, CF14 3DT, CF14 3DW, CF14 3DX, CF14 3DZ, CF14 3EA, CF14 3GH, CF14 3UX, CF14 3UY, CF4 3AG, CF4 3AH, CF4 3AJ, CF4 3AL, CF4 3AQ, CF4 3AS, CF4 3AT, CF4 3AX, CF4 3AY, CF4 3BJ, CF4 3DR, CF4 3DS, CF4 3DT, CF4 3DZ, CF4 3EA, CF4 3EF, CF4 3EG, CF4 3UJ, CF4 3UL, CF4 3XA",1485,1346,139
W00009755,CF14,"CF14 1AA, CF14 1AH, CF14 1BT, CF14 1BY, CF14 1XQ, CF14 2AA, CF14 2AB, CF14 2AD, CF14 2AE, CF14 2AF, CF14 2AX, CF14 2XH, CF14 2XJ, CF14 2XR, CF14 2XS, CF4 1AB, CF4 1AH, CF4 1AJ, CF4 1AR, CF4 1AS, CF4 1AT, CF4 1AU, CF4 1BS, CF4 1BT, CF4 1BU, CF4 1BX, CF4 2AA, CF4 2AB, CF4 2AE, CF4 2AF, CF4 2AX, CF4 2XB, CF4 2XH, CF4 2XJ, CF4 2XQ, CF4 2XS",251,198,53
W00009756,CF14,"CF14 1AB, CF14 1AE, CF14 1AG, CF14 1AP, CF14 1AR, CF14 1BS, CF14 1BU, CF14 1LG, CF4 1AD, CF4 1AE, CF4 1AF, CF4 1AG, CF4 1AP, CF4 1AQ",196,175,21
W00009757,CF14,"CF14 2AS, CF14 2BR, CF14 2BT, CF14 2DA, CF14 2DB, CF14 2DD, CF14 2DE, CF14 2TF, CF14 2TL, CF14 2TQ, CF4 2AS, CF4 2AT, CF4 2AY, CF4 2AZ, CF4 2DA, CF4 2DE, CF4 7JD, CF4 7JF, CF4 7XJ, CF4 7XL, CF4 7XQ",317,254,63
W00009758,CF14,"CF14 2AG, CF14 2AH, CF14 2AJ, CF14 2AL, CF14 2AP, CF14 2AQ, CF4 2AD, CF4 2AG, CF4 2AH, CF4 2AJ, CF4 2AL, CF4 2AP, CF4 2AQ, CF4 2XP, CF4 2XR, CF4 7JE, CF4 7XA, CF4 7XD",304,211,93
W00009759,CF14,"CF14 1AJ, CF14 1DA, CF14 1DB, CF14 1DD, CF14 1DG, CF14 1DH, CF14 1DJ, CF14 1EN, CF14 1LP, CF14 1LT, CF14 1LZ, CF14 1NN, CF14 1NR, CF14 1XB, CF14 1XG, CF14 1XL, CF4 1DG, CF4 1DH, CF4 1DN, CF4 1DP, CF4 1DR, CF4 1EN, CF4 1LT, CF4 1LZ, CF4 1NR, CF4 1PH, CF4 1XB, CF4 1XE",256,199,57
W00009760,CF14,"CF14 2BZ, CF14 2DF, CF14 2DG, CF4 2BZ, CF4 2DG, CF4 7JG",318,287,31
W00009761,CF14,"CF14 2BQ, CF14 2BS, CF14 2BU, CF14 2BX, CF14 2BY, CF4 2BR, CF4 2BX, CF4 2BY, CF4 2DB, CF4 2DD, CF4 2DF",302,239,63
W00010497,CF14,"CF14 3AN, CF14 3AP, CF14 3AQ, CF14 3AR, CF14 3ED, CF14 3UU, CF4 3AD, CF4 3AE, CF4 3AF, CF4 3AN, CF4 3AP, CF4 3AR, CF4 3AW, CF4 3BH, CF4 3BY, CF4 3DU, CF4 3DW, CF4 3ED, CF4 3XD",1713,1557,156
W00009762,CF14,"CF14 2AR, CF14 2AU, CF14 2AW, CF14 2BA, CF14 2DY, CF14 2EA, CF14 2ED, CF14 2EE, CF14 2EG, CF14 2XG, CF4 2AR, CF4 2AU, CF4 2AW, CF4 2BA, CF4 2DY, CF4 2EA, CF4 2EB, CF4 2ED, CF4 2EE",356,251,105
W00009546,CF14,"CF14 6JJ, CF14 6JR, CF14 6LT, CF14 6LX, CF14 6NA, CF14 6NN, CF14 6NW, CF4 6LU, CF4 6LY, CF4 6NA, CF4 6NB, CF4 6NF, CF4 6NN, CF4 6NR, CF4 6NS, CF4 6NT, CF4 6NU, CF4 6NW",238,214,24
W00009539,CF14,"CF14 6ND, CF14 6NE, CF14 6NH, CF14 6NX, CF14 6NY, CF14 6NZ, CF14 6PA, CF4 6NE, CF4 6NY, CF4 6NZ, CF4 6PA, CF4 6PF",309,230,79
W00009545,CF14,"CF14 6DX, CF14 6DZ, CF14 6EH, CF14 6EJ, CF14 6EP, CF14 6EQ, CF14 6YA, CF4 6AJ, CF4 6DX, CF4 6DY, CF4 6DZ, CF4 6EH, CF4 6EJ, CF4 6EP, CF4 6EQ, CF4 6HA, CF4 6HB, CF4 6HG, CF4 6LT, CF4 6LX, CF4 6YA, CF4 6YF, CF4 6YJ, CF4 6YL, CF4 6YP, CF4 6YR, CF4 6YS, CF4 6YT, CF4 6YX, CF4 6ZD",295,251,44
W00009769,CF14,"CF14 1DU, CF14 1JE, CF14 1LF, CF14 1NQ, CF14 1NS, CF14 1NT, CF14 1NU, CF14 2NQ, CF4 1NT, CF4 1NU, CF4 2NQ",199,188,11
W00009768,CF14,"CF14 1DS, CF14 1DT, CF14 1EH, CF14 1XN, CF14 1XR, CF4 1DD, CF4 1DJ, CF4 1DS, CF4 1DT, CF4 1DU, CF4 1EH, CF4 1LF, CF4 1PS, CF4 1XD, CF4 1XF, CF4 1XG, CF4 1XH, CF4 1XL, CF4 1XN, CF4 1XR",275,240,35
W00009752,CF14,"CF14 2TJ, CF14 2TZ, CF14 2WA, CF14 2WB, CF14 7XB, CF4 7AQ, CF4 7AT, CF4 7AU, CF4 7AX, CF4 7AY, CF4 7AZ, CF4 7BL, CF4 7XB, CF4 7YY",126,109,17
W00009544,CF14,"CF14 4ST, CF14 4SW, CF14 4SX, CF14 4SZ, CF14 6AP, CF4 4SP, CF4 4SU, CF4 4SW, CF4 4SX, CF4 4SZ, CF4 4TS, CF4 4TT",280,225,55
W00009766,CF14,"CF14 1PT, CF14 1PU, CF14 1QA, CF14 1QB, CF14 1QG, CF14 1QH, CF14 1QJ, CF14 1XE, CF14 1XF, CF14 1YJ, CF4 1PU, CF4 1PX, CF4 1QA, CF4 1QB, CF4 1QD, CF4 1QG, CF4 1QH, CF4 1QJ, CF4 1QL, CF4 1YD, CF4 1YF, CF4 1YH, CF4 1YJ, CF4 1YL, CF4 1YP, CF4 1YQ, CF4 1YR, CF4 1YS, CF4 1YT",282,233,49
W00009765,CF14,"CF14 1DE, CF14 1ER, CF14 1PQ, CF14 1PS, CF14 1PX, CF14 1PY, CF14 1PZ, CF4 1PA, CF4 1PB, CF4 1PD, CF4 1PE, CF4 1PF, CF4 1PG, CF4 1PQ, CF4 1PR, CF4 1PW, CF4 1PY, CF4 1PZ, CF4 1XP",269,199,70
W00009764,CF14,"CF14 1QN, CF14 1QQ, CF14 1RD, CF14 1RE, CF14 1RY, CF14 1RZ, CF14 1SA, CF4 1RD, CF4 1RE, CF4 1RL, CF4 1RZ, CF4 1TB, CF4 1UP",252,226,26
W00009763,CF14,"CF14 2HB, CF14 2HG, CF14 2HN, CF14 2HP, CF14 2TH, CF14 2TS, CF4 2BL, CF4 2BN, CF4 7XU",285,238,47
W00009767,CF14,"CF14 2EH, CF14 2EJ, CF14 2EL, CF14 2EN, CF14 2EP, CF4 2EH, CF4 2EL, CF4 2EN, CF4 2EP",316,215,101
W00009510,CF15,"CF15 8DD, CF15 8DJ, CF15 8DL, CF15 8DN, CF15 8EP, CF15 8ES, CF15 8RP, CF15 8RX, CF15 8RY, CF15 8RZ, CF4 8BZ, CF4 8DA, CF4 8DD, CF4 8DE, CF4 8DG, CF4 8DL, CF4 8RX, CF4 8RY",311,285,26
W00009509,CF15,"CF15 8EN, CF15 8RQ, CF15 8RR, CF15 8RS, CF15 8RT, CF15 8RW, CF4 8EN, CF4 8RQ, CF4 8RR, CF4 8RU, CF4 8SX",303,251,52
W00010227,CF15,"CF15 8FP, CF15 8FT, CF15 8GN, CF15 8LE, CF15 8LT, CF4 8LF, CF4 8LT",267,208,59
W00009508,CF15,"CF15 8RL, CF15 8RN, CF15 8RU, CF15 8SW, CF15 8SX, CF15 8WZ, CF4 8RJ, CF4 8RL, CF4 8RN, CF4 8RT, CF4 8SW",314,282,32
W00009507,CF15,"CF15 8BY, CF15 8BZ, CF15 8DA, CF15 8DE, CF15 8RE, CF15 8RF, CF15 8XD, CF15 8XL, CF15 8XN, CF15 8YA, CF15 8YP, CF15 8YQ, CF15 8YU, CF4 8AR, CF4 8AT, CF4 8AU, CF4 8AW, CF4 8AX, CF4 8AY, CF4 8BD, CF4 8BL, CF4 8RA, CF4 8RH",312,276,36
W00009506,CF15,"CF15 8BG, CF15 8RB, CF15 8RD, CF15 8RG, CF15 8RH, CF15 8RJ, CF4 8BE, CF4 8BG, CF4 8RB, CF4 8RD, CF4 8RE, CF4 8RF, CF4 8RG",286,253,33
W00009505,CF15,"CF15 8AN, CF15 8AQ, CF15 8AR, CF15 8AT, CF15 8AU, CF15 8AW, CF15 8AX, CF15 8AY, CF15 8BD, CF15 8RA, CF4 8AQ, CF4 8AS",227,189,38
W00009503,CF15,"CF15 8AF, CF15 8AJ, CF15 8AP, CF15 8BS, CF15 8BW, CF15 8BX, CF15 8DB, CF15 8DF, CF15 8DG, CF15 8DP, CF15 8DQ, CF15 8EQ, CF15 8GD, CF15 8GE, CF15 8GF, CF15 8GG, CF4 8AF, CF4 8BN, CF4 8BQ, CF4 8BS, CF4 8BU, CF4 8BW, CF4 8BX, CF4 8BY, CF4 8DF, CF4 8DJ, CF4 8DP, CF4 8DQ, CF4 8XA, CF4 8XD, CF4 8XP",555,473,82
W00006526,CF15,"CF15 7NB, CF15 7NZ, CF15 7RS, CF15 7RT, CF15 7RW, CF15 7RX, CF15 7RY, CF15 7WD, CF15 7YB, CF15 7YH, CF15 7YN, CF4 7RP, CF4 7RS, CF4 7RT, CF4 7RU, CF4 7RW, CF4 7RX, CF4 7RY, CF4 7SE",308,271,37
W00009375,CF15,"CF15 9HA, CF15 9HH, CF15 9HJ, CF15 9HL, CF15 9HQ, CF15 9HR, CF15 9HS, CF15 9HT, CF15 9HU, CF15 9HW, CF15 9HX, CF15 9HY, CF15 9HZ, CF15 9JA, CF15 9JB, CF15 9JD, CF15 9JE, CF15 9JF, CF15 9JG, CF15 9JH, CF4 8HH, CF4 8HJ, CF4 8HL, CF4 8HN, CF4 8HP, CF4 8HR, CF4 8HS, CF4 8HT, CF4 8HU, CF4 8HW, CF4 8HX, CF4 8HY, CF4 8HZ, CF4 8JA, CF4 8JB, CF4 8JD, CF4 8JE, CF4 8JF, CF4 8JG, CF4 8JQ",408,300,108
W00009380,CF15,"CF15 7YL, CF15 7YW, CF15 7YX, CF15 8YB, CF15 8YH, CF15 8YJ, CF15 8YN, CF15 8YT, CF15 8ZB, CF15 9PZ, CF15 9QQ, CF15 9QR, CF15 9UA, CF15 9YA, CF15 9YH, CF15 9YL, CF15 9YN, CF15 9YP, CF15 9YQ, CF15 9YT, CF15 9YU, CF15 9YX, CF4 8AB, CF4 8NP, CF4 8QQ, CF4 8QR",253,206,47
W00009377,CF15,"CF15 9AB, CF15 9NP, CF15 9PU, CF15 9QP, CF15 9SJ, CF4 8PS, CF4 8QP",276,227,49
W00009378,CF15,"CF15 9NR, CF15 9PN, CF15 9PP, CF15 9PQ, CF15 9PS, CF15 9QD, CF15 9QE, CF15 9QT, CF15 9QZ, CF15 9RA, CF4 8PN, CF4 8PP, CF4 8PQ",352,285,67
W00009379,CF15,"CF15 9AD, CF15 9GE, CF15 9PT, CF15 9PW, CF15 9PY, CF15 9QA, CF15 9QL, CF15 9TN, CF15 9YB, CF15 9YF, CF15 9YG, CF4 8NR, CF4 8PT, CF4 8PU, CF4 8PW, CF4 8PY, CF4 8PZ, CF4 8QL, CF4 8SJ, CF4 8TN, CF4 8TP, CF4 8TR, CF4 8TS",249,197,52
W00009718,CF15,"CF15 7HU, CF15 7HW, CF15 7HX, CF15 7LF, CF15 7NG, CF15 7NH, CF15 7NJ, CF15 7NX, CF4 7LE, CF4 7LF, CF4 7LY, CF4 7NH, CF4 7NJ, CF4 7NL, CF4 7NX, CF4 7NZ, CF4 7XX",353,307,46
W00009382,CF15,"CF15 9PX, CF15 9QS, CF15 9QU, CF15 9QW, CF15 9TB, CF15 9TD, CF15 9TJ, CF4 8PX, CF4 8QB, CF4 8QD, CF4 8QE, CF4 8QS, CF4 8QT, CF4 8QU, CF4 8QW, CF4 8TD",277,232,45
W00009383,CF15,"CF15 9LG, CF15 9NB, CF15 9ND, CF15 9NE, CF15 9PD, CF15 9QJ, CF15 9TA, CF4 8NB, CF4 8ND, CF4 8NE, CF4 8PD, CF4 8PE, CF4 8QA, CF4 8QJ, CF4 8TA, CF4 8TB, CF4 8UA",281,222,59
W00009384,CF15,"CF15 9LJ, CF15 9QF, CF15 9QG, CF15 9QH, CF15 9QN, CF15 9QX, CF15 9TE, CF15 9TF, CF15 9TG, CF15 9TH, CF15 9TL, CF15 9XB, CF4 8HB, CF4 8PR, CF4 8QF, CF4 8QG, CF4 8QH, CF4 8QN, CF4 8QX, CF4 8TE, CF4 8TF, CF4 8TG, CF4 8TH, CF4 8TJ, CF4 8TL, CF4 8TQ, CF4 8XB, CF4 8YB, CF4 8YE, CF4 8YG, CF4 8YH, CF4 8YJ, CF4 8YN, CF4 8YQ, CF4 8YS, CF4 8YT, CF4 8YU, CF4 8YW, CF4 8YX, CF4 8YY, CF4 8YZ",345,256,89
W00009385,CF15,"CF15 9HN, CF15 9HP, CF15 9SP, CF15 9SR, CF15 9ST, CF15 9SU, CF4 7PF, CF4 7PJ, CF4 7PL, CF4 7PN, CF4 7PQ, CF4 7RL, CF4 8SP, CF4 8SR, CF4 8ST, CF4 8SU, CF4 9YB, CF4 9YD, CF4 9YE, CF4 9YG, CF4 9YJ, CF4 9YN, CF4 9YT",375,286,89
W00009716,CF15,"CF15 7JL, CF15 7JP, CF15 7JQ, CF15 7JR, CF15 7JS, CF15 7LN, CF15 7LP, CF4 7JQ, CF4 7JS, CF4 7LA, CF4 7LB, CF4 7LP, CF4 7NU, CF4 7XW, CF8 1NG, CF83 1NG",309,261,48
W00009511,CF15,"CF15 8AL, CF15 8BH, CF15 8BL, CF15 8BP, CF15 8BQ, CF15 8BR, CF15 8BT, CF15 8BU, CF15 8DH, CF15 8FS, CF4 8AA, CF4 8AG, CF4 8AH, CF4 8AJ, CF4 8AL, CF4 8AP, CF4 8BH, CF4 8BP, CF4 8BR, CF4 8BT, CF4 8DH, CF4 8DY",347,292,55
W00009717,CF15,"CF15 7LG, CF15 7LH, CF15 7LJ, CF15 7LL, CF15 7LZ, CF15 7NL, CF15 7NN, CF15 7NP, CF15 7NQ, CF15 7NR, CF15 7NS, CF15 7NT, CF15 7NU, CF15 7NW, CF4 7JP, CF4 7JR, CF4 7LG, CF4 7LH, CF4 7LL, CF4 7LZ, CF4 7NG, CF4 7NP, CF4 7NQ, CF4 7NR, CF4 7NS, CF4 7NT, CF4 7NW",272,227,45
W00009376,CF15,"CF15 5AA, CF15 5AB, CF15 5AD, CF15 5AE, CF15 5AF, CF15 5AG, CF15 5AH, CF15 5AL, CF15 5AN, CF15 5AP, CF15 5AQ, CF15 5AR, CF15 5AS, CF15 5AT, CF15 5AU, CF15 5AW, CF15 5AX, CF15 5AY, CF15 5AZ, CF15 5BA, CF15 5BB, CF15 5BD, CF15 5BE, CF15 5BF, CF15 5BG, CF15 5BH, CF15 5BJ, CF15 5BL, CF15 5BN, CF15 5BP, CF15 5BQ, CF15 5BR, CF15 5BS, CF15 5BT, CF15 5BU, CF15 5BW, CF15 5BX, CF15 5BY, CF15 5BZ, CF15 5DA, CF15 5DB, CF15 5DD, CF15 5DE, CF15 5DF, CF15 5DG, CF15 5DH, CF15 5DJ, CF15 5DL, CF15 5DN, CF15 5DP, CF15 5DQ, CF15 5DR, CF15 5DS, CF15 5DT, CF15 5DU, CF15 5DW, CF15 5DX, CF15 5DY, CF15 5DZ, CF15 5EA, CF15 5EB, CF15 5ED, CF15 5EE, CF15 5EF, CF15 5EG, CF15 5EH, CF15 5EJ, CF15 5ZZ, CF15 7WE, CF15 7WG, CF15 7WZ, CF15 7XY, CF15 7XZ, CF15 7YD, CF15 7YR, CF15 7YS, CF15 7YT, CF15 7YU, CF15 7YY, CF15 7ZW, CF15 8LA, CF15 8LW, CF15 8LX, CF15 8XH, CF15 8XR, CF15 8YD, CF15 8YE, CF15 8YF, CF15 8YG, CF15 8YS, CF15 8ZX, CF15 8ZY, CF15 9AA, CF15 9AE, CF15 9HB, CF15 9HD, CF15 9HE, CF15 9HF, CF15 9HG, CF15 9JN, CF15 9NA, CF15 9SS, CF15 9TP, CF15 9TR, CF15 9TS, CF15 9TT, CF15 9TU, CF15 9WZ, CF15 9XE, CF15 9XF, CF15 9XG, CF15 9XJ, CF15 9XQ, CF15 9XU, CF15 9YD, CF15 9YE, CF15 9YJ, CF15 9YR, CF15 9YY, CF15 9YZ, CF15 9ZB, CF15 9ZP, CF4 7RB, CF4 7RE, CF4 7RJ, CF4 8HA, CF4 8HD, CF4 8HE, CF4 8HF, CF4 8HG, CF4 8HQ, CF4 8JH, CF4 8JN, CF4 8SH, CF4 8SS, CF4 8XE, CF4 8XF, CF4 8YA, CF4 8YD, CF4 8YF, CF4 8YL, CF4 8YP, CF4 8YR, CF4 8ZD",387,307,80
W00009512,CF15,"CF15 8AA, CF15 8AB, CF15 8AE, CF15 8AG, CF15 8AH, CF15 8BN, CF15 8DW, CF15 8DY, CF15 8DZ, CF15 8EE, CF15 8EW, CF4 8AE, CF4 8DZ, CF4 8EB, CF4 8ED, CF4 8EE",367,303,64
W00006517,CF15,"CF15 7RU, CF15 7RZ, CF15 7SB, CF15 7SD, CF15 7SE, CF15 7SF, CF4 7RZ, CF4 7SD, CF4 7SF",298,273,25
W00009515,CF15,"CF15 8LD, CF15 8LF, CF15 8LG, CF15 8LH, CF15 8LJ, CF15 8LL, CF15 8LP, CF15 8LQ, CF15 8LR, CF15 8LU, CF4 8LA, CF4 8LB, CF4 8LD, CF4 8LG, CF4 8LH, CF4 8LJ, CF4 8LL, CF4 8LP",297,251,46
W00006547,CF15,"CF15 9JJ, CF15 9JL, CF15 9LA, CF37 5SL, CF37 5SP, CF37 5SQ, CF37 5SR, CF37 5SU, CF37 5SW, CF37 5SY, CF37 5TA, CF37 5TB, CF37 5TF, CF37 5TG, CF37 5TL, CF37 5TN, CF37 5TP, CF37 5TT, CF37 5TU, CF37 5TY, CF37 5UB, CF37 5XB, CF37 5XD, CF37 5XF, CF37 5XL, CF37 5XQ, CF37 5XR, CF37 5YB, CF37 5YH, CF37 5YQ, CF38 1NG, CF38 1NH, CF38 1NL, CF38 1SG, CF38 1SH, CF38 1SL, CF4 7QN, CF4 7SN, CF4 7SP, CF4 8JJ, CF4 8JL",296,260,36
W00009920,CF15,"CF15 7UP, CF15 7UQ, CF15 7UR, CF15 7US, CF15 7UT, CF4 7UG, CF4 7UN, CF4 7UQ, CF4 7UR, CF4 7US, CF4 7UT, CF83 2AQ, CF83 2AU, CF83 2AW, CF83 2AY, CF83 2DA, CF83 2DB, CF83 2DD, CF83 2RL",481,415,66
W00009720,CF15,"CF15 7LA, CF15 7LB, CF15 7LE, CF15 7LQ, CF15 7LR, CF15 7LS, CF15 7XQ, CF15 7XW, CF4 7JW, CF4 7LD, CF4 7LQ, CF4 7LR, CF4 7LS, CF4 7LT, CF4 7LU",289,248,41
W00006247,CF15,"CF15 7TF, CF15 7UU, CF15 7UW, CF37 5AJ, CF37 5AX, CF37 5BF, CF37 5BJ, CF37 5BL, CF37 5SS, CF37 5ST, CF37 5TD, CF37 5TE, CF37 5TH, CF37 5TJ, CF37 5TR, CF37 5TS, CF37 5TW, CF37 5UD, CF37 5UE, CF37 5UF, CF37 5UG, CF37 5UH, CF37 5UL, CF37 5UP, CF37 5UR, CF37 5US, CF37 5UT, CF37 5UU, CF37 5UW, CF37 5UY, CF37 5WA, CF37 5WT, CF37 5XE, CF37 5XG, CF37 5YA, CF37 5YD, CF37 5YE, CF37 5YF, CF37 5YG, CF37 5YL, CF37 5YN, CF37 5YP, CF37 5YR, CF37 5YT, CF37 5YU, CF37 5YW, CF37 5YX, CF37 5YY, CF4 7SU, CF4 7SW, CF4 7SX, CF4 7UP, CF4 7UU, CF4 7UW",130,106,24
W00008942,CF15,"CF15 9EJ, CF15 9EU, CF15 9JW, CF15 9JX, CF15 9JY, CF15 9JZ, CF15 9SQ, CF4 8LX",243,174,69
W00008941,CF15,"CF15 9JR, CF15 9JT, CF15 9JU, CF15 9LQ, CF15 9LW, CF15 9LY, CF15 9LZ, CF4 8DR, CF4 8DS, CF4 8EJ, CF4 8LW, CF4 8LY, CF4 8LZ, CF4 8NL",249,209,40
W00008940,CF15,"CF15 9LX, CF15 9NU, CF15 9NW, CF15 9SL, CF15 9SY, CF15 9SZ, CF4 8EW, CF4 8FA, CF4 8FB, CF4 8FD, CF4 8FE, CF4 8FF, CF4 8GE, CF4 8NN, CF4 8NU, CF4 8SZ",274,195,79
W00008939,CF15,"CF15 9JP, CF15 9NZ, CF15 9PA, CF15 9PB, CF4 8NW, CF4 8NZ, CF4 8PB",265,214,51
W00008938,CF15,"CF15 9SA, CF15 9SB, CF15 9SE, CF15 9SG, CF4 8SB, CF4 8SE, CF4 8SF, CF4 8SG",293,237,56
W00008937,CF15,"CF15 9NG, CF15 9NJ, CF15 9NN, CF15 9NT, CF15 9SD, CF15 9SF, CF4 8NJ, CF4 8PA, CF4 8SA, CF4 8SD, CF4 8SY, CF72 8FG",301,231,70
W00008936,CF15,"CF15 9NL, CF15 9NX, CF15 9NY, CF15 9PE, CF15 9PR, CF15 9TQ, CF4 8NG",332,228,104
W00008935,CF15,"CF15 9NF, CF15 9NH, CF4 8NF, CF4 8NH, CF4 8NX, CF4 8NY, CF5 6GA, CF5 6GB, CF5 6GD, CF5 6GE, CF5 6GF, CF5 6GG, CF5 6GH, CF5 6GJ, CF5 6GL, CF5 6GN, CF5 6GP, CF5 6JA, CF5 6JH, CF5 6JQ, CF5 6JR, CF7 8NG, CF7 8NL, CF7 8NU, CF72 8NG, CF72 8NU, CF72 8SA",314,265,49
W00009514,CF15,"CF15 8AS, CF15 8AZ, CF15 8BA, CF15 8BB, CF15 8BE, CF15 8BJ, CF15 8EZ, CF15 8LB, CF15 8LS, CF4 7LJ, CF4 7LN, CF4 7NN, CF4 8AZ, CF4 8BA, CF4 8BB, CF4 8BJ, CF4 8LN, CF4 8LR, CF4 8LS, CF4 8LU",297,253,44
W00008934,CF15,"CF15 9DR, CF15 9DS, CF15 9ET, CF15 9EW, CF15 9JQ, CF15 9JS, CF15 9SN, CF4 8ET, CF4 8EU, CF4 8EX, CF4 8EY, CF4 8EZ, CF4 8JP, CF4 8JR, CF4 8JS, CF4 8JT, CF4 8JU, CF4 8JW, CF4 8JX, CF4 8JY, CF4 8JZ, CF4 8SL, CF4 8SN, CF7 8RJ, CF7 8RL",289,212,77
W00006516,CF15,"CF15 7AF, CF15 7JE, CF15 7PZ, CF15 7QE, CF15 7QG, CF15 7QL, CF15 7QN, CF15 7QP, CF15 7SR, CF15 7SS, CF15 7SZ, CF15 7TA, CF15 7TE, CF15 7TJ, CF15 7TN, CF15 7TP, CF15 7TQ, CF15 7TU, CF15 7TX, CF15 7WF, CF4 7PZ, CF4 7QL, CF4 7QQ, CF4 7QW, CF4 7SY, CF4 7SZ, CF4 7TJ, CF4 7TL, CF4 7TN, CF4 7TP, CF4 7TQ, CF4 7TR, CF4 7TS, CF4 7UE, CF4 7UY, CF4 7YQ, CF8 1NH, CF83 1NF, CF83 1NH",371,306,65
W00010646,CF15,"CF15 8EL, CF15 8ER, CF15 8GA, CF15 8GB, CF15 8GW, CF4 8DB, CF4 8DN, CF4 8EH, CF4 8EP, CF4 8EQ, CF4 8ES, CF4 8RP, CF4 8RS, CF4 8RW, CF4 8RZ",359,309,50
W00006518,CF15,"CF15 7JJ, CF15 7PH, CF15 7PJ, CF15 7PL, CF15 7PQ, CF15 7PS, CF15 7RB, CF15 7RD, CF15 7RE, CF15 7RF, CF15 7RL, CF15 7YA, CF15 7YG, CF15 7YQ, CF4 7PG, CF4 7PH, CF4 7PS, CF4 7RA, CF4 7RD, CF4 7RF, CF4 7RG, CF4 7YA, CF4 7YB, CF4 7YG",306,265,41
W00006519,CF15,"CF15 7QT, CF15 7QU, CF15 7QW, CF15 7QX, CF15 7QY, CF15 7QZ, CF15 7ST, CF15 7SU, CF15 7SW, CF15 7SX, CF15 7TR, CF4 7SS, CF4 7ST, CF4 7TE",258,229,29
W00010562,CF15,"CF15 8EA, CF15 8EG, CF15 8EH, CF15 8GH, CF15 8GP, CF15 8GQ, CF15 8GR, CF15 8GS, CF15 8GT, CF15 8GU, CF15 8HD, CF15 8HE, CF15 8HF, CF15 8HG, CF4 8DW, CF4 8EA, CF4 8EF, CF4 8EG",333,278,55
W00006520,CF15,"CF15 7UD, CF15 7UE, CF15 7UF, CF15 7UG, CF15 7UH, CF15 7UJ, CF15 7UN, CF15 7UX, CF15 7UY, CF15 7UZ, CF15 7WA, CF15 7YJ, CF4 7UF, CF4 7UH, CF4 7UJ, CF4 7UL, CF4 7UX, CF4 7YH, CF4 7YJ, CF4 7YN",267,236,31
W00006521,CF15,"CF15 7QH, CF15 7QQ, CF15 7SN, CF15 7SY, CF15 7TB, CF15 7TD, CF15 7TG, CF15 7TH, CF15 7TL, CF15 7TS, CF15 7TW, CF15 7UL, CF4 7TA, CF4 7TB, CF4 7TD, CF4 7TF, CF4 7TG, CF4 7TH, CF4 7UA, CF4 7UD",263,240,23
W00006522,CF15,"CF15 7SL, CF15 7SP, CF15 7SQ, CF4 7PB, CF4 7SL",218,185,33
W00006523,CF15,"CF15 7NA, CF15 7PA, CF15 7PB, CF15 7SJ, CF4 7PD",248,217,31
W00006524,CF15,"CF15 7PF, CF15 7PN, CF15 7PP, CF15 7PR, CF15 7PT, CF15 7PU, CF15 7PW, CF15 7QA, CF15 7QJ, CF15 7QS, CF4 7PE, CF4 7PP, CF4 7PR, CF4 7PT, CF4 7PU, CF4 7PW, CF4 7PX, CF4 7PY, CF4 7QA, CF4 7QB, CF4 7QD, CF4 7QE, CF4 7QF, CF4 7QG, CF4 7QH, CF4 7QJ, CF4 7QP, CF4 7QR, CF4 7QS, CF4 7QT, CF4 7QU, CF4 7QX, CF4 7QY, CF4 7QZ, CF4 7SR",261,210,51
W00006525,CF15,"CF15 7ND, CF15 7PD, CF15 7RP, CF15 7RQ, CF15 7RR, CF15 7SA, CF15 7SG, CF15 7SH, CF15 7TT, CF15 7YE, CF15 7YP, CF4 7PA, CF4 7SA, CF4 7SB, CF4 7SG, CF4 7SQ",232,202,30
W00009516,CF15,"CF15 8FA, CF15 8FB, CF15 8FE, CF15 8FF, CF15 8FG, CF15 8FH, CF15 8FJ",463,381,82
W00006515,CF15,"CF15 7AG, CF15 7AS, CF15 7AT, CF15 7DA, CF15 7GE, CF15 7JD, CF15 7PE, CF15 7PG, CF15 7PX, CF15 7PY, CF15 7QB, CF15 7QD, CF15 7QF, CF15 7QR, CF15 7RA, CF15 7RG, CF15 7RH, CF15 7RJ, CF15 7RN, CF15 7YF, CF4 7RH, CF4 7RN, CF4 7RQ, CF4 7RR, CF4 7SH, CF4 7SJ, CF4 7YF, CF4 7YP",441,337,104
W00009721,CF15,"CF15 7AB, CF15 7AD, CF15 7AE, CF15 7LD, CF15 7LT, CF15 7LU, CF15 7LW, CF15 7LX, CF15 7LY, CF15 7NE, CF4 7LW, CF4 7LX",249,227,22
W00009381,CF15,"CF15 9NQ, CF15 9NS, CF15 9PF, CF15 9PG, CF15 9PH, CF15 9PJ, CF15 9PL, CF15 9QB, CF15 9QY, CF4 8NA, CF4 8NQ, CF4 8NS, CF4 8NT, CF4 8PF, CF4 8PG, CF4 8PH, CF4 8PJ, CF4 8PL, CF4 8QY, CF4 8QZ, CF4 8SQ",294,243,51
W00010185,CF15,"CF15 8FQ, CF15 8GJ, CF15 8GL, CF4 7JB",287,248,39
W00010163,CF15,"CF15 8EX, CF15 8EY, CF15 8FD, CF15 8FL, CF15 8FN, CF15 8FR, CF15 8FZ, CF15 8LN, CF4 8LE, CF4 8LQ",357,300,57
W00010182,CF15,"CF15 8AD, CF15 8DS, CF15 8DT, CF15 8DU, CF15 8EB, CF15 8ED, CF15 8EF, CF15 8EJ, CF4 8AD",329,267,62
W00010152,CF15,"CF15 8ET, CF15 8EU, CF15 8FU, CF15 8FW, CF15 8FX",391,327,64
W00010192,CF15,"CF15 8BF, CF15 8DR, CF15 8DX, CF15 8FY, CF15 8GX, CF15 8HA, CF15 8HB, CF15 8XG, CF4 8DT, CF4 8DU, CF4 8DX, CF4 8XG, CF4 8XH, CF4 8XJ, CF4 8XL, CF4 8XN",484,408,76
W00010603,CF2,"CF2 6AE, CF2 6AP, CF2 6AR, CF2 6AS, CF2 6AX, CF2 6BN, CF2 6BU, CF23 6AD, CF23 6AE, CF23 6AR, CF23 6AT, CF23 6AX, CF23 6AY, CF23 6BN, CF23 6HH",619,524,95
W00009473,CF2,"CF2 3EX, CF2 3JP, CF2 3JQ, CF2 3JZ, CF2 3LA, CF24 3JU, CF24 3JY, CF24 3JZ, CF24 3LA",290,256,34
W00009474,CF2,"CF2 3RX, CF2 3RY, CF2 3SA, CF2 3SD, CF2 3SJ, CF24 3RX, CF24 3RY, CF24 3SA, CF24 3SD, CF24 3SE, CF24 3SJ",332,259,73
W00010205,CF2,"CF2 4LD, CF2 4LQ, CF2 4LS, CF2 4LT, CF2 4LU, CF2 4LZ, CF24 4HF, CF24 4HL, CF24 4LS, CF24 4LT",679,632,47
W00009629,CF2,"CF2 2JS, CF2 2JT, CF2 2JZ, CF2 2LD, CF2 2LH, CF2 2NP, CF2 2YN, CF24 2JR, CF24 2JT, CF24 2JX, CF24 2LB, CF24 2LD, CF24 2NF, CF24 2PB",356,306,50
W00009475,CF2,"CF2 3SB, CF24 3PW, CF24 3PX",263,246,17
W00008924,CF2,"CF2 4NY, CF2 4PD, CF2 4PE, CF2 4QJ, CF2 4QL, CF2 4QR, CF2 4QT, CF2 4QX, CF2 4QZ, CF2 4RA, CF24 4NR, CF24 4NY, CF24 4PA, CF24 4QJ, CF24 4QQ, CF24 4QW",490,444,46
W00008926,CF2,"CF2 4LA, CF2 4LB, CF2 4LF, CF2 4LJ, CF2 4LN, CF2 4LR, CF2 4LW, CF24 4LJ, CF24 4LN, CF24 4LQ, CF24 4LR",354,296,58
W00009476,CF2,"CF2 3LJ, CF2 3RP, CF2 3RQ, CF2 3RR, CF2 3XD, CF2 3XF, CF2 3XH, CF2 3XJ, CF2 3XN, CF2 3XT, CF2 3XW, CF2 3XX, CF2 3YW, CF2 3YY, CF24 3DP, CF24 3FA, CF24 3JD, CF24 3JG, CF24 3JH, CF24 3JJ, CF24 3JL, CF24 3JN, CF24 3JR, CF24 3JX, CF24 3LH, CF24 3RN, CF24 3RP, CF24 3RQ, CF24 3WA, CF24 3YF, CF24 3YG, CF24 3YP, CF24 3YW, CF24 3YY",622,574,48
W00008952,CF2,"CF2 6PS, CF2 6QB, CF2 6SJ, CF2 6SP, CF2 6SQ, CF2 6SR, CF2 7DU, CF23 6RX, CF23 6SE, CF23 6SF, CF23 6SP, CF23 6SQ, CF23 6SR",318,278,40
W00010559,CF2,"CF2 1HW, CF2 1HY, CF2 1TN, CF2 1TW, CF24 0DS, CF24 0DZ, CF24 0EH, CF24 0EJ, CF24 0JT, CF24 0JU, CF24 0NJ, CF24 0UZ, CF24 0XX",513,487,26
W00008927,CF2,"CF2 4JW, CF2 4JX, CF2 4LG, CF2 4LP, CF24 4JX, CF24 4LH, CF24 4LL, CF24 4LP, CF24 4LY",417,362,55
W00008929,CF2,"CF2 4NF, CF2 4NG, CF2 4NH, CF2 4NP, CF2 4NQ, CF2 4NR, CF2 4PA, CF2 4QQ, CF2 4QW, CF2 4XR, CF2 4XW, CF24 4EY, CF24 4FA, CF24 4HB, CF24 4HD, CF24 4NF, CF24 4NG, CF24 4NH, CF24 4NP, CF24 4NQ, CF24 4XR, CF24 4XT, CF24 4XW",378,343,35
W00010568,CF2,"CF2 4DY, CF2 4DZ, CF2 4EE, CF2 4EH, CF2 4ER, CF2 4EW, CF2 4EX, CF2 4EY, CF2 4HA, CF24 4DX, CF24 4EG, CF24 4EJ, CF24 4EP, CF24 4ES",401,353,48
W00008931,CF2,"CF2 4EU, CF2 4EZ, CF2 4HW, CF2 4JA, CF2 4JB, CF2 4JE, CF2 4JY, CF2 4JZ, CF2 4LE, CF2 4LH, CF2 4LL, CF2 4XT, CF2 4XX, CF2 4XY, CF2 4XZ, CF24 4JB, CF24 4JE, CF24 4LE, CF24 4LG, CF24 4LW, CF24 4LZ, CF24 4XX, CF4 3JS",444,392,52
W00008932,CF2,"CF2 4EQ, CF2 4ES, CF2 4ET, CF2 4HB, CF2 4HD, CF24 4EQ, CF24 4ET, CF24 4EU, CF24 4EZ, CF24 4HA, CF24 4HZ",551,490,61
W00009470,CF2,"CF2 3LP, CF2 3QE, CF2 3QF, CF2 3RT, CF2 3RU, CF2 3RW, CF2 3YZ, CF24 3EX, CF24 3GP, CF24 3JP, CF24 3JQ",246,212,34
W00010128,CF2,"CF2 5JG, CF2 5JH, CF2 5JJ, CF2 5JL, CF2 5LH, CF2 6AB, CF2 6AU, CF23 5JG, CF23 5JJ, CF23 5JL, CF23 5JQ, CF23 5LH, CF23 5LZ, CF23 5YB, CF23 6AU",671,626,45
W00010648,CF2,"CF2 4ND, CF2 4NX, CF2 4NZ, CF2 4PB, CF2 4UP, CF2 4UQ, CF2 4UR, CF2 4UZ, CF2 4XB, CF2 4XF, CF2 4XG, CF2 4XH, CF2 4XS, CF2 4XU, CF2 4YP, CF2 4YS, CF24 4DT, CF24 4EN, CF24 4ER, CF24 4EW, CF24 4FE, CF24 4FH, CF24 4HE, CF24 4LX, CF24 4ND, CF24 4NL, CF24 4NN, CF24 4WE, CF24 4WH, CF24 4WT, CF24 4WZ, CF24 4XY, CF24 4YJ, CF24 4YL, CF24 4YN, CF24 4YP, CF24 4YQ, CF24 4YS, CF24 4YW, CF24 4YX",359,323,36
W00009487,CF2,"CF2 7ET, CF23 8AY, CF23 8EP, CF23 8EQ, CF23 8HD, CF23 8XL",271,235,36
W00010569,CF2,"CF2 4DD, CF2 4NB, CF2 4NN, CF2 4NW, CF2 4UT, CF2 4UW, CF2 4UX, CF2 4UY, CF2 4XJ, CF2 4YB, CF2 4YG, CF2 4YH, CF2 4YJ, CF2 4YL, CF2 4YQ, CF2 4YU, CF2 4YW, CF2 4YX, CF2 4YZ, CF24 4DD, CF24 4DE, CF24 4DN, CF24 4DU, CF24 4DY, CF24 4DZ, CF24 4EE, CF24 4FB, CF24 4NB, CF24 4YF",504,451,53
W00010125,CF2,"CF2 4AR, CF2 4BJ, CF2 4BU, CF2 4BY, CF2 4BZ, CF24 4AS, CF24 4AW, CF24 4AX",391,345,46
W00010529,CF2,"CF2 3BW, CF24 3BF, CF24 3GA",138,122,16
W00010123,CF2,"CF2 6BR, CF2 6BS, CF2 6BT, CF2 6XB, CF2 6XD, CF2 6XF, CF23 6BP, CF23 6BQ, CF23 6BR, CF23 6BS, CF23 6BT, CF23 6BU, CF23 6XD, CF3 7LF",360,319,41
W00008947,CF2,"CF2 6SY, CF2 6SZ, CF2 6TF, CF2 7AN, CF2 7DY, CF2 7HF, CF2 7HG, CF2 7HH, CF23 6SY, CF23 6TA, CF23 6TD, CF23 6TE, CF23 6TF, CF23 6TG, CF23 6TH, CF23 6TZ",272,243,29
W00008948,CF2,"CF2 6PR, CF2 6QQ, CF2 6QS, CF2 6RD, CF2 6SE, CF23 6PD, CF23 6QR, CF23 6QS, CF23 6RY, CF23 6SB, CF23 6SH, CF23 6SJ",337,289,48
W00008949,CF2,"CF2 6PD, CF2 6QP, CF2 6QR, CF2 6QU, CF2 6RH, CF2 6SH, CF23 6PA, CF23 6PB, CF23 6PJ, CF23 6PN, CF23 6QP, CF23 6QQ, CF23 6QT, CF23 6RH, CF23 6RZ, CF23 6SA, CF23 6SS, CF23 6XH, CF23 6XQ",318,269,49
W00010638,CF2,"CF2 3XA, CF2 3XB, CF2 4DJ, CF2 4NJ, CF2 4NS, CF24 4DJ",198,173,25
W00008950,CF2,"CF2 6NA, CF2 6PB, CF2 6PW, CF2 6PZ, CF2 6QA, CF2 6QT, CF2 6SB, CF2 6SS, CF23 6NA, CF23 6PW, CF23 6PY, CF23 6PZ, CF23 6QA",363,327,36
W00008933,CF2,"CF2 4HT, CF2 4HU, CF2 4HZ, CF2 4JD, CF2 4JF, CF2 4JG, CF2 4JH, CF2 4XQ, CF24 4HU, CF24 4JD, CF24 4JF, CF24 4JG, CF24 4JH",407,367,40
W00009469,CF2,"CF2 3LL, CF2 3LN, CF2 3US, CF2 3UT, CF2 3YQ, CF2 4TE, CF2 4TF, CF2 4TG, CF2 4TJ, CF2 4TQ, CF2 4TS, CF2 4TT, CF24 3LJ, CF24 3YX, CF24 4SW, CF24 4TA, CF24 4TJ, CF24 4TQ",228,201,27
W00009445,CF2,"CF2 1AG, CF2 1PU, CF2 1UA, CF2 3QN, CF2 3QP, CF2 3QQ, CF2 3QR, CF2 3QW, CF2 3QX, CF2 3RG, CF2 7TA, CF2 7TB, CF2 7TD, CF2 7TE, CF2 7TF, CF2 7TG, CF24 3EQ, CF24 3QL, CF24 3QR, CF24 3QW, CF24 3RG",255,227,28
W00010188,CF2,"CF2 6AG, CF2 6BQ, CF2 6RS, CF23 6AG, CF23 6EQ, CF23 6ET",140,118,22
W00008780,CF2,"CF2 1NL, CF2 1NX, CF2 1NZ, CF2 1PA, CF2 1QF, CF24 1NE, CF24 1NJ, CF24 1NX, CF24 1NY, CF24 1PA, CF24 1PR, CF24 1PS, CF24 1WH, CF24 1XR, CF24 1YB, CF24 1YE, CF24 1YF",409,380,29
W00008781,CF2,"CF2 1LD, CF2 1LE, CF2 1LZ, CF2 1NE, CF2 1NF, CF2 1PW, CF2 1PX, CF2 1PZ, CF24 0DF, CF24 0JJ, CF24 0JX, CF24 0JY, CF24 0LD, CF24 0LF, CF24 0LG, CF24 0LN, CF24 0YG, CF24 1LE, CF24 1LX, CF24 1LY, CF24 1LZ, CF24 1PX",416,388,28
W00009330,CF2,"CF2 7ED, CF2 7EE, CF2 7EL, CF2 7EU, CF2 7EZ, CF2 7GW, CF23 7EU, CF23 7EZ, CF23 7XH, CF23 8HH, CF23 8XA, CF23 9EB, CF23 9EQ, CF23 9LD, CF23 9PD, CF23 9PG, CF23 9PJ, CF23 9PZ, CF23 9XF, CF3 7PH, CF3 7PJ",450,395,55
W00009331,CF2,"CF2 7AY, CF2 7BP, CF2 7BU, CF2 7BW, CF2 7EQ, CF23 7BP, CF23 7BT, CF23 7BU, CF23 7EP, CF23 7XJ",362,344,18
W00009332,CF2,"CF2 7BB, CF2 7BD, CF2 7BE, CF23 7BB, CF23 7BD, CF23 7BE, CF23 7WD, CF23 7XU, CF23 7YF",321,306,15
W00009333,CF2,"CF2 7DD, CF2 7DW, CF2 7HP, CF2 7HQ, CF2 7HR, CF2 7HT, CF2 7HU, CF2 7HW, CF2 7HX, CF23 7DW, CF23 7DX, CF23 7HP, CF23 7HQ, CF23 7HR, CF23 7HT, CF23 7HU",342,309,33
W00008779,CF2,"CF2 1NH, CF2 1NN, CF2 1NS, CF2 1NU, CF2 1NW, CF2 1YS, CF24 1ND, CF24 1NN, CF24 1NS, CF24 1NT, CF24 1PY, CF24 1PZ",361,336,25
W00009334,CF2,"CF2 7ER, CF2 7EW, CF2 7EX, CF23 7ER, CF23 7ES, CF23 7EW, CF23 7HX",278,258,20
W00009336,CF2,"CF2 7DX, CF2 7HJ, CF2 7HL, CF2 7HN, CF2 7HS, CF23 7HF, CF23 7HG, CF23 7HH, CF23 7HJ, CF23 7HL, CF23 7HN, CF23 7HS",282,262,20
W00009337,CF2,"CF2 7BA, CF2 7BL, CF2 7JD, CF2 7JN, CF2 7JP, CF2 7LA, CF2 7LB, CF2 7LD, CF2 7LE, CF2 7LF, CF2 7LG, CF2 7LH, CF2 7LJ, CF2 7LL, CF2 7LN, CF2 7LP, CF2 7LQ, CF2 7LR, CF2 7LS, CF2 7LT, CF2 7LU, CF2 7LW, CF2 7LX, CF2 7LY, CF2 7LZ, CF2 7NA, CF2 7NB, CF2 7ND, CF2 7NE, CF2 7NF, CF2 7NG, CF2 7NH, CF2 7NJ, CF2 7NL, CF2 7NN, CF2 7NP, CF2 7NQ, CF2 7NR, CF2 7NS, CF2 7NT, CF2 7NU, CF2 7NW, CF2 7NX, CF2 7NY, CF2 7NZ, CF2 7PA, CF2 7PB, CF2 7PD, CF2 7PE, CF2 7PF, CF2 7PG, CF2 7PH, CF2 7PJ, CF2 7PL, CF2 7PN, CF2 7PP, CF2 7PQ, CF2 7PR, CF2 7PS, CF2 7PT, CF2 7PU, CF2 7PW, CF2 7PX, CF2 7PY, CF2 7PZ, CF2 7QA, CF2 7QB, CF2 7RA, CF2 7RB, CF2 7RD, CF2 7RU, CF2 7SA, CF2 7SB, CF2 7SD, CF2 7SE, CF2 7SF, CF2 7SG, CF2 7SH, CF2 7SJ, CF2 7SL, CF2 7SN, CF2 7SP, CF2 7XG, CF23 7BA, CF23 7JF, CF23 7JG, CF23 7JN, CF23 7JP, CF23 7SD, CF23 7WA",480,438,42
W00009338,CF2,"CF2 7AS, CF2 7AT, CF23 6SZ, CF23 7AR, CF23 7AT",313,273,40
W00009339,CF2,"CF2 7EB, CF2 7EF, CF2 7JE, CF23 7AH, CF23 7EA, CF23 7EB, CF23 7ED, CF23 7EE, CF23 7EY",368,354,14
W00009340,CF2,"CF2 7EG, CF2 7EJ, CF2 7JF, CF23 7EF, CF23 7EG, CF23 7JE",405,368,37
W00009341,CF2,"CF2 7AQ, CF2 7EA, CF23 7AG, CF23 7AP, CF23 7AQ, CF23 7AS",312,276,36
W00009335,CF2,"CF2 7BH, CF2 7BN, CF2 7JA, CF2 7JB, CF23 7BL, CF23 7BN, CF23 7JA",340,321,19
W00009468,CF2,"CF2 4SF, CF2 4SJ, CF2 4SL, CF24 3XA, CF24 4NA, CF24 4NJ, CF24 4NS, CF24 4PN, CF24 4RJ, CF24 4SF, CF24 4SG, CF24 4SJ",477,422,55
W00008899,CF2,"CF2 4HR, CF2 4HY, CF2 4JP, CF24 4HR, CF24 4JJ, CF24 4JL, CF24 4JN",473,424,49
W00008903,CF2,"CF2 4DE, CF2 4NA, CF2 4NL, CF2 4SG, CF24 4BT, CF24 4BW, CF24 4BX, CF24 4DL",555,495,60
W00009499,CF2,"CF2 7AH, CF2 7AX, CF2 7AZ, CF23 8AL, CF23 8SB, CF23 8SD, CF23 8SQ",257,236,21
W00009466,CF2,"CF2 3LT, CF2 3LW, CF2 3LX, CF2 3NS, CF2 3NT, CF2 3PD, CF2 3RS, CF2 3YX, CF2 4TH, CF24 3LL, CF24 3LN, CF24 3LP, CF24 3PE, CF24 3PJ, CF24 3RR, CF24 3RS, CF24 3US, CF24 3YZ, CF24 4TF, CF24 4TG, CF24 4TH, CF24 4TS",331,289,42
W00009497,CF2,"CF2 7AW, CF2 7BX, CF2 7BY, CF2 7BZ, CF2 7EP, CF23 8AH, CF23 8AS, CF23 8AT, CF23 8AW, CF23 8AX, CF23 8AZ, CF23 8BX, CF23 8BY, CF23 8BZ",401,363,38
W00009465,CF2,"CF2 4RW, CF2 4SA, CF2 4SH, CF2 4SX, CF2 4TB, CF2 4TD, CF24 4RL, CF24 4RQ, CF24 4RR, CF24 4RU, CF24 4SH",429,386,43
W00008923,CF2,"CF2 4PF, CF2 4PG, CF2 4PH, CF2 4PJ, CF2 4SR, CF2 4SS, CF2 4YD, CF24 4NX, CF24 4NZ, CF24 4PB, CF24 4PD, CF24 4PE, CF24 4PP",403,341,62
W00008922,CF2,"CF2 4QS, CF2 4QY, CF24 4QR, CF24 4QT, CF24 4QX, CF24 4QZ, CF24 4RA",537,485,52
W00008901,CF2,"CF2 3BT, CF2 4BL, CF2 4BN, CF2 4BP, CF2 4DG, CF24 4BD, CF24 4BH, CF24 4BL, CF24 4BS, CF24 4DH",532,474,58
W00008920,CF2,"CF2 4QP, CF2 4QU, CF2 4RB, CF24 4QN, CF24 4QS, CF24 4QU, CF24 4QY",474,426,48
W00008916,CF2,"CF2 3AL, CF2 3BY, CF2 4DF, CF24 4AB, CF24 4AE, CF24 4AL, CF24 4DF, CF24 4DG",471,430,41
W00008915,CF2,"CF2 4AB, CF2 4AE, CF2 4AP, CF2 4AQ, CF2 4BG, CF24 4AN, CF24 4AQ, CF24 4BA",435,407,28
W00008911,CF2,"CF2 4DX, CF2 4EB, CF2 4EF, CF2 4EJ, CF2 4EP, CF24 4AH, CF24 4DW, CF24 4EF, CF24 4FD, CF24 4HS, CF24 4HX",319,285,34
W00008910,CF2,"CF2 4BR, CF2 4BT, CF2 4BW, CF2 4BX, CF2 4DH, CF2 4DL, CF24 4BN, CF24 4BP, CF24 4BQ, CF24 4BR, CF24 4BY",622,570,52
W00009651,CF2,"CF2 2PZ, CF2 2QB, CF2 2QL, CF2 2QN, CF2 2QP, CF2 2QQ, CF2 2QR, CF2 2YH, CF24 2PY, CF24 2QB, CF24 2QF, CF24 2QH, CF24 2QN, CF24 2QX",380,344,36
W00008906,CF2,"CF2 4EG, CF2 4EL, CF2 4JN, CF24 4EL, CF24 4HH, CF24 4HT, CF24 4HY, CF24 4JP, CF24 4JU, CF24 4XQ",424,392,32
W00008918,CF2,"CF2 4PX, CF2 4PZ, CF2 4QA, CF2 4QD, CF2 4QE, CF2 4QF, CF2 4QH, CF2 4QN, CF2 4YA, CF24 4PW, CF24 4PX, CF24 4PZ, CF24 4QA, CF24 4QB, CF24 4QD, CF24 4QH, CF24 4QL, CF24 4YA, CF24 4YU",477,415,62
W00009467,CF2,"CF2 3LQ, CF2 3LY, CF2 3NZ, CF2 3PB, CF2 3YN, CF2 3YP, CF2 4TY, CF24 3LT, CF24 3LU, CF24 3LW, CF24 3LY, CF24 4TY",315,277,38
W00010122,CF2,"CF2 1DU, CF2 1YQ, CF24 1DJ, CF24 1DS, CF24 1DU, CF24 1SD",235,224,11
W00009342,CF2,"CF2 7EH, CF2 7EN, CF2 7ES, CF2 7EY, CF23 7EH, CF23 7EJ, CF23 7EL, CF23 7EN",400,378,22
W00009668,CF2,"CF2 2NU, CF2 2NW, CF2 2NZ, CF2 2PE, CF2 2PH, CF2 2PJ, CF2 2PL, CF2 2XS, CF24 2NR, CF24 2NT, CF24 2NU, CF24 2NX, CF24 2PG",265,229,36
W00009667,CF2,"CF2 2LG, CF2 2LN, CF2 2LP, CF2 2LW, CF2 2NS, CF24 2LA, CF24 2LE, CF24 2NS, CF24 2NW",214,187,27
W00009666,CF2,"CF2 2RN, CF24 2TJ, CF24 2TL, CF24 2TQ",143,139,4
W00010166,CF2,"CF2 7HA, CF2 7XA, CF2 7XN, CF2 7XP, CF2 7XT, CF2 7XU, CF2 7XX, CF2 7XY, CF2 7XZ, CF2 7YA, CF2 7YB, CF2 7YG, CF2 7YH, CF2 7YJ, CF2 7YL, CF2 7YN, CF2 7YP, CF2 7ZD, CF23 7FA, CF23 8HA, CF23 8XE, CF23 8XN, CF23 8XP, CF23 8XW, CF23 8YX",292,259,33
W00009665,CF2,"CF2 2YD, CF2 2YE, CF24 2HG, CF24 2HH, CF24 2HJ, CF24 2TR, CF24 2TS, CF24 2YE",302,275,27
W00009664,CF2,"CF2 2NB, CF2 2NG, CF2 2NH, CF2 2NL, CF2 2NQ, CF2 2NR, CF2 2NT, CF2 2NX, CF2 2XP, CF24 2NA, CF24 2NB, CF24 2NG, CF24 2NL, CF24 2NQ, CF24 2PD",286,257,29
W00009663,CF2,"CF2 2SZ, CF2 2TE, CF2 2TG, CF2 2TJ, CF2 2TL, CF24 2SS, CF24 2SZ, CF24 2TB, CF24 2TE",308,285,23
W00009662,CF2,"CF2 2BP, CF2 2BT, CF2 2BU, CF2 2BZ, CF2 2EA, CF2 2JR, CF2 2JW, CF2 2JX, CF2 2NA, CF2 2NF, CF2 2PB, CF2 2XT, CF2 2XU, CF2 2XX, CF24 2BN, CF24 2BU, CF24 2BW, CF24 2BZ, CF24 2DA, CF24 2DF, CF24 2EA, CF24 2JW, CF24 2XU, CF24 2XW, CF24 2XX",300,284,16
W00010523,CF2,"CF2 1EP, CF2 1EQ, CF2 1HX, CF2 1JA, CF24 0EN, CF24 0EP, CF24 0HE, CF24 0HW",180,175,5
W00009661,CF2,"CF2 2LL, CF2 2NE, CF2 2NJ, CF2 2NY, CF2 2PA, CF2 2YL, CF24 2LX, CF24 2ND, CF24 2NE, CF24 2NH, CF24 2NJ, CF24 2NY, CF24 2YL",296,267,29
W00009660,CF2,"CF2 2LF, CF2 2LS, CF24 2LL, CF24 2LN, CF24 2NZ, CF24 2PA, CF24 2PE, CF24 2PH, CF24 2PP",321,288,33
W00010159,CF2,"CF2 5ED, CF23 5AB, CF23 5AP, CF23 5ED, CF23 5SE, CF23 9FB, CF23 9FH, CF23 9FJ, CF23 9XA, CF23 9XN, CF3 7UQ, CF3 7XG, CF3 7XH, CF3 7XJ, CF3 7XN",473,409,64
W00009659,CF2,"CF2 2PN, CF2 2PR, CF2 2PS, CF2 2PT, CF2 2PU, CF2 2PW, CF2 2QY, CF24 2FE, CF24 2LF, CF24 2LS, CF24 2PR, CF24 2PS, CF24 2PT, CF24 2SG",333,294,39
W00009657,CF2,"CF2 2LY, CF2 2QS, CF2 2QW, CF2 2YG, CF24 2LW, CF24 2LY",199,185,14
W00009655,CF2,"CF2 2QE, CF2 2QZ, CF2 2RA, CF2 2RE, CF2 2RF, CF2 2RU, CF2 2RW, CF24 2QA, CF24 2QZ, CF24 2RE, CF24 2RW",289,276,13
W00009654,CF2,"CF2 2PX, CF2 2QA, CF2 2QD, CF24 2PU, CF24 2PW, CF24 2QD",280,249,31
W00009653,CF2,"CF2 2RB, CF2 2RG, CF2 2RL, CF2 2RP, CF24 2RA, CF24 2RB, CF24 2RF, CF24 2RG, CF24 2RH, CF24 2RJ, CF24 2RL, CF24 2TZ",428,390,38
W00009649,CF2,"CF2 2RQ, CF2 2RR, CF2 2RS, CF2 2RT, CF2 2RY, CF2 2RZ, CF2 2XB, CF2 2XL, CF2 2XN, CF2 2XR, CF2 2XW, CF24 2PZ, CF24 2QP, CF24 2QR, CF24 2RQ, CF24 2RR, CF24 2RS, CF24 2RT, CF24 2RZ, CF24 2TY",363,343,20
W00009648,CF2,"CF2 2PY, CF2 2QT, CF2 2QU, CF24 2PX, CF24 2QS, CF24 2QT, CF24 2QU, CF24 2QW, CF24 2SB, CF24 2YG",273,257,16
W00009646,CF2,"CF2 2AA, CF2 2AB, CF2 2AE, CF2 2AF, CF2 2AG, CF2 2AH, CF2 2AJ, CF2 2AL, CF2 2AN, CF2 2AQ, CF24 2BT, CF24 2DZ, CF24 2EB, CF24 2ED, CF24 2FB, CF24 5NW, CF24 5NX, CF24 5NY, CF24 5NZ",312,297,15
W00009644,CF2,"CF2 2AP, CF24 2AA, CF24 2AE, CF24 2AF, CF24 2AG, CF24 2AH, CF24 2AJ, CF24 2AL",215,194,21
W00009643,CF2,"CF2 2AR, CF2 2AS, CF2 2AT, CF2 2AU, CF2 2AW, CF2 2AX, CF2 2DE, CF24 2AB, CF24 2AN, CF24 2AP, CF24 2AQ, CF24 2AR",269,220,49
W00009642,CF2,"CF2 2BX, CF2 2BY, CF2 2DB, CF2 2DD, CF2 2DL, CF2 2EH, CF2 2EN, CF2 2ES, CF2 2EZ, CF2 2FX, CF2 2JY, CF2 2LB, CF2 2XY, CF2 2XZ, CF24 2BG, CF24 2BL, CF24 2DL, CF24 2DW, CF24 2DX, CF24 2DY, CF24 2EG",279,256,23
W00010169,CF2,"CF2 7HB, CF2 7XB, CF2 7XD, CF2 7XE, CF2 7XF, CF2 7XH, CF2 7XJ, CF2 7XL, CF2 7XQ, CF2 7XR, CF2 7XS, CF2 7XW, CF2 7YD, CF2 7YE, CF2 7YF, CF2 7YQ, CF2 7YR, CF2 7YS, CF2 7YT, CF2 7YU, CF2 7YW, CF2 7YX, CF2 7YY, CF23 7BQ, CF23 7HA, CF23 7HB, CF23 7JB, CF23 7JD, CF23 7XB",435,395,40
W00009641,CF2,"CF2 2RD, CF2 2SA, CF2 2SB, CF2 2SD, CF2 2SE, CF2 2SG, CF2 2SH, CF2 2SJ, CF2 2SL, CF2 2SP, CF2 2SQ, CF2 2SR, CF2 2ST, CF2 2TN, CF2 2XF, CF2 2YP, CF2 2YQ, CF24 2LG, CF24 2SH, CF24 2SJ, CF24 2SL, CF24 2SW, CF24 2WA, CF24 2WB, CF24 2XQ, CF24 2YA, CF24 2YD, CF24 2ZN",245,219,26
W00009639,CF2,"CF2 2JN, CF2 2JP, CF2 2JU, CF2 2LR, CF24 2BX, CF24 2BY, CF24 2DD, CF24 2EU, CF24 2JL, CF24 2JN, CF24 2JU, CF24 2XY",414,366,48
W00009638,CF2,"CF2 2SU, CF2 2SW, CF2 2SX, CF2 2SY, CF2 2TF, CF24 2SN, CF24 2ST, CF24 2SU, CF24 2TF, CF24 5PQ, CF24 5TH, CF24 5TJ, CF24 5XB, CF24 5XE, CF24 5XG, CF24 5XP",253,225,28
W00009637,CF2,"CF2 2DN, CF2 2LU, CF24 2DB, CF24 2DN, CF24 2EE, CF24 2EH, CF24 2EN, CF24 2ES",272,242,30
W00009636,CF2,"CF2 2ET, CF2 2EU, CF2 2JQ, CF2 2LJ, CF2 2LQ, CF2 2LT, CF24 2EP, CF24 2ET, CF24 2EX, CF24 2EY, CF24 2JQ, CF24 2LJ, CF24 2LQ, CF24 2LR, CF24 2LU, CF24 2LZ",318,269,49
W00009635,CF2,"CF2 2BN, CF2 2BW, CF2 2DA, CF2 2DJ, CF2 2DW, CF2 2EB, CF24 2BJ, CF24 2DH, CF24 2DJ, CF24 2DP, CF24 2DR, CF24 2DT",299,272,27
W00009632,CF2,"CF2 2LA, CF2 2LE, CF2 2NN, CF2 2PD, CF2 2PF, CF2 2PG, CF24 2JS, CF24 2JY, CF24 2JZ, CF24 2NN, CF24 2PF",301,272,29
W00009640,CF2,"CF2 2BD, CF2 2BH, CF2 2DF, CF2 2DH, CF2 2DP, CF24 2AY, CF24 2AZ, CF24 2BA, CF24 2BD, CF24 2BH, CF24 2DG",319,284,35
W00008953,CF2,"CF2 6NH, CF2 6PG, CF2 6PH, CF2 6PJ, CF2 6PL, CF2 6PN, CF2 6PP, CF23 6NB, CF23 6NG, CF23 6NH, CF23 6NJ, CF23 6PG, CF23 6PH, CF23 6PL, CF23 6PP",333,279,54
W00010172,CF2,"CF2 2YJ, CF24 2HB, CF24 2HD, CF24 2HL, CF24 2HN, CF24 2HP, CF24 2RP, CF24 2SA, CF24 5YJ",339,294,45
W00010146,CF2,"CF2 2YF, CF24 2TH, CF24 2TN, CF24 2TT, CF24 2UA, CF24 5ZF",314,280,34
W00008954,CF2,"CF2 6JN, CF2 6JT, CF2 6JU, CF2 6JW, CF2 6PU, CF23 6JA, CF23 6JT, CF23 6JU, CF23 6JW, CF23 6JY, CF23 6PT, CF23 6PU, CF23 6QE",340,296,44
W00008955,CF2,"CF2 6NE, CF2 6NL, CF2 6NQ, CF2 6PF, CF2 6PQ, CF2 6RY, CF2 6RZ, CF2 6SA, CF2 6XG, CF2 6XH, CF2 6XJ, CF2 6XL, CF2 6XN, CF2 6XP, CF2 6XQ, CF2 6XR, CF2 6XS, CF2 6XU, CF23 6JX, CF23 6ND, CF23 6NL, CF23 6NN, CF23 6NQ, CF23 6PE, CF23 6PF, CF23 6PQ",354,291,63
W00010181,CF2,"CF2 1NJ, CF2 1XJ, CF2 1XT, CF2 1XU, CF2 1XX, CF24 1AD, CF24 1DA, CF24 1DR, CF24 1NH, CF24 1QE, CF24 1XJ, CF24 1XQ, CF24 1XU",224,199,25
W00010116,CF2,"CF2 1AB, CF2 1BA, CF2 1BN, CF2 1BX, CF2 1SP, CF2 1SS, CF2 1UD, CF2 1UN, CF2 1UQ, CF2 1UW, CF2 1XW, CF2 1YP, CF24 0DA, CF24 0DD, CF24 0DE, CF24 0DG, CF24 0DH, CF24 0DP, CF24 0ED, CF24 0SR, CF24 0TD, CF24 0US, CF24 0WB",212,205,7
W00008956,CF2,"CF2 6NF, CF2 6NP, CF2 6NR, CF2 6NX, CF2 6NY, CF2 6NZ, CF2 6PA, CF2 6PE, CF2 6RW, CF2 6RX, CF2 6SF, CF2 6SG, CF2 6SL, CF2 6TH, CF2 6XT, CF2 6YD, CF2 6YG, CF2 6YL, CF2 6YN, CF23 6JB, CF23 6NE, CF23 6NF, CF23 6NP, CF23 6NY, CF23 6NZ, CF23 6RW, CF23 6SG, CF23 6SL, CF23 6SN, CF23 6TB",302,272,30
W00009985,CF2,"CF2 1DG, CF2 1DJ, CF2 1DP, CF2 1DQ, CF2 1DR, CF2 1DS, CF2 1NG, CF2 1QD, CF2 1QE, CF2 1TS, CF2 1YT, CF2 1YU, CF24 1AA, CF24 1DG, CF24 1DH, CF24 1DQ, CF24 1NB, CF24 1NF, CF24 1NG, CF24 1PU, CF24 1PW, CF24 1QD, CF24 1YN, CF24 1YT",353,335,18
W00008958,CF2,"CF2 6JG, CF2 6SN, CF2 6ST, CF2 6SU, CF2 6SW, CF2 6SX, CF2 6TA, CF2 6TB, CF2 6TD, CF2 6TE, CF2 6TJ, CF23 6AL, CF23 6JD, CF23 6JG, CF23 6NX, CF23 6RU, CF23 6ST, CF23 6SU, CF23 6SW, CF23 6SX, CF23 6TJ, CF23 6XF, CF23 6YA, CF23 6YJ",269,236,33
W00008959,CF2,"CF2 6EE, CF2 6HT, CF2 6JA, CF2 6PT, CF2 6XE, CF23 5QF, CF23 5QN, CF23 6EE, CF23 6EG, CF23 6HT",332,282,50
W00008960,CF2,"CF2 6JF, CF2 6JJ, CF2 6JL, CF2 6JP, CF2 6JQ, CF2 6JR, CF2 6JS, CF2 6NB, CF2 6ND, CF2 6NG, CF2 6NJ, CF2 6NN, CF23 6JF, CF23 6JJ, CF23 6JL, CF23 6JN, CF23 6JP, CF23 6JQ, CF23 6JR, CF23 6JS",361,320,41
W00008961,CF2,"CF2 6JH, CF2 6JX, CF2 6LF, CF2 6LJ, CF23 6ER, CF23 6JE, CF23 6JH, CF23 6LE, CF23 6LF, CF23 6LG, CF23 6LJ",337,307,30
W00008962,CF2,"CF2 6JB, CF2 6JD, CF2 6JE, CF2 6LU, CF2 6YA, CF2 6YB, CF2 6YE, CF2 6YF, CF2 6YH, CF2 6YJ, CF2 6YP, CF2 6YQ, CF2 6YR, CF2 6YS, CF2 6YT, CF2 6YU, CF2 6YW, CF2 6YX, CF2 6YY, CF23 6LL, CF23 6LN, CF23 6LP, CF23 6LQ, CF23 6LU",256,225,31
W00008963,CF2,"CF2 6AH, CF2 6AJ, CF2 6AL, CF2 6EL, CF2 6ES, CF2 6LQ, CF2 6LR, CF2 6RQ, CF2 6RR, CF2 6RT, CF2 6RU, CF2 6SD, CF2 6UH, CF2 6UN, CF2 6UQ, CF23 6AH, CF23 6AJ, CF23 6EL, CF23 6ES, CF23 6LH, CF23 6LR, CF23 6RQ, CF23 6RR, CF23 6RS, CF23 6RT, CF23 6SD",294,263,31
W00008964,CF2,"CF2 6EB, CF2 6ED, CF2 6EJ, CF2 6LG, CF2 6LL, CF2 6LN, CF2 6LP, CF2 6LS, CF23 6DH, CF23 6DL, CF23 6EJ, CF23 6EP, CF23 6LS, CF23 6LT",326,304,22
W00010626,CF2,"CF2 3AS, CF2 3AZ, CF2 3BJ, CF2 3BL, CF2 3DD, CF2 3DN, CF2 3DS, CF2 3TL, CF2 3TY, CF24 3AZ, CF24 3BA, CF24 3BB, CF24 3BJ, CF24 3DE, CF24 3DH, CF24 3EW",286,269,17
W00008965,CF2,"CF2 6DD, CF2 6DF, CF2 6DH, CF2 6DN, CF2 6EA, CF2 6EF, CF2 6EG, CF2 6EN, CF2 6EP, CF2 6ER, CF2 6LE, CF2 6LT, CF23 5NR, CF23 6DD, CF23 6DF, CF23 6DN, CF23 6EA, CF23 6EF, CF23 6EH, CF23 6EN, CF23 6WG",376,342,34
W00008966,CF2,"CF2 5QN, CF2 5QP, CF2 5QQ, CF2 5QU, CF2 5QY, CF23 5PN, CF23 5QP, CF23 5QQ, CF23 5QS, CF23 5QU, CF23 5QW, CF23 5QX, CF23 5QY",307,254,53
W00008967,CF2,"CF2 6DJ, CF2 6DL, CF2 6EH, CF2 6LH, CF23 6DJ, CF23 6EB, CF23 6ED, CF23 6FH",139,126,13
W00010510,CF2,"CF2 6HG, CF2 6HH, CF2 6HL, CF23 6AP, CF23 6AS, CF23 6HE, CF23 6HS",118,105,13
W00010136,CF2,"CF2 7HD, CF23 8ET, CF23 8HB, CF23 8HW, CF23 8JZ, CF23 8QD, CF23 8QE",275,240,35
W00010500,CF2,"CF2 4NE, CF24 4EH, CF24 4EX, CF24 4NE",249,222,27
W00010132,CF2,"CF2 4AD, CF24 4AA, CF24 4AD, CF24 4AP",207,196,11
W00008980,CF2,"CF2 6QN, CF2 6QX, CF2 6QY, CF2 6QZ, CF2 6RA, CF2 6RF, CF23 6PR, CF23 6QU, CF23 6QW, CF23 6QX, CF23 6QY, CF23 6QZ",304,268,36
W00008979,CF2,"CF2 6QD, CF2 6RB, CF2 6RE, CF2 6RG, CF23 6PS, CF23 6QB, CF23 6RA, CF23 6RD, CF23 6RE, CF23 6RF",282,251,31
W00009446,CF2,"CF2 3AQ, CF2 3AT, CF2 3BD, CF2 3BZ, CF2 3DA, CF2 3DF, CF2 3UN, CF2 3UW, CF24 3AJ, CF24 3AQ, CF24 3AS, CF24 3UN, CF24 3UW",379,346,33
W00008977,CF2,"CF2 5JY, CF2 5NF, CF2 5NG, CF2 5NN, CF2 5NP, CF2 5NQ, CF2 5NR, CF2 5NS, CF2 5PA, CF2 5PB, CF2 5PG, CF2 5PH, CF2 5PR, CF2 5PW, CF2 6AN, CF23 5PG, CF23 5PH, CF23 5PQ, CF23 5PT, CF23 5PU, CF23 5PW, CF23 5PX",332,283,49
W00008975,CF2,"CF2 5PJ, CF2 5PL, CF2 5PP, CF2 5PS, CF23 5PJ, CF23 5PL, CF23 5PP, CF23 5PR, CF23 5PS",262,214,48
W00008974,CF2,"CF2 6HF, CF2 6HN, CF23 6DP, CF23 6DQ, CF23 6DS, CF23 6DT, CF23 6HL, CF23 6HN, CF23 6HP",273,239,34
W00008972,CF2,"CF2 6AF, CF2 6BP, CF2 6ET, CF2 6EW, CF2 6EY, CF2 6EZ, CF2 6HA, CF2 6HB, CF2 6HD, CF2 6HJ, CF23 6AF, CF23 6EU, CF23 6EZ, CF23 6HB, CF23 6HF, CF23 6HG, CF23 6HJ",332,307,25
W00008971,CF2,"CF2 5PN, CF2 5QE, CF2 5QR, CF2 5QS, CF2 5QT, CF2 5QW, CF2 5QX, CF23 5QE, CF23 5QG, CF23 5QH, CF23 5QR, CF23 5QT",326,284,42
W00008970,CF2,"CF2 6DE, CF2 6DG, CF2 6DP, CF2 6DR, CF2 6EU, CF23 5NQ, CF23 5PB, CF23 6DE, CF23 6DG, CF23 6DR",295,259,36
W00008969,CF2,"CF2 6EQ, CF2 6EX, CF23 6EW, CF23 6EX, CF23 6EY, CF23 6HA, CF23 6HD",274,243,31
W00008976,CF2,"CF2 6AQ, CF2 6DQ, CF2 6DS, CF2 6DT, CF2 6DU, CF2 6DW, CF2 6DX, CF2 6HE, CF2 6HP, CF2 6HQ, CF2 6HR, CF2 6HS, CF23 5NP, CF23 6AN, CF23 6AQ, CF23 6DU, CF23 6DW, CF23 6DX, CF23 6HQ, CF23 6HR",329,299,30
W00009343,CF2,"CF2 7AF, CF2 7AG, CF2 7AP, CF2 7AR, CF2 7AU, CF23 7AF, CF23 7AN, CF23 7AU, CF23 7DY",273,252,21
W00008909,CF2,"CF2 4DA, CF2 4DN, CF24 4BU, CF24 4DA, CF24 4DB, CF24 4DP, CF24 4DR, CF24 4ED, CF24 4FF",513,459,54
W00009652,CF2,"CF2 2QF, CF2 2QG, CF2 2QH, CF2 2QJ, CF2 2RH, CF2 2RJ, CF24 2QE, CF24 2QG, CF24 2QJ, CF24 2QL, CF24 2QQ, CF24 2RU",349,319,30
W00009429,CF2,"CF2 3PW, CF2 3PX, CF2 3PY, CF2 3QD, CF24 3QA, CF24 3QB",272,252,20
W00009390,CF2,"CF2 5RA, CF2 5RE, CF23 5RD, CF23 5RE, CF23 9BJ, CF23 9BL, CF23 9BN, CF23 9BP, CF23 9BQ, CF23 9BT, CF23 9FL, CF3 7BH, CF3 7BJ, CF3 7BL, CF3 7BQ, CF3 7DB, CF3 7UU",347,296,51
W00009431,CF2,"CF2 3HA, CF2 3HB, CF2 3HT, CF2 3JT, CF2 3TA, CF2 3TB, CF2 3TD, CF2 3TE, CF2 3TF, CF2 3TG, CF2 3TX, CF2 3UL, CF2 3UQ, CF2 3UY, CF2 3WD, CF2 3XE, CF2 3XG, CF2 3YA, CF2 3YB, CF2 3YF, CF2 3YH, CF2 3YL, CF2 3YT, CF2 3YU, CF24 3HD, CF24 3HL, CF24 3HT",241,210,31
W00009432,CF2,"CF2 3PS, CF2 3PU, CF2 3SL, CF2 3SN, CF24 3PR, CF24 3PS, CF24 3PT",262,231,31
W00009389,CF2,"CF2 5LX, CF2 5LY, CF2 5PD, CF23 5HB, CF23 5HD, CF23 5HG, CF23 5HJ, CF23 5HS",364,309,55
W00009433,CF2,"CF2 1AH, CF2 1DH, CF2 1DL, CF2 1SN, CF2 1UP, CF2 1UR, CF2 1YN, CF2 3SF, CF24 1AG, CF24 1AH, CF24 1AJ, CF24 1AL, CF24 3QJ, CF24 3QN, CF24 3QP, CF24 3RD, CF24 3SN",438,392,46
W00009434,CF2,"CF2 3BH, CF2 3HJ, CF2 3HN, CF2 3HR, CF2 3HS, CF2 3HW, CF2 3JA, CF2 3JB, CF2 3JE, CF2 3JF, CF2 3JG, CF2 3JH, CF2 3JL, CF2 3JN, CF2 3JS, CF2 3JX, CF2 3LB, CF2 3XR, CF2 3XS, CF2 3XU, CF24 3BH, CF24 3BP, CF24 3BQ, CF24 3BW, CF24 3EG, CF24 3FE, CF24 3GL, CF24 3JB, CF24 3JE, CF24 3JF, CF24 3WD",400,373,27
W00009435,CF2,"CF2 3SE, CF24 3PU, CF24 3PZ",188,168,20
W00009436,CF2,"CF2 3EZ, CF2 3HQ, CF2 3HU, CF2 3JU, CF2 3QB, CF24 3EZ, CF24 3HP, CF24 3HQ, CF24 3HU, CF24 3SS, CF24 3UP, CF24 3WB, CF24 3WL, CF24 3XB, CF24 3XG, CF24 3XJ, CF24 3XQ, CF24 3XS, CF24 3YH, CF24 3YJ, CF24 3YQ, CF24 3YS",314,274,40
W00008782,CF2,"CF2 1FA, CF2 1FB, CF2 1FD, CF2 1FE, CF2 1FF, CF2 1FG, CF2 1FH, CF2 1FJ, CF2 1FN, CF2 1FQ, CF2 1FS, CF2 1PY, CF2 1SF, CF2 1SJ, CF2 1SL, CF2 1SR, CF2 1UL, CF2 1UU, CF2 1UX, CF2 1XA, CF2 1YD, CF2 1YE, CF2 1YF, CF2 1YH, CF2 1YJ, CF2 1YL, CF2 1YR, CF2 1YW, CF2 1YX, CF24 1LN, CF24 1LP, CF24 1LQ, CF24 1LR, CF24 1PG, CF24 1QA, CF24 1QB",366,351,15
W00009391,CF2,"CF2 5EA, CF23 5AG, CF23 5EA, CF23 5WS, CF23 9AL, CF23 9AU, CF23 9AW, CF23 9DF, CF23 9FG, CF23 9HJ, CF23 9NY, CF3 7AG, CF3 7AW, CF3 7AY, CF3 7RR",415,377,38
W00009455,CF2,"CF2 4RL, CF2 4RN, CF2 4RP, CF2 4RR, CF2 4RS, CF24 4SL, CF24 4SQ, CF24 4ST",182,166,16
W00009457,CF2,"CF2 5EH, CF2 5EJ, CF2 5EW, CF23 5EJ, CF23 5EU, CF23 5EW, CF24 4BB, CF24 4GD, CF24 4GE, CF24 4SZ, CF24 4WX",325,277,48
W00008784,CF2,"CF2 1HA, CF2 1NP, CF2 1NR, CF2 1NT, CF2 1PF, CF2 1PJ, CF2 1PP, CF24 1HA, CF24 1NQ, CF24 1NR, CF24 1PF, CF24 1PH, CF24 1PP, CF24 1XG",408,382,26
W00009458,CF2,"CF2 5EU, CF24 4GB, CF24 4SY, CF24 4TN, CF24 4TP, CF24 4TX",300,247,53
W00008785,CF2,"CF2 1DY, CF2 1HF, CF2 1LB, CF2 1LF, CF2 1LH, CF2 1LJ, CF2 1LN, CF2 1LP, CF2 1LQ, CF2 1LR, CF2 1LS, CF2 1LU, CF2 1LW, CF2 1LX, CF2 1LY, CF2 1NQ, CF2 1PG, CF2 1PH, CF2 1PQ, CF2 1QA, CF2 1QB, CF2 1XG, CF24 0AJ, CF24 0JS, CF24 0JZ, CF24 0LA, CF24 0LB, CF24 0LH, CF24 0LJ, CF24 0LL, CF24 1LS, CF24 1LU, CF24 1LW",378,354,24
W00009459,CF2,"CF2 3LZ, CF2 5EG, CF2 5HA, CF2 5HB, CF2 5HF, CF2 5HG, CF2 5HJ, CF2 5HS, CF2 5HZ, CF23 5EE, CF23 5EG, CF23 5EH, CF24 3LE, CF24 3LZ",244,216,28
W00008786,CF2,"CF2 1HB, CF2 1HD, CF2 1HE, CF2 1LT, CF24 0HF, CF24 0HG, CF24 0HH, CF24 1HB, CF24 1HD, CF24 1HE, CF24 1LT",322,294,28
W00009460,CF2,"CF2 3NA, CF2 3NB, CF2 4UA, CF24 4GA, CF24 4TU, CF24 4TZ, CF24 4UA, CF24 4UB, CF24 4UR, CF24 4UZ",374,329,45
W00008788,CF2,"CF2 1AX, CF2 1AY, CF2 1DF, CF2 1HZ, CF2 1JB, CF2 1JF, CF2 1JH, CF2 1JJ, CF2 1JL, CF2 1JN, CF2 1JR, CF2 1JU, CF2 1JW, CF2 1JX, CF2 1JY, CF2 1JZ, CF2 1LA, CF2 1LG, CF2 1LL, CF2 1ND, CF2 1SW, CF2 1SZ, CF2 1UH, CF2 1XF, CF2 1YG, CF24 0FN, CF24 0HY, CF24 0HZ, CF24 0JA, CF24 0JB, CF24 0JF, CF24 0JH, CF24 0JW, CF24 0LZ, CF24 0SS, CF24 0SZ, CF24 0WF, CF24 0WN, CF24 0WR, CF24 0XJ, CF24 0XY, CF24 0YT",398,364,34
W00009461,CF2,"CF2 3LD, CF2 3LS, CF2 3LU, CF2 4UB, CF2 4UD, CF2 4UE, CF2 4UF, CF2 4UN, CF2 4US, CF2 4UU, CF2 4WA, CF2 4WB, CF2 4WD, CF2 4WE, CF2 4WF, CF2 4WG, CF2 4WH, CF2 4WZ, CF2 5EF, CF23 5EF, CF24 3LD, CF24 3LS, CF24 3LX, CF24 4UE, CF24 4WF, CF24 4WG",281,240,41
W00009416,CF2,"CF2 5JS, CF2 5LL, CF2 5LN, CF2 5LP, CF2 5LQ, CF2 5LR, CF2 5NU, CF2 5NW, CF2 5NX, CF2 5NY, CF23 5LN, CF23 5LP, CF23 5LQ, CF23 5LR, CF23 5NW, CF23 5NX, CF23 5NY",343,295,48
W00009456,CF2,"CF2 3ND, CF2 3NE, CF2 4TP, CF24 4GF, CF24 4RS, CF24 4RT, CF24 4RY, CF24 4SB",367,336,31
W00009463,CF2,"CF2 3YJ, CF2 4TU, CF2 4TW, CF2 4TZ, CF24 4SP, CF24 4TL, CF24 4TR, CF24 4TT, CF24 4TW",337,294,43
W00009392,CF2,"CF2 5HE, CF2 5HR, CF2 5JA, CF2 5JB, CF2 5JD, CF2 5JE, CF2 5RB, CF23 5HA, CF23 5HE, CF23 5HF, CF23 5HR, CF23 5HT, CF23 5HZ, CF23 5JA, CF3 7AR, CF3 7BA",310,255,55
W00009393,CF2,"CF2 5JP, CF2 5RD, CF2 5RF, CF2 5YA, CF23 5AY, CF23 5AZ, CF23 5DA, CF23 5RB, CF23 5RF, CF23 9AR, CF23 9BG, CF3 7BB, CF3 7BT, CF3 7DD",244,213,31
W00009344,CF2,"CF2 6TG, CF2 7AB, CF2 7AD, CF23 7AA, CF23 7AB, CF23 7AD, CF23 7AE, CF23 9ND, CF3 7ND, CF3 7NF",376,360,16
W00009421,CF2,"CF2 5JN, CF2 5JQ, CF2 5JR, CF2 5JW, CF2 5QZ, CF2 5YF, CF2 5YG, CF2 5YQ, CF2 5YS, CF2 5YW, CF2 5YX, CF2 5YY, CF2 5YZ, CF23 5FA, CF23 5JB, CF23 5JD, CF23 5JE, CF23 5JN, CF23 5JP, CF23 5JR, CF23 5JU, CF23 5JW, CF23 5QD, CF23 5RA, CF23 5UJ, CF23 5YA, CF23 5YD, CF23 5YF, CF23 5YG, CF23 5YJ, CF23 5YN, CF23 5YQ",281,250,31
W00009413,CF2,"CF2 5LD, CF2 5LE, CF2 5LF, CF2 5LG, CF2 5NT, CF23 5LD, CF23 5LE, CF23 5LF, CF23 5LG, CF23 5LS, CF23 5NS, CF23 5NT",283,239,44
W00009411,CF2,"CF2 6AA, CF2 6AW, CF2 6BG, CF2 6BH, CF23 5QZ, CF23 5SA, CF23 5SB, CF23 5SG, CF23 5SH, CF23 5SL, CF23 6AW, CF23 9DT, CF23 9HU, CF3 7DX, CF3 7EU, CF3 7HU, CF3 7HX, CF3 7HY",394,317,77
W00009410,CF2,"CF2 5YB, CF2 6AD, CF2 6AT, CF2 6BJ, CF2 6BL, CF2 6BW, CF2 6XA, CF23 5BF, CF23 5JH, CF23 5LJ, CF23 5NB, CF23 5ND, CF23 5NE, CF23 5NF, CF23 5NG, CF23 5SD, CF23 5SJ, CF3 7JH",350,328,22
W00009423,CF2,"CF2 3NU, CF2 3NW, CF2 3PE, CF2 3PF, CF2 3PG, CF2 3PH, CF2 5BY, CF24 3NT, CF24 3PY, CF24 3QF, CF24 3RU, CF24 3RW, CF24 3SB, CF24 3SR, CF24 3UU",369,330,39
W00009454,CF2,"CF2 3NF, CF2 3NG, CF2 3NH, CF2 4RT, CF2 4RY, CF2 4SB, CF2 4ST, CF2 5HL, CF24 4DQ, CF24 4RN, CF24 4RP, CF24 4SR, CF24 4SS",413,390,23
W00009407,CF2,"CF2 5AP, CF2 5AQ, CF2 5AR, CF2 5AS, CF23 5AQ, CF23 5AR, CF23 5AS, CF23 5AT",315,231,84
W00009405,CF2,"CF2 5BB, CF2 5BD, CF2 5BR, CF2 5BT, CF2 5BU, CF2 5BX, CF23 5BR, CF24 3NU, CF24 3PF, CF24 3PH",250,229,21
W00009404,CF2,"CF2 5AB, CF2 5AJ, CF2 5AL, CF2 5AN, CF2 5AT, CF2 5AU, CF2 5AW, CF2 5AX, CF2 5AY, CF2 5AZ, CF23 5AD, CF23 5AU, CF23 5AW, CF23 5AX, CF23 5BW, CF23 5BZ, CF24 1RJ, CF24 3NY",263,232,31
W00009428,CF2,"CF2 3JW, CF2 3JY, CF24 3HW, CF24 3HX, CF24 3JS, CF24 3JW, CF24 3LB",388,351,37
W00009403,CF2,"CF2 5BN, CF2 5BP, CF2 5BQ, CF2 5BW, CF2 5BZ, CF23 5BQ, CF23 5BU, CF23 5BY, CF24 3NW, CF24 3NX",326,282,44
W00009424,CF2,"CF2 3BE, CF2 3BG, CF2 3BP, CF2 3BQ, CF2 3DR, CF2 3HE, CF2 3UU, CF24 3AT, CF24 3BD, CF24 3BE, CF24 3BG, CF24 3BN, CF24 3DA, CF24 3DB, CF24 3DG, CF24 3ET, CF24 3UR",370,347,23
W00009425,CF2,"CF2 1AE, CF2 1AF, CF2 1AN, CF2 1AP, CF2 1AQ, CF2 1AR, CF2 1AT, CF2 1TY, CF2 1UE, CF2 1UF, CF2 1XN, CF2 3DX, CF2 3DY, CF2 3EE, CF2 3EF, CF2 3RH, CF2 3RJ, CF2 3RL, CF24 0AF, CF24 0AG, CF24 0AQ, CF24 0TY, CF24 3DT, CF24 3DU, CF24 3DX, CF24 3EF, CF24 3FD, CF24 3FF, CF24 3FL, CF24 3FN, CF24 3FP, CF24 3FQ, CF24 3FR, CF24 3FT",334,296,38
W00009401,CF2,"CF2 5AA, CF2 5AE, CF2 5AG, CF2 5AH, CF2 5BH, CF2 5BJ, CF2 5BL, CF2 5BS, CF2 5DE, CF2 5DF, CF2 5DG, CF2 5DH, CF2 5DJ, CF2 5DL, CF2 5DN, CF2 5DP, CF2 5DQ, CF2 5DR, CF23 5AE, CF23 5BH, CF23 5BJ, CF23 5BL, CF23 5BN, CF23 5BP, CF23 5BS, CF23 5DE, CF23 5DL",312,267,45
W00009400,CF2,"CF2 5BG, CF2 5DA, CF2 5DD, CF2 5HX, CF23 5BB, CF23 5BD, CF23 5BE, CF23 5BG, CF23 5DD, CF23 5EZ, CF23 5HW, CF23 5HX, CF23 5SY, CF23 5WA, CF23 5WR",356,299,57
W00009399,CF2,"CF2 5AF, CF2 5DU, CF2 5DW, CF2 5DX, CF2 5DY, CF2 5DZ, CF23 5DF, CF23 5DN, CF23 5DP, CF23 5DR, CF23 5DW",301,244,57
W00009398,CF2,"CF2 5BE, CF23 5BA, CF23 5BT, CF23 5BX, CF23 5FB",265,241,24
W00009397,CF2,"CF2 5DS, CF23 5AF, CF23 5DS, CF23 5DX, CF23 5DY, CF23 5DZ, CF23 9AS, CF23 9AT, CF3 7AS, CF3 7AT, CF3 7AU",339,281,58
W00009396,CF2,"CF2 5DT, CF2 5HY, CF2 5RL, CF2 5SD, CF2 5XA, CF2 5XB, CF2 5XD, CF2 5XE, CF2 5XW, CF2 5XX, CF2 5XZ, CF23 5DB, CF23 5DG, CF23 5DH, CF23 5DJ, CF23 5EX, CF23 5GA, CF23 5HU, CF23 5HY, CF23 5RH, CF23 5RL, CF23 9BA, CF3 7AX, CF3 7BD, CF3 7BE, CF3 7BG, CF3 7BN, CF3 7BP",313,260,53
W00009426,CF2,"CF2 4RX, CF2 4SD, CF2 4SE, CF2 4SN, CF2 4SP, CF2 4SY, CF2 4SZ, CF2 4TX, CF24 4RW, CF24 4RX, CF24 4SA, CF24 4SD",286,252,34
W00009427,CF2,"CF2 1RG, CF2 1RH, CF2 1RQ, CF2 1XP, CF2 3NX, CF2 3NY, CF2 3RZ, CF2 3SG, CF2 3SH, CF2 5AD, CF24 1RG, CF24 1RH, CF24 1XP, CF24 3RZ, CF24 3SF, CF24 3SG, CF24 3SH, CF24 3SL",293,269,24
W00009402,CF2,"CF2 5EB, CF23 5AA, CF23 5AH, CF23 5AJ, CF23 5AL, CF23 5AN",296,244,52
W00008789,CF2,"CF2 1JD, CF2 1JE, CF2 1JG, CF24 0HJ, CF24 0HL, CF24 0HX, CF24 0JD, CF24 0JE, CF24 0JG, CF24 0JQ",280,257,23
W00009462,CF2,"CF2 3LR, CF2 3PA, CF2 3YR, CF2 3YS, CF2 5BA, CF2 5EE, CF2 5HW, CF24 3LQ, CF24 3LR, CF24 3NA, CF24 3NS, CF24 3NZ, CF24 3PA, CF24 3PB, CF24 3PD, CF24 3PG, CF24 3RT, CF24 3YN, CF24 3YR, CF24 3YT",351,311,40
W00009464,CF2,"CF2 4RQ, CF2 4RZ, CF2 4SW, CF2 4TA, CF2 4TL, CF2 4TN, CF2 4TR, CF24 4RZ, CF24 4SE, CF24 4SX, CF24 4TB, CF24 4TD, CF24 4TE",273,239,34
W00009450,CF2,"CF2 1AD, CF2 1AL, CF2 1AS, CF2 1AU, CF2 1AW, CF2 1TJ, CF2 1TR, CF2 1TU, CF2 1TX, CF2 1TZ, CF2 1YY, CF2 1YZ, CF2 1ZA, CF2 1ZD, CF2 1ZS, CF2 1ZZ, CF2 3DJ, CF2 3DL, CF2 3DT, CF2 3DU, CF2 3TN, CF2 3TQ, CF2 3TU, CF2 3TW, CF2 7TH, CF2 7TJ, CF2 7TL, CF2 7UA, CF2 7WA, CF2 7WH, CF24 0AB, CF24 0AD, CF24 0AE, CF24 0AU, CF24 0AW, CF24 0SB, CF24 0SG, CF24 0TW, CF24 0WH, CF24 0WL, CF24 0YP, CF24 0YZ, CF24 3DJ, CF24 3DS, CF24 3FS, CF24 3FX, CF24 3TQ, CF24 3WY, CF24 3WZ",386,368,18
W00010225,CF2,"CF2 7HE, CF23 8AN, CF23 8FE, CF23 8FF, CF23 8FJ, CF23 8FP, CF23 8FX, CF23 8HE, CF23 8HF, CF23 8HG, CF23 8LU, CF23 8LW",247,218,29
W00008790,CF2,"CF2 1HL, CF2 1HN, CF2 1JQ, CF24 0EQ, CF24 0ER, CF24 0ES, CF24 0ET, CF24 0EY, CF24 0HS, CF24 0JL",274,253,21
W00009447,CF2,"CF2 3QL, CF2 3QS, CF2 3QT, CF2 3QU, CF2 3QZ, CF24 3QH, CF24 3QS, CF24 3QT, CF24 3QU, CF24 3RH, CF24 3RJ, CF24 3RL, CF24 3SP",239,220,19
W00010536,CF2,"CF2 1AA, CF2 1DA, CF2 1TA, CF2 1TB, CF2 1TH, CF2 1TL, CF2 1TP, CF2 1TQ, CF2 1YA, CF2 1YB, CF2 3AB, CF2 3AD, CF2 3AE, CF2 3AN, CF2 3AX, CF2 3TH, CF2 3TR, CF2 3TS, CF2 3TZ, CF2 3UA, CF2 3UB, CF2 3UE, CF2 3UF, CF2 3UG, CF2 3UH, CF2 3UJ, CF2 3UP, CF24 0AA, CF24 0TA, CF24 0TB, CF24 0TH, CF24 0TP, CF24 0TQ, CF24 3AA, CF24 3AB, CF24 3AD, CF24 3AE, CF24 3AN, CF24 3AX, CF24 3DL, CF24 3EP, CF24 3FB, CF24 3GH, CF24 3TR, CF24 3TW",356,322,34
W00010219,CF2,"CF2 4BH, CF2 4BQ, CF2 4BS, CF24 4AR, CF24 4BG",323,286,37
W00010615,CF2,"CF2 4NT, CF2 4NU, CF2 4SQ, CF24 4NT, CF24 4NU, CF24 4NW",287,257,30
W00009631,CF2,"CF2 2SS, CF2 2TA, CF2 2TB, CF2 2TD, CF2 2TQ, CF24 2SR, CF24 2SX, CF24 2SY, CF24 2TA, CF24 2TD",303,276,27
W00010206,CF2,"CF2 1ES, CF2 1ET, CF2 1EX, CF2 1HS, CF24 0EU, CF24 0EW, CF24 0EX",240,229,11
W00010229,CF2,"CF2 5JF, CF2 5LJ, CF2 5LT, CF2 5LU, CF2 5LW, CF2 5NA, CF2 5NB, CF2 5ND, CF2 5NE, CF2 5XY, CF2 5YD, CF2 5YE, CF2 5YH, CF2 5YJ, CF2 5YL, CF2 5YN, CF2 5YP, CF2 5YR, CF2 5YT, CF2 5YU, CF23 5JF, CF23 5JS, CF23 5JT, CF23 5LL, CF23 5LT, CF23 5LU, CF23 5LW, CF23 5LX, CF23 5LY, CF23 5NA, CF23 5NJ",189,158,31
W00009356,CF2,"CF2 6UA, CF2 6UB, CF2 6UE, CF2 6UF, CF2 6UG, CF23 6UE, CF23 6UF, CF23 6UG, CF23 6UH",381,332,49
W00009440,CF2,"CF2 3HG, CF2 3HH, CF2 3QY, CF2 3RA, CF2 3RB, CF24 3DY, CF24 3DZ, CF24 3EA, CF24 3QQ, CF24 3QY, CF24 3QZ, CF24 3RB",297,261,36
W00009441,CF2,"CF2 3BN, CF2 3DQ, CF2 3DW, CF2 3ED, CF2 3EH, CF2 3EJ, CF2 3EL, CF2 3ER, CF2 3ES, CF24 3BL, CF24 3BZ, CF24 3DD, CF24 3DF, CF24 3DN, CF24 3DQ, CF24 3DW, CF24 3ED, CF24 3EH, CF24 3ER, CF24 3ES",416,387,29
W00009442,CF2,"CF2 1AJ, CF2 3PR, CF2 3PT, CF2 3RD, CF2 3RE, CF24 3QX, CF24 3RE",203,171,32
W00009443,CF2,"CF2 3HD, CF24 3DR, CF24 3HJ, CF24 3HN, CF24 3HR, CF24 3HS",312,289,23
W00009350,CF2,"CF2 6UL, CF2 6UP, CF23 6UN, CF23 6UP, CF23 6UQ",229,205,24
W00009349,CF2,"CF2 7AA, CF23 6UT, CF23 6UU, CF23 6UW, CF23 9PX, CF3 7PW",273,255,18
W00009348,CF2,"CF2 6UR, CF2 6US, CF2 6UT, CF2 6UU, CF2 6UW, CF23 6UJ, CF23 6UL, CF23 6UR, CF23 6US",302,274,28
W00009444,CF2,"CF2 3DZ, CF2 3EA, CF2 3EB, CF2 3EN, CF2 3EP, CF24 3EB, CF24 3EE, CF24 3EJ, CF24 3EL, CF24 3EN, CF24 3GN",298,272,26
W00009346,CF2,"CF2 7AE, CF23 9PS, CF23 9PT, CF23 9PU, CF23 9PY, CF3 7NE",336,315,21
W00009355,CF2,"CF2 6UD, CF2 6UJ, CF2 6UX, CF23 6UA, CF23 6UB, CF23 6UD, CF3 7LN, CF3 7LS",254,233,21
W00009451,CF2,"CF2 5EQ, CF2 5ER, CF2 5PX, CF23 5EQ, CF23 5ER, CF23 5HH, CF23 5HL, CF23 5HN",374,325,49
W00009448,CF2,"CF2 3AA, CF2 3AG, CF2 3AU, CF2 3BA, CF2 3BB, CF2 3DE, CF2 3TT, CF2 3UD, CF24 3AF, CF24 3AG, CF24 3AH, CF24 3AP, CF24 3AU, CF24 3AW, CF24 3TJ, CF24 3UD, CF24 3XL",305,287,18
W00009438,CF2,"CF2 3EY, CF2 3PZ, CF2 3QA, CF2 3RF, CF24 3EY, CF24 3HH, CF24 3RA, CF24 3RF",232,202,30
W00008791,CF2,"CF2 1HG, CF2 1HH, CF2 1JP, CF24 0EG, CF24 0HP, CF24 0HR, CF24 0JP",215,210,5
W00009437,CF2,"CF2 3AR, CF2 3BR, CF2 3BS, CF2 3BU, CF2 3DB, CF2 3UR, CF2 3XQ, CF24 3AL, CF24 3AR, CF24 3AY, CF24 3BR, CF24 3BU, CF24 3BY, CF24 3WJ",343,314,29
W00008792,CF2,"CF2 1HJ, CF2 1HP, CF2 1HQ, CF2 1HR, CF2 1HT, CF2 1HU, CF24 0EZ, CF24 0HB, CF24 0HN, CF24 0HQ, CF24 0HT, CF24 0HU",263,247,16
W00008794,CF2,"CF2 1DN, CF2 1DT, CF2 1DW, CF2 1RJ, CF24 1DL, CF24 1DN, CF24 1DP, CF24 1DT, CF24 1DW, CF24 1DX, CF24 1DY, CF24 1DZ, CF24 1YQ",439,406,33
W00009374,CF2,"CF2 7BG, CF2 7DA, CF2 7DB, CF2 7DG, CF23 7BG, CF23 7DA, CF23 7DB",306,287,19
W00009373,CF2,"CF2 7BJ, CF2 7DF, CF2 7DL, CF23 7BJ, CF23 7DF, CF23 7DG",307,282,25
W00008795,CF2,"CF2 1DX, CF2 1QG, CF2 1QH, CF2 1QL, CF2 1QN, CF2 1QP, CF2 1QQ, CF2 1RL, CF2 1RR, CF2 1RU, CF2 1RW, CF2 1RX, CF24 1JJ, CF24 1QF, CF24 1QL, CF24 1QP, CF24 1QQ, CF24 1RU, CF24 1RW, CF24 1RX, CF5 4YF, CF5 4YG, CF5 4YP, CF5 4YY",376,340,36
W00009372,CF2,"CF2 7BQ, CF2 7BR, CF2 7BS, CF2 7BT, CF23 7BH, CF23 7BR, CF23 7BS",342,317,25
W00009371,CF2,"CF2 7AL, CF2 7DE, CF2 7DJ, CF23 7BW, CF23 7DD, CF23 7DE, CF23 7DJ, CF23 7DL",333,306,27
W00009369,CF2,"CF2 7AJ, CF2 7DH, CF2 7DQ, CF23 7DH, CF23 7DN, CF23 7DP, CF23 7DQ",399,382,17
W00009439,CF2,"CF2 3EG, CF2 3HF, CF2 3HL, CF2 3HP, CF24 3HE, CF24 3HF, CF24 3HG",285,253,32
W00008797,CF2,"CF2 1QU, CF24 1PQ, CF24 1QU, CF24 1QW, CF24 1QX, CF24 1QY, CF24 1QZ, CF24 1RS",336,300,36
W00008798,CF2,"CF2 1QS, CF2 1QT, CF2 1QW, CF2 1QX, CF2 1QY, CF2 1QZ, CF2 1RA, CF24 1QR, CF24 1QS, CF24 1QT, CF24 1RA, CF24 1RD",418,358,60
W00009368,CF2,"CF2 7DN, CF2 7DP, CF2 7DR, CF2 7DS, CF2 7DT, CF23 7DR, CF23 7DS, CF23 7DT, CF23 7DU",302,282,20
W00009418,CF2,"CF2 5JT, CF2 5JU, CF2 5JX, CF2 5JZ, CF2 5LA, CF2 5LB, CF2 5LS, CF2 5NZ, CF23 5JX, CF23 5JY, CF23 5JZ, CF23 5LA, CF23 5LB, CF23 5NN, CF23 5NU, CF23 5NZ, CF23 5PA, CF23 5PD",266,230,36
W00008799,CF2,"CF2 1PE, CF2 1QJ, CF2 1QR, CF2 1RN, CF2 1RS, CF2 1XB, CF2 1XD, CF2 1XE, CF2 1XH, CF2 1XL, CF2 1XQ, CF2 1XR, CF2 1XS, CF2 1XY, CF2 1XZ, CF24 1JN, CF24 1NL, CF24 1NP, CF24 1PE, CF24 1QG, CF24 1QH, CF24 1QJ, CF24 1QN, CF24 1RR",387,337,50
W00009452,CF2,"CF2 5EP, CF2 5HP, CF2 5HQ, CF23 5EP, CF23 5HP, CF23 5HQ, CF24 4GG, CF24 4GH",338,292,46
W00009453,CF2,"CF2 5EL, CF2 5EN, CF2 5ES, CF2 5ET, CF2 5HD, CF23 5EL, CF23 5EN, CF23 5ES, CF23 5ET",344,277,67
W00008800,CF2,"CF2 1NY, CF2 1PL, CF2 1PN, CF2 2ND, CF24 1LL, CF24 1NA, CF24 1NU, CF24 1NW, CF24 1PJ, CF24 1PL",375,341,34
W00008801,CF2,"CF2 1PB, CF2 1PD, CF2 1RB, CF2 1RD, CF24 1NZ, CF24 1PB, CF24 1PD, CF24 1PN, CF24 1RB",331,298,33
W00009419,CF23,"CF23 9BW, CF23 9DX, CF23 9ES, CF23 9ET, CF23 9EU, CF23 9EW, CF23 9EX, CF3 7DY, CF3 7ED, CF3 7ES, CF3 7ET, CF3 7EW, CF3 7EX, CF3 7HJ, CF3 7UX",280,229,51
W00009420,CF23,"CF23 9DH, CF23 9FQ, CF23 9HA, CF23 9HL, CF23 9NB, CF3 7DL, CF3 7DN, CF3 7EY, CF3 7HA",334,288,46
W00008978,CF23,"CF23 6QD, CF23 6QN, CF23 6RB, CF23 6RG",213,196,17
W00009422,CF23,"CF23 9BF, CF23 9BR, CF23 9BS, CF23 9BU, CF23 9DA, CF23 9DB, CF23 9DJ, CF23 9DL, CF3 7BR, CF3 7BS, CF3 7BU, CF3 7BW, CF3 7BX, CF3 7BY, CF3 7BZ",318,260,58
W00010217,CF23,"CF23 7FB, CF23 7FE, CF23 7XG",247,219,28
W00010157,CF23,"CF23 8HJ, CF23 8NP, CF23 8NZ, CF23 8XJ, CF23 8XQ, CF23 8XR",311,262,49
W00010174,CF23,"CF23 8NQ, CF23 8NW, CF23 8NX, CF23 8NY, CF23 8PE, CF23 8PF, CF23 8PP",247,215,32
W00010156,CF23,"CF23 8AJ, CF23 8FD, CF23 8FG, CF23 8FR",183,168,15
W00010142,CF23,"CF23 5EB, CF23 9AG, CF23 9AJ, CF23 9AP, CF23 9FA, CF23 9FD, CF23 9HP, CF23 9XB, CF23 9XG, CF23 9XH, CF3 7AP, CF3 7UH, CF3 7UJ, CF3 7UZ, CF3 7WA, CF3 7WB, CF3 7WD, CF3 7WE, CF3 7WF, CF3 7XA, CF3 7XB, CF3 7XD, CF3 7XE, CF3 7XR",313,274,39
W00010175,CF23,"CF23 7EX, CF23 7FD",196,170,26
W00010595,CF23,"CF23 8FT, CF3 6AG, CF3 6YF",288,254,34
W00009676,CF23,"CF23 0AA, CF23 0AB, CF23 0AD, CF23 0AE, CF23 0AF, CF23 0AH, CF23 0AJ, CF23 0AL, CF23 0AN, CF23 0AP, CF23 0AQ, CF23 0AR, CF23 0AS, CF23 0AT, CF23 0AU, CF23 0AW, CF23 0AX, CF23 0AY, CF23 0AZ, CF23 0BA, CF23 0BB, CF23 0BD, CF23 0BE, CF23 0BF, CF23 0BG, CF23 0BH, CF23 0BL, CF23 0BN, CF23 0BP, CF23 0BQ, CF23 0BR, CF23 0BS, CF23 0BT, CF23 0BU, CF23 0BW, CF23 0BX, CF23 0BY, CF23 0BZ, CF23 0DA, CF23 0DB, CF23 0DD, CF23 0DE, CF23 0DF, CF23 0DG, CF23 0DH, CF23 0DJ, CF23 0DL, CF23 0DN, CF23 0DP, CF23 0DQ, CF23 0DR, CF23 0DS, CF23 0DT, CF23 0DU, CF23 0DW, CF23 0DX, CF23 0DY, CF23 0DZ, CF23 0EA, CF23 0EB, CF23 0ED, CF23 0EE, CF23 0EF, CF23 0EG, CF23 0EH, CF23 0EJ, CF23 0EL, CF23 0EN, CF23 0EP, CF23 0EQ, CF23 0ER, CF23 0ES, CF23 0ET, CF23 0EU, CF23 0EW, CF23 0EX, CF23 0EY, CF23 0EZ, CF23 0FA, CF23 0FB, CF23 0FD, CF23 0FE, CF23 0FF, CF23 0FG, CF23 0FH, CF23 0FJ, CF23 0FL, CF23 0FN, CF23 0FP, CF23 0FQ, CF23 0FR, CF23 0FS, CF23 0FT, CF23 0FU, CF23 0FW, CF23 0FX, CF23 0FY, CF23 0FZ, CF23 0GA, CF23 0GB, CF23 0GD, CF23 0GE, CF23 0GF, CF23 0GG, CF23 0GH, CF23 0GJ, CF23 0GL, CF23 0GN, CF23 0GP, CF23 0GQ, CF23 0GR, CF23 0GS, CF23 0GT, CF23 0GU, CF23 0GW, CF23 0GX, CF23 0GY, CF23 0GZ, CF23 0HA, CF23 0HB, CF23 0HD, CF23 0HE, CF23 0HF, CF23 0HG, CF23 0HH, CF23 0HJ, CF23 0HL, CF23 0HN, CF23 0HP, CF23 0HQ, CF23 0HR, CF23 0HU, CF23 0HW, CF23 0HX, CF23 0HY, CF23 0HZ, CF23 0JA, CF23 0JB, CF23 0JD, CF23 0JE, CF23 0JF, CF23 0JG, CF23 0JH, CF23 0JJ, CF23 0JL, CF23 0JN, CF23 0JP, CF23 0JQ, CF23 0JR, CF23 0JS, CF23 0JT, CF23 5RZ, CF23 5WB, CF23 5WF, CF23 5WJ, CF23 5WP, CF23 5WW, CF23 5WZ, CF23 5XA, CF23 5XF, CF23 5XJ, CF23 5XT, CF23 5YH, CF23 5YU, CF23 5YW, CF23 5ZE, CF23 6WP, CF23 6WQ, CF23 6WR, CF23 6WW, CF23 6XN, CF23 6XP, CF23 6XR, CF23 6XS, CF23 6XU, CF23 6YB, CF23 6YD, CF23 6YG, CF23 6YH, CF23 6YR, CF23 6YY, CF23 6ZD, CF23 6ZY, CF23 7WB, CF23 7WH, CF23 7XY, CF23 7XZ, CF23 7YA, CF23 7YE, CF23 7YG, CF23 7YQ, CF23 7YW, CF23 7ZW, CF23 8WA, CF23 8WB, CF23 8WJ, CF23 8WN, CF23 8WR, CF23 8WS, CF23 8WT, CF23 8WW, CF23 8WX, CF23 8WY, CF23 8XB, CF23 8XT, CF23 8YA, CF23 8YB, CF23 8YL, CF23 8YS, CF23 8YY, CF23 8YZ, CF23 8ZH, CF23 8ZQ, CF23 9WH, CF23 9WQ, CF23 9XQ, CF23 9YD, CF23 9YE, CF23 9YH, CF23 9YJ, CF23 9YQ, CF23 9YU, CF23 9ZP, CF23 9ZQ, CF23 9ZT, CF3 1EL, CF3 1EY, CF3 1TH, CF3 1XH, CF3 1YA, CF3 1YD, CF3 2AG, CF3 2EE, CF3 2EF, CF3 2EJ, CF3 2EN, CF3 2ER, CF3 2ES, CF3 2EU, CF3 2EW, CF3 2GA, CF3 2GB, CF3 2GH, CF3 2GJ, CF3 2PU, CF3 2PW, CF3 2PX, CF3 2PY, CF3 2PZ, CF3 2XH, CF3 2YA, CF3 2ZZ, CF3 3EE, CF3 3EF, CF3 3EG, CF3 3EP, CF3 8ED, CF3 8EE, CF3 8EH, CF3 8EJ, CF3 8EL, CF3 8EN, CF3 8EW, CF3 8HJ, CF3 8TG, CF3 8XH, CF3 8XL, CF3 8YD",364,356,8
W00009345,CF23,"CF23 9NF, CF23 9NH, CF23 9NJ, CF23 9NN, CF23 9NX, CF23 9UL, CF23 9UP, CF3 7NG, CF3 7NH, CF3 7NQ",382,354,28
W00009415,CF23,"CF23 9DU, CF23 9DY, CF23 9ED, CF23 9HS, CF23 9HT, CF23 9JF, CF3 7DP, CF3 7DR, CF3 7DS, CF3 7DT, CF3 7DU, CF3 7HS, CF3 7HT, CF3 7HW, CF3 7JD, CF3 7JF",341,301,40
W00009354,CF23,"CF23 9NL, CF23 9NU, CF23 9NW, CF23 9PF, CF3 7NL, CF3 7NN, CF3 7NP, CF3 7NU, CF3 7NW, CF3 7PD, CF3 7PF, CF3 7PG, CF3 7US",379,353,26
W00009714,CF23,"CF23 9XT, CF3 1QH, CF3 1SD, CF3 1SG, CF3 1SX, CF3 1SY, CF3 1TB, CF3 1XZ, CF3 8RP, CF3 8SD, CF3 8SX, CF3 8SY, CF3 8TB",310,275,35
W00009502,CF23,"CF23 8PB, CF23 8PG, CF23 8PJ, CF23 8PL, CF23 8PU, CF23 8XF",360,313,47
W00009500,CF23,"CF23 8SF, CF23 8SG, CF23 8SH, CF23 8SJ, CF23 8SP",286,263,23
W00009496,CF23,"CF23 8LN, CF23 8NG, CF23 8NH, CF23 8NN",303,270,33
W00009495,CF23,"CF23 8LB, CF23 8LP, CF23 8LQ, CF23 8LR, CF23 8PZ",291,258,33
W00009357,CF23,"CF23 9NS, CF23 9PA, CF23 9PB, CF23 9PH, CF3 7EB, CF3 7NS, CF3 7NT, CF3 7NZ, CF3 7PB",302,281,21
W00009365,CF23,"CF23 9EE, CF23 9EH, CF23 9JN, CF23 9JS, CF3 7EE, CF3 7EG, CF3 7EH, CF3 7EJ, CF3 7EN, CF3 7JS, CF3 7XF",250,230,20
W00009358,CF23,"CF23 9FN, CF23 9LR, CF23 9LY, CF23 9LZ, CF23 9PE, CF23 9PL, CF23 9PN, CF23 9US, CF3 7LQ, CF3 7LR, CF3 7LZ, CF3 7PQ",432,400,32
W00009360,CF23,"CF23 9LN, CF23 9LP, CF23 9LQ, CF3 7LP",312,295,17
W00009361,CF23,"CF23 9EJ, CF23 9EL, CF23 9EN, CF23 9EP, CF3 7EL, CF3 7EQ",409,375,34
W00009362,CF23,"CF23 9EF, CF23 9EG, CF23 9LL, CF3 7EP, CF3 7PE, CF3 7PL, CF3 7PN, CF3 7UP",296,268,28
W00009363,CF23,"CF23 9JW, CF23 9JX, CF23 9JY, CF23 9JZ",191,183,8
W00009364,CF23,"CF23 9JT, CF23 9LG, CF23 9LH, CF23 9LJ, CF3 7JU, CF3 7LH, CF3 7LJ",313,289,24
W00009367,CF23,"CF23 9LF, CF23 9QA, CF23 9QB, CF3 7JQ, CF3 7JT, CF3 7LG, CF3 7QA, CF3 7QB",293,274,19
W00009417,CF23,"CF23 9DZ, CF23 9EY, CF23 9EZ, CF23 9HB, CF23 9HD, CF23 9HE, CF3 7DW, CF3 7DZ, CF3 7HB, CF3 7HD, CF3 7HE",276,246,30
W00009359,CF23,"CF23 9LX, CF23 9NA, CF23 9PQ, CF3 7LW, CF3 7LY",255,229,26
W00009352,CF23,"CF23 9NE, CF23 9PP, CF23 9PR, CF3 7NJ, CF3 7NX, CF3 7PP, CF3 7PR, CF3 7PS, CF3 7PT",331,302,29
W00009353,CF23,"CF23 9LS, CF23 9LT, CF23 9LU, CF23 9LW, CF23 9PW, CF3 7LT, CF3 7LU, CF3 7LX, CF3 7NA, CF3 7PU, CF3 7PX, CF3 7PY, CF3 7PZ",332,309,23
W00008599,CF23,"CF23 5XB, CF23 5XD, CF23 5XE, CF23 5XG, CF23 5XH, CF23 5XL, CF23 5XN, CF23 5XP, CF23 5XQ, CF23 5XR, CF23 5XS, CF23 5XU, CF23 5XX, CF23 5YE, CF23 5YL, CF23 5YP, CF23 5YR, CF23 5YS, CF23 5YT, CF23 5YX, CF23 5YY, CF23 5YZ, CF23 5ZA, CF23 5ZY, CF23 6XB, CF23 6XJ, CF23 6YE, CF23 6YF, CF23 6YQ, CF23 6YS, CF23 6YT, CF23 6YU, CF23 7YB, CF23 7YD, CF23 7YH, CF23 7YS, CF23 7YU, CF23 7ZG, CF23 7ZH, CF23 8WZ, CF23 8XD, CF23 8XX, CF23 8XZ, CF23 8YD, CF23 8YE, CF23 8YF, CF23 8YG, CF23 8YH, CF23 8YQ, CF23 8YR, CF23 8YT, CF23 8YU, CF23 8YW, CF23 8ZJ, CF23 8ZL, CF23 8ZR, CF23 9XD, CF23 9XJ, CF23 9XS, CF23 9YL, CF23 9YT, CF23 9YW, CF23 9YX, CF23 9YY, CF23 9YZ, CF23 9ZX, CF3 2AY, CF3 2NA, CF3 2NN, CF3 2PS, CF3 8AY, CF3 8PS, CF3 8UL",348,320,28
W00010189,CF23,"CF23 8QF, CF23 8QG",259,227,32
W00009414,CF23,"CF23 9DW, CF23 9EA, CF23 9HF, CF23 9HG, CF23 9HH, CF3 7EA, CF3 7EZ, CF3 7HF, CF3 7HG, CF3 7HH, CF3 7HL",266,240,26
W00009412,CF23,"CF23 9HW, CF23 9JA, CF23 9JD, CF23 9JE, CF23 9JG, CF23 9JJ, CF23 9LE, CF3 7ER, CF3 7JA, CF3 7JB, CF3 7JE, CF3 7JG, CF3 7JJ, CF3 7JP, CF3 7LE",312,261,51
W00009409,CF23,"CF23 6BL, CF23 9HX, CF23 9HY, CF23 9HZ, CF23 9JB, CF23 9JH, CF3 7HZ",301,256,45
W00009489,CF23,"CF23 8LA, CF23 8PY, CF23 8RG, CF23 8RJ",269,243,26
W00009488,CF23,"CF23 8GW, CF23 8LD, CF23 8LE, CF23 8LG, CF23 8LJ, CF23 8LS, CF23 8YJ, CF23 8YN, CF23 8YP",325,298,27
W00009387,CF23,"CF23 9BB, CF23 9BD, CF23 9BE, CF23 9BZ, CF23 9DN, CF23 9ER, CF3 7UW",292,258,34
W00009486,CF23,"CF23 8SA, CF23 8SE, CF23 8SN",348,305,43
W00009366,CF23,"CF23 9JP, CF23 9JQ, CF23 9JR, CF23 9JU, CF23 9UN, CF23 9WA, CF23 9WD, CF23 9WE, CF23 9WF, CF23 9XY, CF23 9YR, CF23 9YS, CF3 7EF, CF3 7JR, CF3 7JW, CF3 7JX, CF3 7JY, CF3 7JZ, CF3 7LL, CF3 7XQ, CF3 7XS, CF3 7YE, CF3 7YH, CF3 7YL, CF3 7YQ, CF3 7YR, CF3 7YS, CF3 7YT, CF3 7YU, CF3 7YW, CF3 7YX",358,318,40
W00009395,CF23,"CF23 5DQ, CF23 5DT, CF23 5DU",280,215,65
W00009394,CF23,"CF23 9AX, CF23 9AZ, CF23 9BH, CF23 9DD, CF23 9DE, CF23 9DG, CF3 7AZ, CF3 7DA, CF3 7DE, CF3 7DF, CF3 7DG, CF3 7DH, CF3 7DJ, CF3 7DQ",330,268,62
W00009491,CF23,"CF23 8LF, CF23 8LH, CF23 8LL, CF23 8PQ, CF23 8PR, CF23 8QA, CF23 8RN",465,417,48
W00009492,CF23,"CF23 8LT, CF23 8LX, CF23 8LY, CF23 8PT",200,179,21
W00009351,CF23,"CF23 9NP, CF23 9NT, CF23 9NZ, CF23 9UT, CF23 9UU, CF23 9UW, CF3 7NR, CF3 7PA",339,321,18
W00009493,CF23,"CF23 8NJ, CF23 8NR, CF23 8NS, CF23 8NT, CF23 8NU, CF23 8PD, CF23 8PH",302,267,35
W00009494,CF23,"CF23 8NE, CF23 8NF, CF23 8QB, CF23 8RE, CF23 8RF, CF23 8SL, CF3 9YE, CF3 9YF",444,398,46
W00009347,CF23,"CF23 9NG, CF23 9NQ, CF23 9NR",253,220,33
W00010601,CF24,CF24 4BZ,146,136,10
W00009658,CF24,"CF24 2QY, CF24 2RD, CF24 2SP, CF24 2SQ, CF24 2TG",278,246,32
W00009650,CF24,"CF24 2PJ, CF24 2PL, CF24 2PN, CF24 2RN, CF24 2SD, CF24 2SE, CF24 2UD",229,210,19
W00009634,CF24,"CF24 2JP, CF24 2LH, CF24 2LP, CF24 2LT, CF24 2NP",289,249,40
W00010581,CF24,CF24 2EF,160,146,14
W00010180,CF24,"CF24 2TP, CF24 2TU, CF24 2TW",345,296,49
W00010643,CF24,"CF24 2HA, CF24 2HE, CF24 2HF",321,291,30
W00009430,CF24,"CF24 3HA, CF24 3HB, CF24 3JT",238,204,34
W00008921,CF24,"CF24 4FG, CF24 4PF, CF24 4PG, CF24 4PH, CF24 4PJ, CF24 4YD",298,263,35
W00009472,CF24,"CF24 3QD, CF24 3QE",238,209,29
W00010134,CF24,"CF24 2RY, CF24 2SF, CF24 2TX",271,239,32
W00008913,CF24,"CF24 4AT, CF24 4AU, CF24 4BE",432,385,47
W00009602,CF3,"CF3 3DJ, CF3 3DL, CF3 3DN, CF3 3DP, CF3 3DQ, CF3 3LP, CF3 4FG, CF3 8DH, CF3 8DL, CF3 8DQ, CF3 8ER, CF3 8ES, CF3 8ET, CF3 8EU, CF3 8EX, CF3 8EY, CF3 8EZ, CF3 8GA, CF3 8GB, CF3 8JJ, CF3 8JN, CF3 8LN, CF3 8LP",301,269,32
W00009697,CF3,"CF3 0EP, CF3 0ET, CF3 0EU, CF3 0EX, CF3 0HR, CF3 0NT, CF3 0XE, CF3 0XF, CF3 0XJ, CF3 0XY, CF3 0YD, CF3 0YW, CF3 0ZA",290,263,27
W00009696,CF3,"CF3 0JB, CF3 0JE, CF3 0PA, CF3 0PE, CF3 0SB, CF3 0SD, CF3 0SE, CF3 0SF",288,267,21
W00009695,CF3,"CF3 0GB, CF3 0HQ, CF3 0JA, CF3 0JD, CF3 0JF, CF3 0JG, CF3 0LP",334,311,23
W00009687,CF3,"CF3 0AY, CF3 0DA, CF3 0DB, CF3 0DD, CF3 0DE, CF3 0DG, CF3 0EF, CF3 0EH, CF3 0FD, CF3 0GA",338,312,26
W00009708,CF3,"CF3 0HX, CF3 0HZ, CF3 0JX, CF3 0JZ, CF3 0NP, CF3 0NQ, CF3 0NR",318,296,22
W00009694,CF3,"CF3 0AA, CF3 0AE, CF3 0AQ",230,211,19
W00008607,CF3,"CF3 2TN, CF3 2TP, CF3 2TQ, CF3 2TR, CF3 2TS, CF3 8TH, CF3 8TL, CF3 8TN, CF3 8TP, CF3 8TQ, CF3 8TR, CF3 8TS, NP1 9SA, NP1 9SB, NP1 9SD, NP1 9SE, NP1 9SF, NP1 9SG, NP1 9SN, NP1 9SP, NP1 9SR, NP1 9SS, NP1 9SW, NP10 8SE, NP10 8SJ, NP10 8SN, NP10 8SP, NP10 8SQ, NP10 8SR, NP10 8SS",427,409,18
W00009686,CF3,"CF3 0AT, CF3 0BS, CF3 0BT, CF3 0BU, CF3 0BW, CF3 0BX, CF3 5AA, CF3 5UA, CF3 5YN, CF3 9TX, CF3 9YN, CF3 9YP",305,283,22
W00008604,CF3,"CF3 2AZ, CF3 2EZ, CF3 2TH, CF3 2TX, CF3 2TZ, CF3 2UA, CF3 2WF, CF3 8AZ, CF3 8TU, CF3 8TX, CF3 8TZ, CF3 8UH",343,315,28
W00009698,CF3,"CF3 0AZ, CF3 0PB, CF3 0PD, CF3 0PF, CF3 0PG, CF3 0ST, CF3 0WB, CF3 0WJ, CF3 0XZ",257,235,22
W00009684,CF3,"CF3 0DP, CF3 0DQ, CF3 0DR, CF3 0LL, CF3 0LU",281,256,25
W00009683,CF3,"CF3 0DS, CF3 0DT, CF3 0DU",302,274,28
W00009682,CF3,"CF3 0AB, CF3 0AD, CF3 0BA, CF3 0BB, CF3 0BD, CF3 0BE",350,335,15
W00009681,CF3,"CF3 0AF, CF3 0AH, CF3 0AJ, CF3 0AL, CF3 0BH",298,292,6
W00008603,CF3,"CF3 2DY, CF3 2NJ, CF3 2SB, CF3 2SD, CF3 2SE, CF3 2UN, CF3 2UP, CF3 2UQ, CF3 2UR, CF3 2UT, CF3 2WH, CF3 2XR, CF3 2XS, CF3 8DY, CF3 8NL, CF3 8NN, CF3 8PR, CF3 8SB, CF3 8UN, CF3 8UP, CF3 8UQ, CF3 8UT, CF3 8UU, CF3 8UW, CF3 8UX, CF3 8XR, CF3 8XU, CF3 9XH, NP1 9TZ, NP10 8TZ, NP10 8UF",432,403,29
W00009680,CF3,"CF3 0HB, CF3 0HD, CF3 0HE, CF3 9UH",370,340,30
W00008602,CF3,"CF3 2LF, CF3 2LG, CF3 2SA, CF3 2UU, CF3 2UW, CF3 2UX, CF3 2UY, CF3 2WA, CF3 2WD, CF3 2WE, CF3 8LF, CF3 8LG, CF3 8SA, CF3 8UR, CF3 8UY",381,351,30
W00008601,CF3,"CF3 2SF, CF3 2TG, CF3 2TJ, CF3 2TW, CF3 2TY, CF3 2UB, CF3 2UD, CF3 2UE, CF3 2UG, CF3 8TJ, CF3 8TT, CF3 8TW, CF3 8TY, CF3 8UA, CF3 8UB, CF3 8UD, CF3 8UF, CF3 8UJ",503,467,36
W00008600,CF3,"CF3 2AW, CF3 2AX, CF3 2NL, CF3 2PR, CF3 2XY, CF3 8AW, CF3 8AX",334,301,33
W00008605,CF3,"CF3 6US, CF3 6WQ, CF3 6WZ, CF3 6XE, CF3 6XF, CF3 6XG, CF3 6XL, CF3 6XS, CF3 6XT, CF3 6XU, CF3 6XW, CF3 6YU, CF3 6YZ, CF3 8US, CF3 9WB, CF3 9WQ, CF3 9WR, CF3 9WS, CF3 9WT, CF3 9WU, CF3 9WW, CF3 9WX, CF3 9WY, CF3 9WZ, CF3 9XE, CF3 9XF, CF3 9XG, CF3 9XS, CF3 9XU, CF3 9YZ, CF3 9ZA, CF3 9ZB, NP1 9RU, NP1 9UE, NP1 9UF, NP1 9UG, NP1 9UH, NP1 9UJ, NP1 9UL, NP1 9UN, NP1 9UP, NP1 9UQ, NP1 9UR, NP1 9UW, NP1 9UX, NP1 9UY, NP1 9UZ, NP10 8RU, NP10 8UE, NP10 8UR",298,266,32
W00009699,CF3,"CF3 0AG, CF3 0AN, CF3 0AP, CF3 5UD, CF3 9ST",235,217,18
W00009701,CF3,"CF3 1NT, CF3 1QS, CF3 1QT, CF3 1QZ, CF3 1RF, CF3 1UE, CF3 8QT, CF3 9UE",208,197,11
W00009601,CF3,"CF3 3HA, CF3 3JQ, CF3 3JS, CF3 3JT, CF3 3LA, CF3 3LB, CF3 3YQ, CF3 8JP, CF3 8JQ, CF3 8JR, CF3 8JS, CF3 8JT, CF3 8LA",312,286,26
W00009600,CF3,"CF3 1NP, CF3 1QQ, CF3 1UF, CF3 1UG, CF3 1UJ, CF3 1UL, CF3 1XQ, CF3 5TW, CF3 5UF, CF3 8QQ, CF3 8QS, CF3 8RL, CF3 9TW, CF3 9UF, CF3 9UG, CF3 9UL",309,287,22
W00009603,CF3,"CF3 3HR, CF3 3HS, CF3 3HU, CF3 3HW, CF3 3JW, CF3 3LD, CF3 3LG, CF3 8EP, CF3 8HT, CF3 8HU, CF3 8HW, CF3 8HX, CF3 8JW, CF3 8LD",314,282,32
W00009710,CF3,"CF3 1AB, CF3 1BX, CF3 1QU, CF3 1QX, CF3 1RL, CF3 1RN, CF3 1RS, CF3 1RT, CF3 1YL, CF3 8QU, CF3 8RA, CF3 8RB, CF3 8RD, CF3 8RS, CF3 8RT, CF3 8SJ, CF3 8SL, CF3 8SN, CF3 8YH, CF3 8YJ, CF3 8YP, CF3 8YR, CF3 8YS, CF3 8YU, CF3 8YW, CF3 8YX, CF3 8YY",375,338,37
W00009711,CF3,"CF3 0NY, CF3 0NZ, CF3 0PH",332,298,34
W00009679,CF3,"CF3 0LQ, CF3 0LR, CF3 0LZ, CF3 0NE, CF3 0NF",349,309,40
W00009678,CF3,"CF3 0DF, CF3 0DH, CF3 0DJ, CF3 0DL, CF3 0DN, CF3 0DW",232,214,18
W00010517,CF3,"CF3 0EG, CF3 0LA, CF3 0LE, CF3 0LF, CF3 0LG, CF3 0LH, CF3 0LJ, CF3 0LX, CF3 0UH, CF3 0YZ, CF3 0ZD, CF3 0ZF, CF3 0ZR, CF3 2AD, CF3 2AE, CF3 2WJ, CF3 8UZ, CF3 8WA",279,259,20
W00010502,CF3,"CF3 6AB, CF3 6AE, CF3 6AT, CF3 6AU, CF3 6AW, CF3 6AX",223,193,30
W00009707,CF3,"CF3 0JH, CF3 0JJ, CF3 0JL",290,260,30
W00009693,CF3,"CF3 0BR, CF3 0BZ, CF3 0EN, CF3 0EQ, CF3 0ER, CF3 0EZ, CF3 0FA, CF3 0HS, CF3 0NS",345,320,25
W00009673,CF3,"CF3 1AA, CF3 1QY, CF3 1RQ, CF3 1RZ, CF3 1SA, CF3 1SF, CF3 1YH, CF3 1YU, CF3 8QX, CF3 8QY, CF3 8SH",319,290,29
W00009672,CF3,"CF3 0JU, CF3 0JW, CF3 0JY, CF3 0NJ",314,278,36
W00009671,CF3,"CF3 0AR, CF3 0DX, CF3 0DY, CF3 0HY",280,254,26
W00009670,CF3,"CF3 1QW, CF3 1RG, CF3 1RH, CF3 1RJ, CF3 1RR, CF3 1RX, CF3 1TN, CF3 1XX, CF3 8QW, CF3 8QZ, CF3 8RF, CF3 8RG, CF3 8RH, CF3 8RJ, CF3 8RN, CF3 8RQ, CF3 8RX",388,359,29
W00009692,CF3,"CF3 0AS, CF3 0EJ, CF3 0EL, CF3 0LS, CF3 0SH",349,309,40
W00009669,CF3,"CF3 0BJ, CF3 0BP, CF3 0HU, CF3 0JN, CF3 0JQ, CF3 0JR, CF3 0XW",453,415,38
W00009691,CF3,"CF3 0BF, CF3 0BY, CF3 0EA, CF3 0EB, CF3 0ED, CF3 0EE, CF3 0HA, CF3 0HF, CF3 0YG, CF3 0YS, CF3 0YT, CF3 8NJ, CF3 9XZ",546,513,33
W00009690,CF3,"CF3 0HG, CF3 0HH, CF3 0HJ, CF3 0HL, CF3 0HN, CF3 0HP",434,396,38
W00009689,CF3,"CF3 0LB, CF3 0LD, CF3 0LN, CF3 0LY, CF3 0NG",226,201,25
W00009688,CF3,"CF3 0EW, CF3 0EY, CF3 0FB, CF3 0FE, CF3 0LT, CF3 0LW, CF3 0RA, CF3 0RB, CF3 0RE, CF3 0RG, CF3 0SA, CF3 0SG, CF3 0SP, CF3 0TA, CF3 0YE, CF3 0YF, CF3 0YH, CF3 0YP, CF3 0YQ, CF3 0YX, CF3 0YY, CF3 8XS",292,264,28
W00009706,CF3,"CF3 0AX, CF3 0DZ, CF3 0NW, CF3 0PT",305,282,23
W00009705,CF3,"CF3 0RD, CF3 0RF, CF3 0RH, CF3 0RJ, CF3 0RL",258,227,31
W00009704,CF3,"CF3 0BG, CF3 1RA, CF3 1RB, CF3 1RD",317,280,37
W00009703,CF3,"CF3 0AU, CF3 0AW, CF3 0BN, CF3 0JS, CF3 0JT",230,207,23
W00009702,CF3,"CF3 1RE, CF3 1SJ, CF3 1SL, CF3 1SN, CF3 1SQ, CF3 1SR, CF3 1SS, CF3 1US, CF3 8RE",369,336,33
W00009700,CF3,"CF3 0BL, CF3 0BQ, CF3 0ES, CF3 0HT, CF3 0HW, CF3 0JP",282,264,18
W00009677,CF3,"CF3 0NA, CF3 0NB, CF3 0ND, CF3 0NH, CF3 0NL",262,240,22
W00009675,CF3,"CF3 1QJ, CF3 1QL, CF3 1QR, CF3 1RU, CF3 1RW, CF3 1RY, CF3 1SE, CF3 8QH, CF3 8RR, CF3 8RU, CF3 8RY, CF3 8RZ, CF3 8SF",313,282,31
W00009605,CF3,"CF3 2ED, CF3 3EB, CF3 3HF, CF3 3HG, CF3 3HH, CF3 3HJ, CF3 3HQ, CF3 8HF, CF3 8HH, CF3 8HQ, CF3 8HR, CF3 8HS, CF3 8YA",306,281,25
W00009294,CF3,"CF3 4HG, CF3 4HL, CF3 4HN, CF3 4HP, CF3 9ED, CF3 9HL, CF3 9HN, CF3 9HQ",247,239,8
W00009295,CF3,"CF3 5QB, CF3 5RR, CF3 5RT, CF3 5TA, CF3 5TB, CF3 5TQ, CF3 5TT, CF3 5TU, CF3 9RZ, CF3 9TT",363,339,24
W00009296,CF3,"CF3 5LL, CF3 5LU, CF3 5QA, CF3 5SE, CF3 5SH, CF3 9LL, CF3 9LW, CF3 9QB, CF3 9QD, CF3 9SB, CF3 9SD, CF3 9SF",273,244,29
W00009297,CF3,"CF3 5HW, CF3 5LR, CF3 5LS, CF3 5LT, CF3 5NA, CF3 5NG, CF3 9JJ, CF3 9LB, CF3 9LE, CF3 9LQ, CF3 9LR, CF3 9LS, CF3 9LT, CF3 9LU, CF3 9RG",317,300,17
W00009298,CF3,"CF3 5TG, CF3 5TJ, CF3 5TL, CF3 5TN, CF3 5TP, CF3 9RU, CF3 9SU, CF3 9TJ, CF3 9TP, CF3 9TQ, CF3 9UJ",268,255,13
W00009299,CF3,"CF3 0WD, CF3 0XA, CF3 0XB, CF3 0XD, CF3 0XG, CF3 0XH, CF3 0XL, CF3 0XN, CF3 0XP, CF3 0XQ, CF3 0XR, CF3 0XS, CF3 0YA, CF3 0YB, CF3 0YJ, CF3 0YL, CF3 0YN, CF3 0YR, CF3 0YU, CF3 0ZS, CF3 0ZX, CF3 1XA, CF3 1YB, CF3 1YE, CF3 1YF, CF3 1YQ, CF3 2WY, CF3 2WZ, CF3 2XL, CF3 2YB, CF3 2YD, CF3 2YE, CF3 2YH, CF3 2YN, CF3 2YR, CF3 2YT, CF3 2YU, CF3 2ZF, CF3 2ZQ, CF3 2ZR, CF3 2ZS, CF3 2ZT, CF3 3WZ, CF3 3YA, CF3 3YB, CF3 3YD, CF3 3YE, CF3 3YG, CF3 3YH, CF3 3YR, CF3 3YS, CF3 4WY, CF3 4WZ, CF3 4ZA, CF3 4ZP, CF3 5AB, CF3 5HY, CF3 5LD, CF3 5NQ, CF3 5RN, CF3 5SJ, CF3 5SL, CF3 5SN, CF3 5SP, CF3 5SQ, CF3 5SR, CF3 5SS, CF3 5SZ, CF3 5TE, CF3 5TF, CF3 5TH, CF3 5TR, CF3 5TS, CF3 5WB, CF3 5WL, CF3 5WS, CF3 5WU, CF3 5WY, CF3 5WZ, CF3 5XD, CF3 5XW, CF3 5YA, CF3 5YB, CF3 5YD, CF3 5YE, CF3 5YF, CF3 5YG, CF3 5YH, CF3 5YJ, CF3 5YL, CF3 5YP, CF3 5YR, CF3 5YU, CF3 6WG, CF3 6WY, CF3 6YB, CF3 6YD, CF3 6YE, CF3 9RN, CF3 9SL, CF3 9SN, CF3 9SQ, CF3 9SR, CF3 9SS, CF3 9TG, CF3 9TH, CF3 9TL, CF3 9TN, CF3 9TR, CF3 9TS, CF3 9YR, CF30 0AA, CF30 0AB, CF30 0AD, CF30 0AE, CF30 0AF, CF30 0AG, CF30 0AH, CF30 0AJ, CF30 0AL, CF30 0AN, CF30 0AP, CF30 0AQ, CF30 0AR, CF30 0AS, CF30 0AT, CF30 0AU, CF30 0AW, CF30 0AX, CF30 0AY, CF30 0AZ, CF30 0BA, CF30 0BB, CF30 0BD, CF30 0BE, CF30 0BF, CF30 0BG, CF30 0BH, CF30 0BJ, CF30 0BL, CF30 0BN, CF30 0BP, CF30 0BQ, CF30 0BR, CF30 0BS, CF30 0BT, CF30 0BU, CF30 0BW, CF30 0BX, CF30 0BY, CF30 0BZ, CF30 0DA, CF30 0DB, CF30 0DD, CF30 0DE, CF30 0DF, CF30 0DG, CF30 0DH, CF30 0DJ, CF30 0DL, CF30 0DN, CF30 0DP, CF30 0DQ, CF30 0DR, CF30 0DS, CF30 0DT, CF30 0DU, CF30 0DW, CF30 0DX, CF30 0DY, CF30 0DZ, CF30 0EA, CF30 0EB, CF30 0ED, CF30 0EE, CF30 0EF, CF30 0EG, CF30 0EH, CF30 0EJ, CF30 0EL, CF30 0EN, CF30 0EP, CF30 0EQ, CF30 0ER, CF30 0ES, CF30 0ET, CF30 0EW, CF30 0EX, CF30 0EY, CF30 0EZ, CF30 0FA, CF30 0FB, CF30 0FD, CF30 0FE, CF30 0FF, CF30 0FG, CF30 0FH, CF30 0FJ, CF30 0FL, CF30 0FN, CF30 0FP, CF30 0FQ, CF30 0FR, CF30 0FS, CF30 0FT",370,353,17
W00009300,CF3,"CF3 5LJ, CF3 5LP, CF3 5LQ, CF3 5NB, CF3 5RG, CF3 5RJ, CF3 5SG, CF3 9LP, CF3 9QA, CF3 9RH, CF3 9RJ, CF3 9RL, CF3 9RP, CF3 9SE, CF3 9SG, CF3 9SH, CF3 9WD, CF3 9WE, CF3 9WF, CF3 9WG, CF3 9WH, CF3 9WJ, CF3 9WL, CF3 9WN, CF3 9WP, CF3 9YB, CF3 9YD",287,273,14
W00009301,CF3,"CF3 5AD, CF3 5HS, CF3 5HT, CF3 5HU, CF3 5LH, CF3 9HS, CF3 9HT, CF3 9HU, CF3 9HW, CF3 9HX, CF3 9HY, CF3 9LH, CF3 9LJ, CF3 9NA, CF3 9NB, CF4 8AN",321,291,30
W00009303,CF3,"CF3 4BE, CF3 4HE, CF3 4HH, CF3 4HJ, CF3 4HQ, CF3 4HR, CF3 4JB, CF3 4JL, CF3 9HH, CF3 9HJ, CF3 9HR, CF3 9JA, CF3 9JB, CF3 9JH",270,245,25
W00009304,CF3,"CF3 4AD, CF3 4AF, CF3 4AG, CF3 4BS, CF3 4JN, CF3 4JQ, CF3 9AD, CF3 9AF, CF3 9AG, CF3 9BS, CF3 9JN, CF3 9JP, CF3 9JQ, CF3 9JR",308,258,50
W00009293,CF3,"CF3 4JE, CF3 4JF, CF3 4JG, CF3 4JJ, CF3 5JT, CF3 5LX, CF3 5ND, CF3 5NE, CF3 5NL, CF3 9JT, CF3 9JU, CF3 9LX, CF3 9LY, CF3 9ND, CF3 9NE, CF3 9NF, CF3 9NG, CF3 9NH, CF3 9NL, CF3 9NQ, CF3 9NR, CF3 9NS, CF3 9NT",360,323,37
W00009305,CF3,"CF3 4TB, CF3 4TD, CF3 4TE, CF3 5SX, CF3 9SX, CF3 9SZ, CF3 9TF",252,232,20
W00009307,CF3,"CF3 4BX, CF3 4HA, CF3 4HB, CF3 4HD, CF3 4HF, CF3 9HA, CF3 9HB, CF3 9HE, CF3 9HF, CF3 9HZ",311,278,33
W00009308,CF3,"CF3 4DX, CF3 4EB, CF3 4EE, CF3 4EG, CF3 4EJ, CF3 4ES, CF3 9DY, CF3 9EF, CF3 9EG, CF3 9ER, CF3 9HG, CF3 9TA",241,227,14
W00009309,CF3,"CF3 4DP, CF3 4DS, CF3 4DW, CF3 4EH, CF3 4EL, CF3 4EN, CF3 9DW, CF3 9DX, CF3 9EA, CF3 9EJ, CF3 9EL, CF3 9EN, CF3 9ES, CF3 9ET",313,289,24
W00009310,CF3,"CF3 4DL, CF3 4DT, CF3 4DU, CF3 4DZ, CF3 4EA, CF3 4EP, CF3 4EQ, CF3 9DT, CF3 9DU, CF3 9EB, CF3 9EE, CF3 9EP, CF3 9EQ, CF3 9EW",314,288,26
W00009311,CF3,"CF3 4BZ, CF3 4DA, CF3 4DB, CF3 4DD, CF3 4DQ, CF3 4DR, CF3 4HZ, CF3 4WT, CF3 4YA, CF3 4YB, CF3 4YE, CF3 4YY, CF3 4ZB, CF3 9BZ, CF3 9DA, CF3 9DD, CF3 9DE, CF3 9EH, CF3 9HD",281,246,35
W00009312,CF3,"CF3 4BN, CF3 4BP, CF3 4BQ, CF3 4BR, CF3 4BT, CF3 4BU, CF3 4BW, CF3 4BY, CF3 4DN, CF3 9BQ, CF3 9BR, CF3 9BT, CF3 9BU, CF3 9BW, CF3 9BX, CF3 9BY, CF3 9DB, CF3 9DH, CF3 9DN, CF3 9DP, CF3 9DQ, CF3 9DR, CF3 9DS, CF3 9DZ",348,316,32
W00009313,CF3,"CF3 4BG, CF3 4BH, CF3 4BJ, CF3 4BL, CF3 9BA, CF3 9BB, CF3 9BD, CF3 9BG, CF3 9BN, CF3 9BP",190,174,16
W00009314,CF3,"CF3 4AT, CF3 4AU, CF3 4AW, CF3 4AX, CF3 4BD, CF3 4FD, CF3 8DD, CF3 9AH, CF3 9AJ, CF3 9AS, CF3 9AT, CF3 9AU, CF3 9AW, CF3 9AX, CF3 9AY",274,252,22
W00009315,CF3,"CF3 4AA, CF3 4AB, CF3 4AE, CF3 4AH, CF3 4AP, CF3 9AB, CF3 9BH, CF3 9BJ, CF3 9BL, CF3 9JL",290,242,48
W00009316,CF3,"CF3 4AJ, CF3 4AL, CF3 4AN, CF3 4AQ, CF3 4AR, CF3 4AS, CF3 4AY, CF3 9AA, CF3 9AE, CF3 9AL, CF3 9AN, CF3 9AP, CF3 9AQ, CF3 9AR",256,236,20
W00009306,CF3,"CF3 4DY, CF3 4ED, CF3 4EF, CF3 4ER, CF3 4TA, CF3 5SY, CF3 9HP, CF3 9SJ, CF3 9SP, CF3 9SY, CF3 9TB, CF3 9TD, CF3 9TE",251,231,20
W00009627,CF3,"CF3 3JJ, CF3 3JN, CF3 3JP, CF3 3LN, CF3 4LQ, CF3 8JL",268,250,18
W00009626,CF3,"CF3 3AX, CF3 3ET, CF3 4FH, CF3 4LH, CF3 4LJ, CF3 4LR, CF3 4LS, CF3 8LH, CF3 8LJ, CF3 8LQ, CF3 8LR, CF3 8LS",285,271,14
W00009625,CF3,"CF3 3HX, CF3 3HY, CF3 3HZ, CF3 3JB, CF3 3JF, CF3 3JG, CF3 3JH, CF3 3JX, CF3 8HY, CF3 8HZ, CF3 8JA, CF3 8JB, CF3 8JF, CF3 8JH, CF3 8JX, CF3 8NT, CF3 8PD",271,247,24
W00009621,CF3,"CF3 3NX, CF3 3PB, CF3 3PD, CF3 3PF, CF3 3PQ, CF3 3PR, CF3 8NF, CF3 8PQ",287,257,30
W00009620,CF3,"CF3 3NA, CF3 3NB, CF3 3ND, CF3 3NR, CF3 3NT, CF3 3NU, CF3 3NY, CF3 4LL, CF3 8LL, CF3 8NA, CF3 8ND, CF3 8NG, CF3 8NH, CF3 8NU, CF3 8NW, CF3 8NX, CF3 8NY",293,272,21
W00010645,CF3,"CF3 5DF, CF3 5UJ, CF3 5UN, CF3 5UW, CF3 5UY, CF3 9YL, CF3 9YU",284,262,22
W00010623,CF3,"CF3 0UG, CF3 0UJ, CF3 5BD, CF3 5DE, CF3 5EA, CF3 5TX, CF3 5TZ, CF3 5XB, CF3 5YX, CF3 9TZ",275,257,18
W00010579,CF3,"CF3 6AF, CF3 6AH, CF3 6AY, CF3 9YA",252,219,33
W00009619,CF3,"CF3 3NE, CF3 3NF, CF3 3NG, CF3 3NW, CF3 3PT, CF3 8NE, CF3 8PT, CF3 8PW",342,313,29
W00009618,CF3,"CF3 1JA, CF3 1PZ, CF3 1QD, CF3 1QF, CF3 1QN, CF3 3PJ, CF3 3PP, CF3 8PP, CF3 8PZ, CF3 8QD, CF3 8QF, CF3 8QL, CF3 8RW, CF3 8SE, CF3 8SG, CF3 8XD, CF3 8XN, CF3 8XW, CF3 8YB, CF3 8YE, CF3 8YG, CF3 8YL, CF3 8YN, CF3 8YQ, CF3 8YT, CF3 8YZ",317,286,31
W00010183,CF3,"CF3 0PL, CF3 0PW, CF3 1XY",361,302,59
W00010179,CF3,"CF3 0FH, CF3 0FJ, CF3 0PY, CF3 0XU, CF3 1SP, CF3 8SQ, CF3 9XY",428,390,38
W00010644,CF3,"CF3 6WA, CF3 6YA",280,240,40
W00009484,CF3,"CF3 5RA, CF3 5RB, CF3 5RD, CF3 5RF, CF3 9PX, CF3 9RB, CF3 9RD",244,235,9
W00009483,CF3,"CF3 1NR, CF3 5ST, CF3 5SU, CF3 5UB, CF3 5UE, CF3 5UL, CF3 5UP, CF3 5UQ, CF3 5UR, CF3 9UA, CF3 9UD, CF3 9UN, CF3 9UP, CF3 9UR, CF3 9UW, CF3 9YT",188,173,15
W00009617,CF3,"CF3 3LX, CF3 3LY, CF3 3LZ, CF3 3NH, CF3 8LX",187,176,11
W00009713,CF3,"CF3 1ST, CF3 1TA, CF3 1TD, CF3 1TE, CF3 1TF, CF3 1TG, CF3 1UT, CF3 8TA, CF3 8TE",369,336,33
W00009482,CF3,"CF3 5EX, CF3 5EY, CF3 5EZ, CF3 5US, CF3 5UT, CF3 5UU, CF3 5UX, CF3 5XE, CF3 9EY, CF3 9EZ, CF3 9FX, CF3 9UX, CF3 9XA",312,293,19
W00009481,CF3,"CF3 5DH, CF3 5DJ, CF3 5ET, CF3 5TY, CF3 5XA, CF3 9EX, CF3 9TY, CF3 9XB, CF3 9YX",374,347,27
W00009480,CF3,"CF3 5PX, CF3 5PY, CF3 5PZ, CF3 5RE, CF3 9PW, CF3 9PY, CF3 9PZ",208,192,16
W00010558,CF3,"CF3 0NU, CF3 0NX, CF3 0PN, CF3 0PX",289,257,32
W00009622,CF3,"CF3 1QA, CF3 1QB, CF3 1QG, CF3 1SB, CF3 3PH, CF3 3PN, CF3 8PJ, CF3 8QB, CF3 8QG",269,246,23
W00010552,CF3,"CF3 6AJ, CF3 6YG, CF3 6YH, CF3 6YJ, CF3 6YQ, CF3 6YS, CF3 6YW, CF3 6YY, CF3 9YJ",248,223,25
W00009604,CF3,"CF3 3HE, CF3 3JD, CF3 3JU, CF3 3JY, CF3 3JZ, CF3 8HG, CF3 8JD, CF3 8JU, CF3 8JZ",252,232,20
W00009623,CF3,"CF3 3JL, CF3 3JR, CF3 3LE, CF3 3NP, CF3 3NQ, CF3 3NS, CF3 8LE, CF3 8NB, CF3 8NP, CF3 8NQ, CF3 8NR, CF3 8NS",279,252,27
W00009624,CF3,"CF3 1QE, CF3 3AW, CF3 3AY, CF3 3HL, CF3 3HN, CF3 3HP, CF3 3HT, CF3 3JA, CF3 3JE, CF3 3LF, CF3 3LL, CF3 3NZ, CF3 3PA, CF3 3YF, CF3 3ZS, CF3 8HL, CF3 8HN, CF3 8HP, CF3 8JE, CF3 8NZ, CF3 8PA, CF3 8PB, CF3 8PF, CF3 8PH, CF3 8PN, CF3 8QA, CF3 8QE, CF3 8YF",468,428,40
W00009317,CF3,"CF3 5PB, CF3 5PJ, CF3 5PL, CF3 5PP, CF3 5UH, CF3 9PU",297,282,15
W00009318,CF3,"CF3 5NW, CF3 5PA, CF3 5PG, CF3 5PH, CF3 5PN, CF3 9NX, CF3 9PH, CF3 9PJ, CF3 9PL, CF3 9PN, CF3 9PP",367,346,21
W00009302,CF3,"CF3 4JA, CF3 4JD, CF3 4JH, CF3 4JP, CF3 4JR, CF3 4JS, CF3 4YW, CF3 9JD, CF3 9JE, CF3 9JS, CF3 9YW",313,283,30
W00009320,CF3,"CF3 5PF, CF3 5PT, CF3 5QN, CF3 5QR, CF3 5QY, CF3 5QZ, CF3 9QN, CF3 9QP, CF3 9QQ, CF3 9QR, CF3 9QU, CF3 9QZ",320,297,23
W00009324,CF3,"CF3 5DG, CF3 5JU, CF3 5JW, CF3 5JX, CF3 5JY, CF3 9DF, CF3 9DG, CF3 9JF, CF3 9JG, CF3 9JW, CF3 9JX, CF3 9JY, CF3 9JZ, CF3 9LA, CF3 9LD, CF3 9NP, CF3 9NU, CF3 9NW",302,290,12
W00009871,CF3,"CF3 2TA, CF3 2TD, CF3 2TL, CF3 2TT, CF3 2UJ, CF3 2UL, CF3 2XB, CF3 2XF, CF3 2YF, CF3 8UE, CF3 8UG, CF3 8XB, CF3 8XF",378,344,34
W00010207,CF3,"CF3 0FF, CF3 0FG, CF3 0PZ, CF3 0QA, CF3 0QB, CF3 0QD, CF3 0RP, CF3 0RQ",407,375,32
W00010613,CF3,"CF3 0NN, CF3 2AA, CF3 2AB, CF3 2AF, CF3 2UZ, CF3 2WL",306,269,37
W00009329,CF3,"CF3 5RH, CF3 5RL, CF3 5RP, CF3 5RQ, CF3 5SB, CF3 5SD, CF3 5SF, CF3 9RQ, CF3 9RR, CF3 9RS, CF3 9RT, CF3 9TU, CF3 9YS",329,304,25
W00009613,CF3,"CF3 2EH, CF3 2EP, CF3 2EX, CF3 2EY, CF3 2HP, CF3 3AD, CF3 3AE, CF3 3AR, CF3 3AU, CF3 3BX, CF3 8AE, CF3 8AQ, CF3 8AR, CF3 8AT, CF3 8AU, CF3 8BN, CF3 8BQ, CF3 8BR, CF3 8BX",299,274,25
W00009328,CF3,"CF3 5RS, CF3 5RU, CF3 5RW, CF3 5RX, CF3 5RY, CF3 5RZ, CF3 5SA, CF3 5YS, CF3 5YT, CF3 9RF, CF3 9RW, CF3 9RX, CF3 9RY, CF3 9SA, CF3 9UB, CF3 9UQ, CF3 9UT",327,302,25
W00009616,CF3,"CF3 3PE, CF3 3PG, CF3 3PL, CF3 3PU, CF3 8PE, CF3 8PG, CF3 8PL, CF3 8QJ, CF3 8QR, CF3 8XQ",354,326,28
W00009325,CF3,"CF3 5QF, CF3 5QG, CF3 5QH, CF3 5QX, CF3 9QH",363,332,31
W00009614,CF3,"CF3 3AB, CF3 3AF, CF3 3AH, CF3 3AL, CF3 3BY, CF3 3DB, CF3 3DD, CF3 3DE, CF3 8AD, CF3 8AH, CF3 8AN, CF3 8AP, CF3 8BY, CF3 8BZ",279,251,28
W00010534,CF3,"CF3 5FX, CF3 5SW, CF3 5UG, CF3 5WW, CF3 6XA, CF3 6XD, CF3 6XJ, CF3 8XT, CF3 9SW, CF3 9XD, CF3 9XJ, CF3 9XL, CF3 9XN, CF3 9XW, CF3 9YY",321,305,16
W00009326,CF3,"CF3 5LN, CF3 5LW, CF3 5NN, CF3 5QD, CF3 5QE, CF3 5QT, CF3 5WH, CF3 5WN, CF3 5WR, CF3 5WX, CF3 5ZD, CF3 9PD, CF3 9QJ, CF3 9QX",305,288,17
W00009327,CF3,"CF3 5LY, CF3 5LZ, CF3 5NF, CF3 5NH, CF3 5NT, CF3 9LN, CF3 9LZ, CF3 9NN, CF3 9NZ, CF3 9QE, CF3 9QG, CF3 9QT",274,255,19
W00009712,CF3,"CF3 1RP, CF3 1SH, CF3 1SU, CF3 1SW, CF3 1SZ, CF3 1TJ, CF3 1TL, CF3 8SP, CF3 8SR, CF3 8SS, CF3 8ST, CF3 8SU, CF3 8SW, CF3 8SZ, CF3 8TD, CF3 8TF",281,257,24
W00009615,CF3,"CF3 3LJ, CF3 3LQ, CF3 3LR, CF3 3LT, CF3 3LU, CF3 3LW, CF3 3NJ, CF3 3NL, CF3 3PW, CF3 3PX, CF3 3PY, CF3 3XG, CF3 8LT, CF3 8LU, CF3 8LW, CF3 8LY, CF3 8LZ, CF3 8PU, CF3 8PX, CF3 8PY, CF3 8XG",353,330,23
W00010631,CF3,"CF3 6AL, CF3 6AN, CF3 6AP, CF3 6AQ, CF3 6AR, CF3 6AS",269,232,37
W00009862,CF3,"CF3 2AH, CF3 2TB, CF3 2TE, CF3 2TF, CF3 2TU, CF3 2UF, CF3 2UH, CF3 2US, CF3 2WB",413,352,61
W00009323,CF3,"CF3 5JZ, CF3 5LA, CF3 5NJ, CF3 5NU, CF3 9NJ",335,305,30
W00009322,CF3,"CF3 5NP, CF3 5NX, CF3 5NY, CF3 5NZ, CF3 5PD, CF3 5QJ, CF3 5QL, CF3 9NY, CF3 9PA, CF3 9PG, CF3 9PR, CF3 9QF, CF3 9QL",378,357,21
W00009611,CF3,"CF3 3AG, CF3 3AN, CF3 3AP, CF3 3AQ, CF3 3AS, CF3 3BT, CF3 8AS, CF3 8BS, CF3 8BT",307,277,30
W00009610,CF3,"CF3 3AA, CF3 3AJ, CF3 4AZ, CF3 4DF, CF3 4FA, CF3 4FB, CF3 4FE, CF3 4FT, CF3 4FU, CF3 8AB, CF3 8AF, CF3 8AG, CF3 8AJ, CF3 8AL, CF3 8DB, CF3 8DU, CF3 8DX, CF3 8DZ",369,316,53
W00009609,CF3,"CF3 2EQ, CF3 2ET, CF3 3AZ, CF3 3BF, CF3 3BJ, CF3 3BL, CF3 3BN, CF3 3BP, CF3 3BW, CF3 8BL, CF3 8BP, CF3 8BW, CF3 8EF, CF3 8EG, CF3 8EQ, CF3 8HE, CF3 8XJ, CF3 8XP",302,285,17
W00010594,CF3,"CF3 0PJ, CF3 0PP, CF3 0PR, CF3 0RN",295,268,27
W00009715,CF3,"CF3 1DW, CF3 1DX, CF3 1DZ, CF3 8XX, CF3 8XY, CF3 8XZ",370,349,21
W00010629,CF3,"CF3 5DL, CF3 5PW, CF3 6HX, CF3 6UY, CF3 6UZ, CF3 9UU, CF3 9UY, CF3 9UZ",256,228,28
W00009608,CF3,"CF3 3BA, CF3 3BB, CF3 3BS, CF3 3BU, CF3 3DS, CF3 8BA, CF3 8BB, CF3 8BD, CF3 8BE, CF3 8BU, CF3 8DF, CF3 8DJ, CF3 8DS, CF3 8HA",315,293,22
W00010538,CF3,"CF3 6YN, CF3 6YP, CF3 6YR",315,273,42
W00010155,CF3,"CF3 0PQ, CF3 0PS, CF3 0PU",229,203,26
W00009612,CF3,"CF3 3AT, CF3 3BE, CF3 3BH, CF3 3BQ, CF3 3BR, CF3 3BZ, CF3 8BG, CF3 8BH, CF3 8BJ, CF3 8EB",299,264,35
W00009607,CF3,"CF3 3BD, CF3 3BG, CF3 3EA, CF3 3HB, CF3 3HD, CF3 3XE, CF3 8EA, CF3 8HB, CF3 8HD, CF3 8JY, CF3 8LB, CF3 8XA, CF3 8XE",299,262,37
W00009606,CF3,"CF3 3DR, CF3 4BA, CF3 4BB, CF3 4DJ, CF3 4FF, CF3 8DG, CF3 8DN, CF3 8DP, CF3 8DR, CF3 8DW",263,248,15
W00009319,CF3,"CF3 5NR, CF3 5PU, CF3 5QP, CF3 5QQ, CF3 5QS, CF3 5QU, CF3 5QW, CF3 9DJ, CF3 9DL, CF3 9QS, CF3 9QW, CF3 9QY, CF3 9RA, CF3 9RE, CF3 9US",314,289,25
W00009321,CF3,"CF3 5PE, CF3 5PQ, CF3 5PR, CF3 5PS, CF3 9PB, CF3 9PE, CF3 9PF, CF3 9PQ, CF3 9PS, CF3 9PT",297,254,43
W00010391,CF31,"CF31 4AT, CF31 4DY, CF31 4QS, CF31 4RF, CF31 4RG, CF31 4RQ",361,332,29
W00005430,CF31,"CF31 4JR, CF31 4JY, CF31 4JZ, CF31 4LA, CF31 4LB, CF31 4LJ, CF31 4PE, CF31 4PJ, CF31 4QH, CF31 4XX",539,487,52
W00005421,CF31,"CF31 1RJ, CF31 1SH, CF31 1SJ",281,254,27
W00010419,CF31,"CF31 2DP, CF31 2DQ, CF31 2DR",370,343,27
W00005420,CF31,"CF31 1RT, CF31 1RU, CF31 1RY, CF31 1SL, CF31 1SN",321,303,18
W00010390,CF31,"CF31 2BN, CF31 2BW, CF31 2BX, CF35 6JU",224,197,27
W00005415,CF31,"CF31 1AA, CF31 1AB, CF31 1AD, CF31 1AF, CF31 1AG, CF31 1AT, CF31 1AU, CF31 1AX, CF31 1BD, CF31 1BE, CF31 1BH, CF31 1BL, CF31 1BQ, CF31 1BS, CF31 1DH, CF31 1DJ, CF31 1DL, CF31 1DN, CF31 1DQ, CF31 1DS, CF31 1DT, CF31 1DU, CF31 1DW, CF31 1DX, CF31 1EB, CF31 1ED, CF31 1EE, CF31 1EF, CF31 1EG, CF31 1EH, CF31 1EJ, CF31 1EL, CF31 1EN, CF31 1EP, CF31 1EQ, CF31 1ER, CF31 1ES, CF31 1ET, CF31 1EU, CF31 1EW, CF31 1EX, CF31 1EY, CF31 1EZ, CF31 1HA, CF31 1HN, CF31 1HS, CF31 1HT, CF31 1HU, CF31 1HW, CF31 1HX, CF31 1JA, CF31 1JB, CF31 1JD, CF31 1JE, CF31 1JF, CF31 1JH, CF31 1JN, CF31 1JQ, CF31 1JW, CF31 1LA, CF31 1LE, CF31 1LF, CF31 1LH, CF31 1LJ, CF31 1LL, CF31 1LP, CF31 1LQ, CF31 1NQ, CF31 1ST, CF31 1TD, CF31 3BL",391,366,25
W00005418,CF31,"CF31 1TG, CF31 1TH, CF31 1TJ, CF31 1TL, CF31 1TQ",294,266,28
W00005409,CF31,"CF31 1JG, CF31 1RZ, CF31 1YZ",247,233,14
W00010371,CF31,"CF31 2AL, CF31 2AS, CF31 2BB, CF31 2DA, CF31 2XA, CF35 6NJ, CF35 6PS, CF35 6PX, CF35 6PY, CF35 6QA, CF35 6QD, CF35 6QE, CF35 6QL, CF35 6QP",204,176,28
W00010450,CF31,CF31 2LN,100,89,11
W00010449,CF31,"CF31 2NY, CF31 2NZ, CF31 2PT, CF31 2PU, CF31 2PW, CF31 2QT",252,223,29
W00010448,CF31,CF31 2PJ,206,180,26
W00005410,CF31,"CF31 1JY, CF31 1JZ, CF31 1LY, CF31 1NA, CF31 1NB, CF31 1ND, CF31 1NS, CF31 1NW, CF31 1XP, CF31 1XS, CF31 1XT, CF31 1XW",269,244,25
W00005419,CF31,"CF31 1RG, CF31 1RP, CF31 1RR, CF31 1RS, CF31 1RW, CF31 1RX, CF31 1YF",251,233,18
W00005411,CF31,"CF31 1JP, CF31 1JR, CF31 1JS, CF31 1JT, CF31 1JU, CF31 1JX, CF31 1LG, CF31 1YE",436,401,35
W00005413,CF31,"CF31 1HH, CF31 1HJ, CF31 1HL, CF31 1NJ, CF31 1NL",209,199,10
W00005414,CF31,"CF31 1GW, CF31 1HE, CF31 1HF, CF31 1HG, CF31 1HQ, CF31 1LR, CF31 1LS, CF31 1XX",284,262,22
W00005431,CF31,"CF31 4HB, CF31 4RL, CF31 4RN, CF31 4SE, CF31 4SH",310,286,24
W00005416,CF31,"CF31 1HB, CF31 1HD, CF31 1TF",341,308,33
W00005417,CF31,"CF31 1BB, CF31 1BN, CF31 1BR, CF31 1BT, CF31 1BU, CF31 1BW, CF31 1BX, CF31 1BY, CF31 1DA, CF31 1DB, CF31 1EA, CF31 1SU, CF31 1SY, CF31 1SZ, CF31 1TA, CF31 1TE, CF31 1TN, CF31 1TW",248,224,24
W00010389,CF31,"CF31 2AD, CF31 2AE, CF31 2AH, CF31 2AQ, CF31 2AY, CF31 2DB, CF31 2XF, CF31 2XG, CF35 6AU, CF35 6AY, CF35 6AZ, CF35 6BA, CF35 6DB, CF35 6DL, CF35 6FG",272,233,39
W00005412,CF31,"CF31 1LT, CF31 1LU, CF31 1LZ, CF31 1NE, CF31 1NF",218,205,13
W00005523,CF31,"CF31 4NR, CF31 4NT, CF31 4NU, CF31 4NX, CF31 4NZ",263,237,26
W00005434,CF31,"CF31 4AL, CF31 4AN, CF31 4AP, CF31 4AW, CF31 4EY, CF31 4EZ, CF31 4HA, CF31 4JA, CF31 4JB, CF31 4JE, CF31 4JJ, CF31 4JN, CF31 4XY, CF31 4YD, CF31 4YF, CF31 4YG, CF31 4YJ, CF31 4YN, CF31 4YU",237,208,29
W00005522,CF31,"CF31 4BT, CF31 4BU, CF31 4DU, CF31 4FF, CF31 4LX, CF31 4LY, CF31 4NB, CF31 4ND, CF31 4NE, CF31 4NF, CF31 4NG",309,281,28
W00005503,CF31,"CF31 1LB, CF31 1LD, CF31 1NT, CF31 1RQ, CF31 1SQ",233,215,18
W00005502,CF31,"CF31 1HZ, CF31 1LN, CF31 1LW, CF31 1NG, CF31 1NN, CF31 1NR, CF31 1NU",285,259,26
W00005501,CF31,"CF31 1PE, CF31 1PG, CF31 1PN, CF31 1PQ",319,299,20
W00005500,CF31,"CF31 1NX, CF31 1NY, CF31 1NZ, CF31 1PA, CF31 1PB, CF31 1PD, CF31 1PT, CF31 1UZ, CF35 6AL, CF35 6BB, CF35 6BD, CF35 6BX",463,428,35
W00005499,CF31,"CF31 1PF, CF31 1PP, CF31 1PR, CF31 1PS, CF31 1PW",250,229,21
W00005485,CF31,"CF31 3BZ, CF31 3LB, CF31 3LL, CF31 3LP, CF31 3LR, CF31 3LS, CF31 3LT, CF31 3LW",373,334,39
W00005498,CF31,"CF31 3AJ, CF31 3BH, CF31 3DR, CF31 3HG, CF31 3HH, CF31 3HJ, CF31 3SP, CF31 3SQ, CF31 3SW, CF31 3XX",361,319,42
W00010428,CF31,"CF31 2AG, CF31 2AJ, CF31 2AN, CF31 2AW, CF31 2AX, CF31 2AZ, CF31 2BA, CF31 2BD, CF31 2BF, CF31 2EN, CF31 2XD, CF31 2XE, CF31 2XJ, CF31 2XL, CF32 0YG, CF32 0YJ, CF32 0YS, CF35 6GN, CF35 6GQ, CF35 6GS, CF35 6GT, CF35 6GU, CF35 6GW, CF35 6GX, CF35 6JT",243,211,32
W00005497,CF31,"CF31 3EA, CF31 3EL, CF31 3EN, CF31 3ES, CF31 3ET, CF31 3EU, CF31 3EW, CF31 3HB, CF31 3HD",327,288,39
W00005504,CF31,"CF31 1DF, CF31 1HP, CF31 1HR, CF31 1NP",253,236,17
W00005496,CF31,"CF31 3NS, CF31 3NU, CF31 3NX, CF31 3NY, CF31 3NZ, CF31 3PN",321,275,46
W00005487,CF31,"CF31 1TP, CF31 1TR, CF31 1TT, CF31 1TY",250,234,16
W00005488,CF31,"CF31 2ED, CF31 3AY, CF31 3BA, CF31 3BJ, CF31 3DL",313,292,21
W00005489,CF31,"CF31 1HY, CF31 1SA, CF31 1SE, CF31 1TS, CF31 1TU, CF31 1TX, CF31 1TZ, CF31 1UA, CF31 1UB, CF31 1UD, CF31 1UG, CF31 1UH, CF31 1WB, CF31 1WD, CF31 1WE, CF31 1WF, CF31 1WG, CF31 1WH, CF31 1WJ, CF31 1WZ, CF31 1XB, CF31 1XD, CF31 1XH, CF31 1XL, CF31 1XQ, CF31 1XU, CF31 1YA, CF31 1YB, CF31 1ZP, CF31 1ZZ, CF31 2WA, CF31 2WB, CF31 2WD, CF31 2WE, CF31 2WP, CF31 2WX, CF31 2WY, CF31 2WZ, CF31 2XB, CF31 2XH, CF31 2XN, CF31 2XP, CF31 2XR, CF31 2XT, CF31 2XY, CF31 2XZ, CF31 2YA, CF31 2YD, CF31 2YL, CF31 2YP, CF31 2YQ, CF31 2YR, CF31 2YU, CF31 2YY, CF31 2ZR, CF31 2ZX, CF31 2ZY, CF31 3AT, CF31 3DZ, CF31 3LQ, CF31 3UH, CF31 3WA, CF31 3WE, CF31 3WF, CF31 3WG, CF31 3WN, CF31 3WR, CF31 3WS, CF31 3WU, CF31 3WW, CF31 3WX, CF31 3WY, CF31 3XL, CF31 3XN, CF31 3XP, CF31 3YA, CF31 3YB, CF31 3YF, CF31 3YJ, CF31 3YQ, CF31 3YT, CF31 3YZ, CF31 3ZB, CF31 3ZD, CF31 3ZE, CF31 3ZF, CF31 3ZU, CF31 3ZY, CF31 4WP, CF31 4XE, CF31 4XF, CF31 4XH, CF31 4XJ, CF31 4XL, CF31 4XN, CF31 4XP, CF31 4XQ, CF31 4XR, CF31 4XS, CF31 4XZ, CF31 4YA, CF31 4YL, CF31 4YP, CF31 4YQ, CF31 4YR, CF31 4YT, CF31 4ZR, CF31 4ZY, CF31 5NA, CF31 5WB, CF31 5WZ, CF31 5YA, CF31 5YB, CF31 5YF, CF31 5YH, CF31 5YU, CF31 9AA, CF31 9AB, CF31 9AD, CF31 9AE, CF31 9AF, CF31 9AG, CF31 9AH, CF31 9AJ, CF31 9AL, CF31 9AN, CF31 9AP, CF31 9AQ, CF31 9AR, CF31 9AS, CF31 9AT, CF31 9AU, CF31 9AW, CF31 9AX, CF31 9AY, CF31 9AZ, CF31 9BA, CF31 9BB, CF31 9BE, CF31 9BF, CF31 9BG, CF31 9BH, CF31 9BJ, CF31 9BL, CF31 9BN, CF31 9BP, CF31 9BQ, CF31 9BR, CF31 9BS, CF31 9BT, CF31 9BU, CF31 9BW, CF31 9BX, CF31 9BY, CF31 9BZ, CF31 9DA, CF31 9DB, CF31 9DD, CF31 9DE, CF31 9DF, CF31 9DG, CF31 9DH, CF31 9DJ, CF31 9DL, CF31 9DN, CF31 9DP, CF31 9DQ, CF31 9DR, CF31 9DS, CF31 9DT, CF31 9DU, CF31 9DW, CF31 9DX, CF31 9DY, CF31 9DZ, CF31 9EA, CF31 9EB, CF31 9ED, CF31 9EE, CF31 9EF, CF31 9EG, CF31 9EH, CF31 9EJ, CF31 9EL, CF31 9EN, CF31 9EP, CF31 9EQ, CF31 9ER, CF31 9ES, CF31 9ET, CF31 9EU, CF31 9EW, CF31 9EX, CF31 9EY, CF31 9EZ, CF31 9FA, CF31 9FB, CF31 9FD, CF31 9FE, CF31 9FF, CF31 9FG, CF31 9FH, CF31 9FJ, CF31 9FL, CF31 9FN, CF31 9FP, CF31 9FQ, CF31 9FR, CF31 9FS, CF31 9FT, CF31 9FW, CF31 9FX, CF31 9FY, CF31 9FZ, CF31 9GA, CF31 9GB, CF31 9GD, CF31 9GE, CF31 9GF, CF31 9GG, CF31 9GH, CF31 9GJ, CF31 9GL, CF31 9GN, CF31 9GP, CF31 9GQ, CF31 9GR, CF31 9GS, CF31 9GT, CF31 9GU, CF31 9GW, CF31 9GX, CF31 9GY, CF31 9GZ, CF31 9HA, CF31 9HB, CF31 9HD, CF31 9HE, CF31 9HF, CF31 9HG, CF31 9HH, CF31 9HJ, CF31 9HL, CF31 9HN, CF31 9HP, CF31 9HQ, CF31 9HR, CF31 9HS, CF31 9HT, CF31 9HU, CF31 9HW, CF31 9HX, CF31 9HY, CF31 9HZ, CF31 9JA, CF31 9JB, CF31 9JD, CF31 9JE, CF31 9JF, CF31 9JG, CF31 9JH, CF31 9JJ, CF31 9JL, CF31 9JN, CF31 9JP, CF31 9JQ, CF31 9JR, CF31 9JS, CF31 9JT, CF31 9JU, CF31 9JW, CF31 9JX, CF31 9JY, CF31 9JZ, CF31 9LA, CF31 9LB, CF31 9LD, CF31 9LE, CF31 9LF, CF31 9LG, CF31 9LH, CF31 9LJ, CF31 9LL, CF31 9LN, CF31 9LP, CF31 9LQ, CF31 9LR, CF31 9LS, CF31 9LT, CF31 9LU, CF31 9LW, CF31 9LY, CF31 9LZ, CF31 9NA, CF31 9NB, CF31 9ND, CF31 9NE, CF31 9NF, CF31 9NG, CF31 9NH, CF31 9NJ, CF31 9NL, CF31 9NN, CF31 9NP, CF31 9NQ, CF31 9NR, CF31 9NS, CF31 9NT, CF31 9NU, CF31 9NW, CF31 9NX, CF31 9NY, CF31 9NZ, CF31 9PA, CF31 9PB, CF31 9PD, CF31 9PE, CF31 9PF, CF31 9PG, CF31 9PL, CF31 9PN, CF31 9PP, CF31 9PQ, CF31 9PR, CF31 9PS, CF31 9PT, CF31 9PU, CF31 9PW, CF31 9PX, CF31 9PY, CF31 9PZ, CF31 9QA, CF31 9QB, CF31 9QD, CF31 9QE, CF31 9QF, CF31 9QG, CF31 9QH, CF31 9QJ, CF31 9QN, CF31 9QP, CF31 9QQ, CF31 9QR, CF31 9QS, CF31 9QT, CF31 9QU, CF31 9QW, CF31 9QX, CF31 9QY, CF31 9QZ, CF31 9RA, CF31 9RB, CF31 9RD, CF31 9RE, CF31 9RF, CF31 9RG, CF31 9RH, CF31 9RL, CF31 9RN, CF31 9RQ, CF31 9RR, CF31 9RS, CF31 9RT, CF31 9RU, CF31 9RW, CF31 9RX, CF31 9RY, CF31 9RZ, CF31 9SA, CF31 9SB, CF31 9SD, CF31 9SE, CF32 0WG, CF32 0WZ, CF32 0YA, CF32 0YB, CF32 0YD, CF32 0YE, CF32 0YF, CF32 0YH, CF32 0YN, CF32 0YP, CF32 0YQ, CF32 0YR, CF32 0YX, CF32 0YY, CF32 0YZ, CF32 0ZB, CF32 0ZY, CF32 7WH, CF32 7YG, CF32 7YH, CF32 7YL, CF32 7YR, CF32 7ZY, CF32 8YJ, CF32 8YL, CF32 8YN, CF32 8ZR, CF32 9WA, CF32 9XA, CF32 9XJ, CF32 9XN, CF32 9XQ, CF32 9XS, CF32 9XT, CF32 9XU, CF32 9XZ, CF32 9YQ, CF32 9ZR, CF32 9ZY, CF33 4WP, CF33 4WQ, CF33 4YB, CF33 4YE, CF33 4YG, CF33 4YU, CF33 4ZY, CF33 6WZ, CF33 6XB, CF33 6YB, CF33 6YE, CF33 6YF, CF33 6YH, CF33 6YJ, CF33 6YL, CF33 6YP, CF33 6YU, CF33 6YW, CF33 6ZR, CF35 5WY, CF35 5WZ, CF35 5YA, CF35 5YB, CF35 5YD, CF35 5YH, CF35 5YQ, CF35 5YR, CF35 5YS, CF35 5YU, CF35 5YW, CF35 5YX, CF35 5ZA, CF35 5ZB, CF35 5ZQ, CF35 5ZR, CF35 5ZX, CF35 5ZY, CF35 6WA, CF35 6WB, CF35 6WG, CF35 6WY, CF35 6WZ, CF35 6XA, CF35 6XG, CF35 6XL, CF35 6XN, CF35 6XP, CF35 6XS, CF35 6XW, CF35 6XX, CF35 6XZ, CF35 6ZS",254,227,27
W00005490,CF31,"CF31 1DD, CF31 1DP, CF31 1JJ, CF31 3AA, CF31 3AB, CF31 3AD, CF31 3AE, CF31 3AF, CF31 3AG, CF31 3BE, CF31 3BN, CF31 3BP, CF31 3BS, CF31 3BT, CF31 3BU, CF31 3BW, CF31 3ED, CF31 3EJ, CF31 3HL, CF31 3HN, CF31 3HP, CF31 3HW, CF31 3NG, CF31 3NH, CF31 3NL, CF31 3NP",271,244,27
W00005491,CF31,"CF31 3NT, CF31 3PA, CF31 3PB, CF31 3PD, CF31 3PE, CF31 3PP",259,225,34
W00005492,CF31,"CF31 3AZ, CF31 3EE, CF31 3NN, CF31 3NR, CF31 3NW, CF31 3PF, CF31 3PG",343,290,53
W00005493,CF31,"CF31 3AL, CF31 3AP, CF31 3AR, CF31 3AW, CF31 3DA, CF31 3DB, CF31 3DD, CF31 3DE, CF31 3DG, CF31 3DH",335,306,29
W00005494,CF31,"CF31 3BB, CF31 3BD, CF31 3DF, CF31 3DN, CF31 3DS, CF31 3DW",312,273,39
W00005495,CF31,"CF31 3EF, CF31 3EG, CF31 3EH, CF31 3HR, CF31 3HS, CF31 3HT, CF31 3HU, CF31 3WB, CF31 3WH, CF31 3WJ, CF31 3WL, CF31 3WP, CF31 3WQ, CF31 3WZ, CF31 3XT, CF31 3XW, CF31 3XZ, CF31 3YD, CF31 3YG",334,300,34
W00005486,CF31,"CF31 1BZ, CF31 1UE, CF31 1UF, CF31 3AH, CF31 3AN, CF31 3AS, CF31 3AU, CF31 3BY",266,246,20
W00005432,CF31,"CF31 4HN, CF31 4HR, CF31 4HW, CF31 4JP, CF31 4LD, CF31 4PB",322,297,25
W00005408,CF31,"CF31 1AH, CF31 1YN, CF31 1YP, CF31 1YS, CF31 1YT, CF31 1YW",226,211,15
W00005484,CF31,"CF31 3AX, CF31 3BX, CF31 3ER, CF31 3EY, CF31 3HA, CF31 3LD, CF31 3LE, CF31 3LF, CF31 3LH, CF31 3LJ, CF31 3LN, CF31 3LU, CF31 3NA, CF31 3NB, CF31 3ND, CF31 3XY, CF35 5AA, CF35 5AJ, CF35 5AP, CF35 5AW",441,408,33
W00005521,CF31,"CF31 4LZ, CF31 4NA, CF31 4NL, CF31 4NN, CF31 4PA",250,225,25
W00005520,CF31,"CF31 4LN, CF31 4LP, CF31 4NP, CF31 4NS, CF31 4NY, CF32 9PW",318,294,24
W00005519,CF31,"CF31 4GA, CF31 4GB, CF31 4GJ, CF31 4LS, CF31 4LT, CF31 4LU, CF31 4NH",357,328,29
W00005433,CF31,"CF31 4HS, CF31 4HT, CF31 4RP, CF31 4RR, CF31 4RS, CF31 4RW",294,280,14
W00005435,CF31,"CF31 4HJ, CF31 4HP, CF31 4RJ, CF31 4SD",273,262,11
W00005436,CF31,"CF31 4HD, CF31 4HX, CF31 4HY, CF31 4JW",204,188,16
W00005437,CF31,"CF31 4DB, CF31 4DJ, CF31 4DL, CF31 4DN, CF31 4DR, CF31 4DW",234,221,13
W00005438,CF31,"CF31 4BY, CF31 4DA, CF31 4DH, CF31 4DP, CF31 4JH, CF31 4LR",271,256,15
W00005439,CF31,"CF31 4BB, CF31 4BD, CF31 4BQ, CF31 4HG, CF31 4HH, CF31 4HL, CF31 4HQ, CF31 4SJ",326,278,48
W00010424,CF31,"CF31 4QT, CF31 4QU, CF31 4RD",258,245,13
W00005440,CF31,"CF31 4AZ, CF31 4BA, CF31 4BH, CF31 4BS, CF31 4BW, CF31 4FH, CF31 4HE, CF31 4HF, CF31 4HU",300,280,20
W00005442,CF31,"CF31 4BZ, CF31 4SL, CF31 4SN, CF31 4SW, CF31 4TA",265,228,37
W00005443,CF31,"CF31 4SU, CF31 4SX, CF31 4SY, CF31 4SZ",273,254,19
W00005444,CF31,"CF31 4BL, CF31 4BN, CF31 4SR, CF31 4TB",238,222,16
W00005445,CF31,"CF31 4BJ, CF31 4BP, CF31 4SS",306,280,26
W00005446,CF31,"CF31 4SP, CF31 4ST, CF31 4TD",180,174,6
W00005447,CF31,"CF31 4JD, CF31 4JF, CF31 4JG, CF31 4JL, CF31 4JQ, CF31 4LG, CF31 4LH, CF31 4PD, CF31 4PG, CF31 4PH, CF31 4PQ, CF31 4QQ",455,417,38
W00005518,CF31,"CF31 4BE, CF31 4BF, CF31 4BG, CF31 4BX, CF31 4DS, CF31 4DT, CF31 4FG, CF31 4LQ, CF31 4NW",334,292,42
W00005517,CF31,"CF31 4GD, CF31 4GE, CF31 4GF, CF31 4GG, CF31 4GH, CF31 4GL, CF31 4LL, CF31 4LW, CF31 4NQ",405,354,51
W00005483,CF31,"CF31 3DP, CF31 3DT, CF31 3DU, CF31 3HY, CF31 3LA",273,237,36
W00005441,CF31,"CF31 1JL, CF31 1LX, CF31 4AA, CF31 4AB, CF31 4AD, CF31 4AE, CF31 4AF, CF31 4AG, CF31 4AH, CF31 4AJ, CF31 4AQ, CF31 4AR, CF31 4AS, CF31 4AU, CF31 4AX, CF31 4AY, CF31 4HZ, CF31 4NJ, CF31 4WB, CF31 4ZA, CF31 9BD, CF31 9XY, CF31 9XZ, CF31 9YA, CF31 9YB, CF31 9YD, CF31 9YE, CF31 9YF, CF31 9YG, CF31 9YH, CF31 9YJ, CF31 9YL, CF31 9YN, CF31 9YP, CF31 9YQ, CF31 9YR, CF31 9YS, CF31 9YT, CF31 9YU, CF31 9YW, CF31 9YX, CF31 9YY, CF31 9YZ, CF31 9ZA, CF31 9ZB, CF31 9ZD, CF31 9ZE, CF31 9ZF, CF31 9ZG, CF31 9ZH, CF31 9ZJ, CF31 9ZL, CF31 9ZN, CF31 9ZP, CF31 9ZQ, CF31 9ZR, CF31 9ZS, CF31 9ZT, CF31 9ZU, CF31 9ZW, CF31 9ZX, CF31 9ZY, CF31 9ZZ",222,207,15
W00005407,CF31,"CF31 1RH, CF31 1RL, CF31 1RN, CF31 1SP, CF31 1SW",279,260,19
W00010392,CF31,"CF31 1DE, CF31 2PZ, CF31 2QS, CF31 2QU",319,257,62
W00010429,CF31,"CF31 1PU, CF31 1PX, CF31 1PY",305,281,24
W00009959,CF31,"CF31 4DZ, CF31 5EU, CF31 5EW, CF31 5EZ, CF31 5FL, CF31 5FQ, CF31 5FS, CF31 5GA",597,526,71
W00009958,CF31,"CF31 5BA, CF31 5BB, CF31 5BD, CF31 5FF, CF32 0NS",348,312,36
W00005255,CF31,"CF31 3LG, CF31 3LY, CF32 0LR, CF32 0LS, CF32 0LT, CF32 0LY, CF32 0NA, CF32 0ND, CF32 0NE, CF32 0NN, CF32 0NP, CF32 0NU, CF32 0NW, CF32 0YL, CF33 4RS, CF33 4RT, CF33 4RU",254,218,36
W00005285,CF31,"CF31 4PS, CF31 4PU, CF31 4QP, CF31 4QR, CF31 4QW",247,225,22
W00005287,CF31,"CF31 4PY, CF31 4QB, CF31 4QN, CF31 4UH",236,232,4
W00005288,CF31,"CF31 4PL, CF31 4PN, CF31 4PW, CF31 4QD, CF31 4QE",317,293,24
W00005289,CF31,"CF31 4PP, CF31 4PR, CF31 4PT, CF31 4PX, CF31 4PZ, CF31 4QA",231,215,16
W00009956,CF31,"CF31 2AR, CF31 2LD, CF31 2LR, CF31 2LS, CF31 2NL",236,209,27
W00009955,CF31,"CF31 4SF, CF31 5AW, CF31 5AY, CF31 5DS, CF31 5DT, CF31 5EG, CF31 5EJ, CF31 5FH, CF31 5FT",289,263,26
W00005251,CF31,"CF31 5AA, CF31 5AD, CF31 5AG, CF31 5AH, CF31 5AJ, CF31 5EH",497,457,40
W00009954,CF31,"CF31 5AT, CF31 5AU, CF31 5AZ, CF31 5BE, CF31 5BP, CF31 5BQ, CF31 5BR, CF31 5EY, CF31 5FE",325,295,30
W00005223,CF31,"CF31 2JF, CF31 2JG, CF31 2LA, CF31 2LB",272,241,31
W00009951,CF31,"CF31 5AL, CF31 5AN, CF31 5AQ, CF31 5AS, CF31 5DU, CF31 5DW, CF31 5DY, CF31 5DZ",401,352,49
W00005314,CF31,"CF31 3AQ, CF31 3BF, CF31 3BG, CF31 3BQ, CF31 3DJ, CF31 3DQ, CF31 3DX, CF31 3DY, CF31 3EB, CF31 3EX, CF31 3EZ, CF31 3PH, CF31 3PJ, CF31 3PL, CF31 3PR, CF31 3PT, CF31 3PU, CF31 3PY, CF31 3RA, CF31 3RB, CF31 3RD, CF31 3RE, CF31 3RF, CF31 3RG, CF31 3RH, CF31 3RJ, CF31 3RL, CF31 3RN, CF31 3RP, CF31 3RR, CF31 3RS, CF31 3RT, CF31 3RU, CF31 3RW, CF31 3RX, CF31 3RY, CF31 3RZ, CF31 3SA, CF31 3SB, CF31 3SD, CF31 3SE, CF31 3SF, CF31 3SG, CF31 3SH, CF31 3SL, CF31 3SR, CF31 3SS, CF31 3ST, CF31 3SU, CF31 3SY, CF31 3SZ, CF31 3TA, CF31 3TB, CF31 3TD, CF31 3TE, CF31 3TF, CF31 3TG, CF31 3TH, CF31 3TL, CF31 3TN, CF31 3TP, CF31 3TQ, CF31 3TR, CF31 3TS, CF31 3TT, CF31 3TU, CF31 3TW, CF31 3TX, CF31 3TY, CF31 3TZ, CF31 3UA, CF31 3UB, CF31 3UD, CF31 3UE, CF31 3UF, CF31 3UG, CF31 3UJ, CF31 3UL, CF31 3UN, CF31 3UR, CF31 3US, CF31 3UT, CF31 3UU, CF31 3UW, CF31 3UX, CF31 3UY, CF31 3UZ, CF31 3WD, CF31 3WT, CF31 3XA, CF31 3XB, CF31 3XD, CF31 3XE, CF31 3XF, CF31 3XG, CF31 3XH, CF31 3XJ, CF31 3XQ, CF31 3XR, CF31 3XS, CF31 3XU, CF31 3YE, CF31 3YH, CF31 3YL, CF31 3YN, CF31 3YP, CF31 3YR, CF31 3YS, CF31 3YU, CF31 3YW, CF31 3YX, CF31 3YY, CF31 3ZQ, CF31 3ZR, CF35 5AU, CF35 5EJ, CF35 5EL, CF35 5EN, CF35 5EP, CF35 5ER, CF35 5ES, CF35 5EW, CF35 5EY, CF35 5FB, CF35 5FD, CF35 5FE, CF35 5FF, CF35 5FG, CF35 5NS, CF35 6AA",481,451,30
W00005339,CF31,"CF31 1NH, CF31 1QH, CF31 1QJ, CF31 1QL, CF31 1QP, CF31 1QQ, CF31 1RA, CF31 1RB, CF31 1RD, CF31 1RF, CF32 9SH, CF32 9ST, CF35 6HA, CF35 6HB, CF35 6HD, CF35 6HE, CF35 6HF",549,475,74
W00005340,CF31,"CF31 1QS, CF31 1QU, CF31 1QZ, CF31 1YJ, CF31 1YL",251,228,23
W00005341,CF31,"CF31 1QN, CF31 1QR, CF31 1QW",246,226,20
W00005342,CF31,"CF31 1AY, CF31 1PH, CF31 1PJ, CF31 1QB, CF31 1QD, CF31 1QE, CF31 1QF",269,250,19
W00005343,CF31,"CF31 1PL, CF31 1QA, CF31 1QG",305,283,22
W00005344,CF31,"CF31 1QT, CF31 1QX, CF31 1QY, CF31 1XE, CF31 1XF, CF31 1XG, CF31 1XJ, CF31 1XN, CF31 1XY, CF31 1XZ, CF31 1YD, CF31 1YG, CF31 1YH, CF31 1YQ, CF31 4LE",287,253,34
W00009953,CF31,"CF31 5BZ, CF31 5DH, CF31 5DJ, CF31 5DL, CF31 5DN, CF31 5DP, CF31 5EN",430,398,32
W00005250,CF31,"CF31 4DX, CF31 4EA, CF31 4EE, CF31 4EQ, CF31 4ES, CF31 5AB, CF31 5AE, CF31 5AF, CF31 5AR, CF31 5BF",466,414,52
W00005249,CF31,"CF31 4EP, CF31 4ER, CF31 4EW",224,219,5
W00005248,CF31,"CF31 4DD, CF31 4DG, CF31 4DQ, CF31 4EJ, CF31 4RT",279,272,7
W00005224,CF31,"CF31 2AF, CF31 2HG, CF31 2HT, CF31 2XQ, CF31 2XS, CF31 2XU, CF31 2XW, CF31 2XX, CF31 2YE, CF31 2YN, CF31 2YS, CF31 2YT, CF31 2YW, CF31 2YX, CF31 2YZ",283,264,19
W00005225,CF31,"CF31 2QA, CF31 2QB, CF31 2QD, CF31 2QE",312,271,41
W00005226,CF31,"CF31 2EU, CF31 2EW, CF31 2EX, CF31 2EY",288,266,22
W00005214,CF31,"CF31 2LG, CF31 2LQ",231,214,17
W00005227,CF31,"CF31 2NG, CF31 2NH, CF31 2NP, CF31 2PF",271,240,31
W00005228,CF31,"CF31 2PG, CF31 2PR",219,191,28
W00005229,CF31,"CF31 2JH, CF31 2JJ, CF31 2JQ",243,227,16
W00005230,CF31,"CF31 2DS, CF31 2HA, CF31 2HD, CF31 2HS",289,264,25
W00005221,CF31,"CF31 2BP, CF31 2JZ, CF31 2NA, CF31 2NE, CF31 2NF",261,241,20
W00005220,CF31,"CF31 2PA, CF31 2PB, CF31 2PE",299,272,27
W00005219,CF31,"CF31 2QL, CF31 2QN, CF31 2QR",296,269,27
W00005218,CF31,"CF31 2AB, CF31 2HE, CF31 2HL, CF31 2HX, CF31 2PD",277,252,25
W00005215,CF31,"CF31 2BJ, CF31 2NT, CF31 2NU, CF31 2NW, CF31 2NX",293,279,14
W00005216,CF31,"CF31 2LE, CF31 2LF, CF31 2LP, CF31 2NN",216,206,10
W00005217,CF31,"CF31 2PX, CF31 2PY, CF31 2QP, CF31 2QQ, CF31 2QW",307,274,33
W00009963,CF31,"CF31 5BT, CF31 5BU, CF31 5BW, CF31 5DA, CF31 5DD, CF31 5DF, CF31 5DG, CF31 5EX, CF31 5HA, CF32 0NT",396,348,48
W00009961,CF31,"CF31 2DD, CF31 2DG",405,361,44
W00009960,CF31,"CF31 2DE, CF31 2DH, CF31 2DJ",257,216,41
W00005243,CF31,"CF31 4EB, CF31 4ED, CF31 4EF, CF31 4EG, CF31 4FE",255,238,17
W00005246,CF31,"CF31 4EH, CF31 4EL, CF31 4ET, CF31 4EU, CF31 4EX, CF31 4FA, CF31 4FB, CF31 4FD, CF31 4RH, CF31 4XG",495,451,44
W00005247,CF31,"CF31 4DE, CF31 4DF, CF31 4EN",283,265,18
W00009948,CF31,"CF31 5EP, CF31 5FJ, CF31 5FN, CF31 5FP, CF31 5FR",481,422,59
W00010447,CF31,"CF31 2DF, CF31 2EZ, CF31 2HB, CF31 2HF, CF31 2HJ, CF31 2LL",193,182,11
W00009952,CF31,"CF31 5BS, CF31 5DB, CF31 5DE, CF31 5DR",341,290,51
W00005222,CF31,"CF31 2HU, CF31 2JA, CF31 2JB, CF31 2JY",279,251,28
W00005354,CF31,"CF31 4JT, CF31 4RU, CF31 4RX",200,189,11
W00005353,CF31,"CF31 4JU, CF31 4QL, CF31 4UD, CF31 4UE, CF31 4UF, CF31 4UG, CF31 4UQ",250,234,16
W00005211,CF31,"CF31 2JN, CF31 2JP, CF31 2JW, CF31 2PP",271,261,10
W00005207,CF31,"CF31 1SR, CF31 1SS, CF31 2HR, CF31 2SR, CF31 2SS",259,235,24
W00005206,CF31,"CF31 2LT, CF31 2LU, CF31 2LW, CF31 2LX, CF31 2LY, CF31 2LZ, CF31 2PL",242,224,18
W00005205,CF31,"CF31 2AT, CF31 2DN, CF31 2HH, CF31 2PQ, CF31 2PS, CF31 2ST, CF31 2YB, CF31 2YF, CF31 2YG, CF31 2YH, CF31 2YJ",260,239,21
W00005204,CF31,"CF31 2BE, CF31 2BL, CF31 2BQ, CF31 2BS, CF31 2BT, CF31 2BU",325,293,32
W00005203,CF31,"CF31 2AA, CF31 2AP, CF31 2BY, CF31 2BZ, CF31 2DL",317,297,20
W00005202,CF31,"CF31 2QF, CF31 2QG, CF31 2QH, CF31 2QJ",442,381,61
W00005199,CF31,"CF31 2BH, CF31 2JT, CF31 2JU, CF31 2NB, CF31 2NJ, CF31 2NR",311,285,26
W00005213,CF31,"CF31 2LH, CF31 2LJ, CF31 2ND",355,330,25
W00009968,CF31,"CF31 5EQ, CF31 5FB, CF31 5FD, CF31 5FW",336,305,31
W00009970,CF31,"CF31 2JR, CF31 2PH, CF31 2PN",240,218,22
W00009971,CF31,"CF31 5BX, CF31 5BY, CF31 5EL, CF31 5ER, CF31 5ES, CF31 5ET",393,356,37
W00009972,CF31,"CF31 5EA, CF31 5EB, CF31 5ED, CF31 5EE, CF31 5EF",231,214,17
W00009966,CF31,"CF31 2JD, CF31 2JE, CF31 2JL, CF31 2JS",372,328,44
W00005352,CF31,"CF31 4JX, CF31 4RZ",236,211,25
W00005406,CF31,"CF31 1YR, CF31 1YU, CF31 1YX, CF31 1YY",249,236,13
W00005350,CF31,"CF31 4TR, CF31 4TT, CF31 4TU, CF31 4TX, CF31 4TY, CF31 4TZ, CF31 4UB, CF31 4UL, CF31 4UN",332,315,17
W00005358,CF31,"CF31 4JS, CF31 4QJ, CF31 4RB, CF31 4RY, CF31 4SA, CF31 4SB, CF31 4YB, CF31 4YH, CF31 4YS, CF31 4YW, CF31 4YX",266,241,25
W00009973,CF31,"CF31 5AP, CF31 5DQ, CF31 5FA, CF31 5FG",372,328,44
W00005351,CF31,"CF31 4LF, CF31 4QX, CF31 4QY, CF31 4QZ, CF31 4RA, CF31 4RE, CF31 4TG, CF31 4UA, CF31 4UJ",331,312,19
W00005356,CF31,"CF31 4QF, CF31 4QG",195,188,7
W00005357,CF31,"CF31 4XA, CF31 4XB, CF31 4XD",227,218,9
W00005212,CF31,"CF31 2AU, CF31 2BG, CF31 2EA, CF31 2EB, CF31 2JX, CF31 2NS",345,321,24
W00009975,CF31,"CF31 5BG, CF31 5BH, CF31 5BJ, CF31 5BL, CF31 5BN, CF31 5DX",355,312,43
W00005355,CF31,"CF31 4TH, CF31 4TJ, CF31 4TL, CF31 4TN, CF31 4TP, CF31 4TQ, CF31 4TS, CF31 4TW",334,312,22
W00010360,CF31,"CF31 2HN, CF31 2HP, CF31 2HQ, CF31 2HW, CF31 2HY, CF31 2HZ",338,305,33
W00010451,CF31,"CF31 2ES, CF31 2ET",235,212,23
W00005186,CF32,"CF32 7BE, CF32 7HU, CF32 7HW, CF32 7LL, CF32 7LN, CF32 7LP, CF32 7LR, CF32 7LS, CF32 7LT, CF32 7LU, CF32 7LZ",261,244,17
W00005187,CF32,"CF32 7HY, CF32 7LA, CF32 7LB, CF32 7LD, CF32 7LE, CF32 7LF, CF32 7LG, CF32 7LH, CF32 7LJ, CF32 7LQ, CF32 7LW",508,477,31
W00005188,CF32,"CF32 8RJ, CF35 6DP, CF35 6DR, CF35 6DS, CF35 6DT, CF35 6DU, CF35 6DY, CF35 6EA, CF35 6EB, CF35 6EJ, CF35 6EP, CF35 6EQ, CF35 6ER, CF35 6ES, CF35 6ET, CF35 6EY, CF35 6UD",381,336,45
W00005605,CF32,"CF32 9DB, CF32 9DG, CF32 9DH, CF32 9DL, CF32 9HD, CF32 9HE",495,436,59
W00005193,CF32,"CF32 8AY, CF32 8BG, CF32 8BH, CF32 8BL, CF32 8BN, CF32 8BP, CF32 8BS, CF32 8BW, CF32 8NE",313,285,28
W00005599,CF32,"CF32 9BF, CF32 9BT, CF32 9BU, CF32 9DE, CF32 9DF, CF32 9DP, CF32 9DR, CF32 9DS, CF32 9DW",314,280,34
W00005196,CF32,"CF32 8AB, CF32 8AG, CF32 8AN, CF32 8AP, CF32 8AR, CF32 8AW",310,291,19
W00005601,CF32,"CF32 9EU, CF32 9EY, CF32 9JZ, CF32 9QE, CF32 9XD, CF32 9XE, CF32 9XF, CF32 9XH, CF32 9XL, CF32 9XR, CF32 9XW",232,209,23
W00005604,CF32,"CF32 9HB, CF32 9HH, CF32 9HP, CF32 9HQ",234,221,13
W00005603,CF32,"CF32 9HG, CF32 9HL, CF32 9HN, CF32 9HR, CF32 9HS, CF32 9HW, CF32 9LG",355,311,44
W00005600,CF32,"CF32 9BS, CF32 9DY, CF32 9EA, CF32 9EH, CF32 9EN, CF32 9ES, CF32 9ET, CF32 9EW, CF32 9FB, CF32 9FE, CF32 9LT",262,253,9
W00005194,CF32,"CF32 8AH, CF32 8AL, CF32 8AS, CF32 8AT",315,283,32
W00005195,CF32,"CF32 8ND, CF32 8NF, CF32 8NG, CF32 8NH, CF32 8NL",267,228,39
W00005531,CF32,"CF32 8LP, CF32 8LR, CF32 8LS, CF32 8NA, CF32 8NB, CF32 8NQ",317,266,51
W00010614,CF32,"CF32 0QB, CF32 0QD, CF32 0QE, CF32 0QF",327,277,50
W00005174,CF32,"CF32 9AA, CF32 9AB, CF32 9AD, CF32 9AE, CF32 9AF, CF32 9AL, CF32 9DA",309,274,35
W00005173,CF32,"CF32 0BP, CF32 0BQ, CF32 0BS, CF32 0BU, CF32 0DH, CF32 0DL, CF32 0DN, CF32 0DP, CF32 0DR, CF32 0DW, CF32 0DY, CF32 0EA, CF32 0EF, CF32 0EG, CF32 0EH, CF32 0EL, CF32 0EP, CF32 8YR, CF32 8YS, CF32 8YU, CF32 8YX, CF32 8YY, CF32 8YZ, CF32 8ZB, CF32 9DN, CF32 9HA, CF32 9HF",242,211,31
W00005172,CF32,"CF32 0DS, CF32 0DT, CF32 0DU, CF32 0EB, CF32 0ED, CF32 0EE",217,196,21
W00005594,CF32,"CF32 9NY, CF32 9PA, CF32 9TY, CF32 9UA, CF32 9UD, CF32 9UF, CF32 9XP",298,275,23
W00005953,CF32,"CF32 0PN, CF32 0PP, CF32 0PR, CF32 0PS, CF32 0PT, CF32 0PU, CF32 0PZ",350,311,39
W00005952,CF32,"CF32 0PA, CF32 0PY, CF32 0QP, CF32 0RL, CF32 0RN, CF32 0RP, CF32 0RR, CF32 0RT, CF32 0RW, CF32 0SF, CF32 0SN, CF32 0TD, CF32 0TE, CF32 0TF, CF35 5AN, CF35 5BS",275,236,39
W00005951,CF32,"CF32 0SA, CF32 0SB, CF32 0SE, CF32 0SP, CF32 0SU, CF32 0SW, CF32 0SY, CF32 0SZ, CF32 0TA, CF32 0TG, CF32 0TH, CF32 0TL, CF32 0TN, CF32 0YT, CF32 0YU, CF32 0YW",357,310,47
W00005529,CF32,"CF32 8AZ, CF32 8DE, CF32 8DF, CF32 8DG, CF32 8DH, CF32 8DL, CF32 8DN, CF32 8EA, CF32 8ES",269,233,36
W00005593,CF32,"CF32 9NB, CF32 9NG, CF32 9NH, CF32 9NL, CF32 9NN, CF32 9RG, CF32 9RH, CF32 9RL",294,263,31
W00005592,CF32,"CF32 9NP, CF32 9NR, CF32 9NS, CF32 9NT, CF32 9NW, CF32 9PB, CF32 9PF, CF32 9QF, CF32 9RS",304,289,15
W00005591,CF32,"CF32 9QA, CF32 9QB, CF32 9RN, CF32 9RP, CF32 9RR, CF32 9RZ, CF32 9SD, CF32 9SE, CF32 9SL",337,300,37
W00005590,CF32,"CF32 9SN, CF32 9SU, CF32 9SY, CF32 9UG, CF32 9UH, CF32 9UP, CF32 9UW",284,263,21
W00005589,CF32,"CF32 9RT, CF32 9RU, CF32 9RY, CF32 9SA, CF32 9SB, CF32 9SF, CF32 9SG, CF32 9UE",258,242,16
W00005530,CF32,"CF32 8DP, CF32 8DQ, CF32 8DR, CF32 8DS, CF32 8DT, CF32 8DU, CF32 8DW, CF32 8DY",290,265,25
W00005588,CF32,"CF32 9TU, CF32 9UL, CF32 9UN, CF32 9UR, CF32 9UT, CF32 9UU, CF32 9UY",268,252,16
W00005176,CF32,"CF32 9BD, CF32 9BN, CF32 9BW, CF32 9DD, CF32 9PL, CF32 9PP, CF32 9PR, CF32 9PS, CF32 9PU, CF32 9RF, CF32 9TF",299,273,26
W00005598,CF32,"CF32 9EF, CF32 9EG, CF32 9EP, CF32 9EQ, CF32 9ER",319,288,31
W00005177,CF32,"CF32 9BP, CF32 9BQ, CF32 9GP, CF32 9HZ, CF32 9PY, CF32 9RA, CF32 9RB, CF32 9RD, CF32 9RE",299,279,20
W00005179,CF32,"CF32 8TB, CF32 8TE, CF32 8TH, CF32 8TJ, CF32 8TN, CF32 8TR, CF32 8TW, CF32 8TZ, CF32 8UN, CF32 8UP, CF32 8UR, CF32 8UW, CF32 8YD, CF32 8YE, CF32 8YF, CF32 8YH, CF32 8YQ, CF32 8YW",271,264,7
W00005184,CF32,"CF32 8SY, CF32 8TA, CF32 8TD, CF32 8TF, CF32 8TG, CF32 8TL, CF32 8TP, CF32 8TS, CF32 8TT",357,319,38
W00005596,CF32,"CF32 9AQ, CF32 9FD, CF32 9HT, CF32 9LS, CF32 9LU",290,263,27
W00005595,CF32,"CF32 9ND, CF32 9NE, CF32 9NF, CF32 9PD, CF32 9PE, CF32 9PG, CF32 9RW",273,258,15
W00005524,CF32,"CF32 8LT, CF32 8LU, CF32 8LW, CF32 8LY, CF32 8NN, CF32 8NW",338,292,46
W00005525,CF32,"CF32 8DA, CF32 8DB, CF32 8DD, CF32 8ED, CF32 8EG, CF32 8EH, CF32 8ER, CF32 8HA, CF32 8HG, CF32 8HL, CF32 8LL",248,219,29
W00005526,CF32,"CF32 8HB, CF32 8HE, CF32 8HN, CF32 8LQ",289,260,29
W00005527,CF32,"CF32 8EB, CF32 8EE, CF32 8EF, CF32 8EL, CF32 8EN, CF32 8EP, CF32 8EW, CF32 8HD, CF32 8HP, CF32 8HR, CF32 8HS, CF32 8HU, CF32 8LE, CF32 8LF, CF32 8LN, CF32 8NP",320,280,40
W00005958,CF32,"CF32 0RS, CF7 7PZ, CF7 7QA, CF7 7QB, CF7 7QD, CF7 7QE, CF7 7QF, CF7 7QG, CF71 7PZ, CF71 7QA, CF71 7QB, CF71 7QD, CF71 7QE, CF71 7QF, CF71 7QG, CF71 7QW, CF71 7QX",488,440,48
W00005528,CF32,"CF32 8HF, CF32 8HT, CF32 8HW, CF32 8HY, CF32 8LA, CF32 8LB, CF32 8LD",282,240,42
W00005956,CF32,"CF32 0SD, CF32 0SG, CF32 0SH, CF32 0SJ, CF32 0SL, CF32 0TB, CF32 0TJ",381,330,51
W00005954,CF32,"CF32 0PD, CF32 0PF, CF32 0PG, CF32 0PH, CF32 0PJ, CF32 0PX, CF32 0QA",358,325,33
W00005183,CF32,"CF32 8RL, CF32 8RN, CF32 8RP, CF32 8RS, CF32 8RT, CF32 8RU, CF32 8SP",392,370,22
W00005182,CF32,"CF32 8SB, CF32 8SD, CF32 8SE, CF32 8ST, CF32 8UL",321,302,19
W00005181,CF32,"CF32 8RQ, CF32 8RR, CF32 8RY, CF32 8SA, CF32 8SF, CF32 8SG",402,373,29
W00005180,CF32,"CF32 8RE, CF32 8RW, CF32 8SR, CF32 8SS, CF32 8SU, CF32 8SW, CF32 8TU, CF32 8TY, CF32 8UA, CF32 8UB, CF32 8UD, CF32 8UE, CF32 8UJ",419,384,35
W00005178,CF32,"CF32 0EN, CF32 0EW, CF32 0HD, CF32 9AG, CF32 9AH, CF32 9AN, CF32 9AP, CF32 9AR, CF32 9AS, CF32 9AT, CF32 9AW, CF32 9BA, CF32 9BY",275,258,17
W00005597,CF32,"CF32 9DQ, CF32 9DT, CF32 9DU, CF32 9EB, CF32 9ED, CF32 9EE",356,324,32
W00010364,CF32,"CF32 7AJ, CF32 7AX, CF32 7BT, CF32 7BU, CF32 7BW, CF32 7EH, CF32 7EL, CF32 7EN, CF32 7EP, CF32 7ER, CF32 7EW, CF32 7YA, CF32 7YB, CF32 7YE, CF32 7YF",318,299,19
W00005232,CF32,"CF32 9FA, CF32 9NZ, CF32 9PN, CF32 9QD, CF32 9XG, CF32 9XX, CF32 9XY, CF32 9YH, CF32 9YL, CF32 9YN, CF32 9YP, CF32 9YR, CF32 9YS, CF32 9YT, CF32 9YU, CF32 9YW",460,405,55
W00005474,CF32,"CF32 7AD, CF32 7AE, CF32 7AF, CF32 7AR, CF32 7AS, CF32 7AT, CF32 7AU, CF32 7AY",245,229,16
W00005473,CF32,"CF32 7AA, CF32 7AB, CF32 7DA, CF32 7DB, CF32 7DE, CF32 7DF, CF32 7DG, CF32 7DU, CF32 7EA",292,268,24
W00005472,CF32,"CF32 7AG, CF32 7BA, CF32 7BD, CF32 7DH, CF32 7DY, CF32 7EB",292,272,20
W00005452,CF32,"CF32 0NF, CF32 0NG, CF32 0NH, CF32 0NL, CF32 0NY, CF36 5RF, CF36 5RG, CF36 5RH, CF36 5SP, CF36 5SQ, CF36 5SR, CF36 5SS, CF36 5ST, CF36 5SU, CF36 5SY",329,312,17
W00005231,CF32,"CF32 9JP, CF32 9YE, CF32 9YF",208,194,14
W00005346,CF32,"CF32 8FD, CF32 8PP, CF32 8PR, CF32 8PS, CF32 8PW",302,276,26
W00010423,CF32,"CF32 9BZ, CF32 9GA, CF32 9GB, CF32 9GD, CF32 9GE, CF32 9GJ, CF32 9GN",379,330,49
W00005347,CF32,"CF32 8NT, CF32 8PT, CF32 8PU, CF32 8PY, CF32 8RA, CF32 8RB, CF32 8RD, CF32 8UT, CF32 8UU, CF32 8YA, CF35 6UE, CF35 6UF",375,341,34
W00005348,CF32,"CF32 8AJ, CF32 8AX, CF32 8BJ, CF32 8BX, CF32 8BZ, CF32 8LX, CF32 8PJ, CF32 8PX, CF32 8QA",221,191,30
W00005349,CF32,"CF32 8DJ, CF32 8DX, CF32 8EJ, CF32 8EX, CF32 8HH, CF32 8HJ, CF32 8HX, CF32 8HZ, CF32 8LJ, CF32 8NU, CF32 8NY, CF32 8PA, CF32 8PB, CF32 8PD, CF32 8PE, CF32 8PF, CF32 8PG, CF32 8PH, CF32 8PL, CF32 8PN, CF32 8RX, CF32 8UG, CF32 8UH, CF34 0EB",313,280,33
W00010422,CF32,"CF32 9EZ, CF32 9GF, CF32 9GH",251,216,35
W00005429,CF32,"CF32 7NH, CF32 7NJ, CF32 7NL, CF32 7NN, CF32 7NP, CF32 7NR, CF32 7NS, CF32 7NT, CF32 7NU, CF32 7NW, CF32 7NX, CF32 7NY",337,313,24
W00005428,CF32,"CF32 7RD, CF32 7RE, CF32 7RF, CF32 7RG, CF32 7RH, CF32 7RJ, CF32 7RL, CF32 7RN, CF32 7RW",284,260,24
W00005427,CF32,"CF32 7PA, CF32 7PB, CF32 7PD, CF32 7PE, CF32 7RA, CF32 7RB, CF32 7RP, CF32 7RR",282,265,17
W00005426,CF32,"CF32 7SS, CF32 7SU, CF32 7SY",329,299,30
W00010415,CF32,"CF32 9AJ, CF32 9AX, CF32 9AZ, CF32 9BJ, CF32 9TB, CF32 9TG, CF32 9TH, CF32 9TL, CF32 9TN, CF32 9TW, CF32 9YA, CF32 9YB, CF32 9YD, CF32 9YX",309,276,33
W00010399,CF32,"CF32 9BX, CF32 9GG, CF32 9LJ, CF32 9LX",289,266,23
W00005425,CF32,"CF32 7PL, CF32 7SB, CF32 7SF, CF32 7SH, CF32 7SJ, CF32 7SN, CF32 7SP, CF32 7SR, CF32 7ST, CF32 7SW",275,251,24
W00005424,CF32,"CF32 7NA, CF32 7ND, CF32 7PW, CF32 7SA, CF32 7SD, CF32 7SE, CF32 7SG, CF32 7TA, CF32 7TB, CF32 7TD, CF32 7YD",302,286,16
W00005423,CF32,"CF32 7EY, CF32 7NB, CF32 7PN, CF32 7PP, CF32 7PR, CF32 7PS, CF32 7PT",289,273,16
W00005422,CF32,"CF32 7NE, CF32 7NF, CF32 7NG, CF32 7PQ, CF32 7PU, CF32 7PY",201,192,9
W00005198,CF32,"CF32 8AA, CF32 8AD, CF32 8AE, CF32 8AF",281,257,24
W00005197,CF32,"CF32 8AQ, CF32 8AU, CF32 8BA, CF32 8BB, CF32 8BD, CF32 8BE, CF32 8BF, CF32 8BQ",240,222,18
W00010387,CF32,"CF32 9AU, CF32 9AY, CF32 9BB, CF32 9BE, CF32 9BG, CF32 9BH, CF32 9BL",284,267,17
W00010381,CF32,"CF32 8XA, CF32 9HU, CF32 9HY, CF32 9LA, CF32 9LB, CF32 9LD, CF32 9LE, CF32 9LF, CF32 9LL, CF32 9LY",335,302,33
W00010571,CF32,"CF32 0PB, CF32 0PE, CF32 0PL, CF32 0PQ, CF32 0PW, CF32 0QG, CF32 0QL, CF32 0QN, CF32 0RH",279,241,38
W00005361,CF32,"CF32 8UF, CF34 0DT, CF34 0DU, CF34 0DY, CF34 0EA, CF34 9HW, CF34 9RN, CF34 9RP, CF34 9RR, CF34 9RS, CF34 9RT, CF34 9RU, CF34 9RW, CF34 9RY, CF34 9SA, CF34 9SB, CF34 9SD, CF34 9SE, CF34 9SF",191,165,26
W00005475,CF32,"CF32 7DP, CF32 7DR, CF32 7DS, CF32 7DT, CF32 7DW",325,295,30
W00005476,CF32,"CF32 7AH, CF32 7AL, CF32 7AN, CF32 7AP, CF32 7AW, CF32 7HR, CF32 7HS, CF32 7HT",242,229,13
W00005233,CF32,"CF32 9LQ, CF32 9LZ, CF32 9RQ, CF32 9SQ, CF32 9SZ, CF32 9TD, CF32 9TQ, CF32 9TX, CF32 9TZ, CF32 9YY, CF32 9YZ, CF32 9ZH",254,219,35
W00005478,CF32,"CF32 7AQ, CF32 7ET, CF32 7EU, CF32 7HD, CF32 7SL",321,304,17
W00005283,CF32,"CF32 0AA, CF32 0AD, CF32 0AF, CF32 0AJ, CF32 0DB, CF32 0DE, CF32 0EY",304,288,16
W00005282,CF32,"CF32 0AL, CF32 0AP, CF32 0AR, CF32 0AS, CF32 0AT, CF32 0BN",248,224,24
W00005284,CF32,"CF32 0AB, CF32 0AE, CF32 0AG, CF32 0AH, CF32 0AN, CF32 0AU, CF32 0AW, CF32 0BJ",278,250,28
W00005281,CF32,"CF32 0BG, CF32 0BH, CF32 0BL, CF32 0BX, CF32 0DD",291,272,19
W00005280,CF32,"CF32 0BT, CF32 0BW, CF32 0BY, CF32 0DA, CF32 0EU, CF32 0HA, CF32 0HB",151,135,16
W00005279,CF32,"CF32 0AQ, CF32 0AY, CF32 0BA, CF32 0BB, CF32 0BD, CF32 0BE, CF33 4AB",227,213,14
W00005477,CF32,"CF32 7BB, CF32 7DL, CF32 7DN",305,287,18
W00005253,CF32,"CF32 0HH, CF32 0HL, CF32 0HN, CF32 0HP, CF32 0HQ, CF32 0HW, CF32 0LG",257,228,29
W00005252,CF32,"CF32 0HR, CF32 0HS, CF32 0LD, CF32 0LE, CF32 0LF, CF32 0LH, CF32 0LL, CF32 0LN, CF32 0LU",228,198,30
W00005241,CF32,"CF32 9HJ, CF32 9PZ, CF32 9SR, CF32 9SS, CF32 9SW",257,238,19
W00005240,CF32,"CF32 9DJ, CF32 9DZ, CF32 9NX, CF32 9SJ, CF32 9SX, CF32 9TA, CF32 9TE, CF32 9TJ, CF32 9TP, CF32 9TR, CF32 9TS, CF32 9TT",243,232,11
W00005254,CF32,"CF32 0ET, CF32 0HE, CF32 0HF, CF32 0HG, CF32 0HT, CF32 0HU, CF32 0HY, CF32 0LA, CF32 0LB, CF32 0NB, CF32 0NR",297,260,37
W00005482,CF32,"CF32 7BH, CF32 7BL, CF32 7BN, CF32 7BP, CF32 7BS, CF32 7BY, CF32 7DD, CF32 7DJ, CF32 7HP",309,283,26
W00005479,CF32,"CF32 7EQ, CF32 7ES, CF32 7EX, CF32 7HA, CF32 7HB, CF32 7HE, CF32 7HF, CF32 7HG, CF32 7HH",352,306,46
W00005237,CF32,"CF32 9EL, CF32 9NQ, CF32 9PH, CF32 9PJ, CF32 9PQ, CF32 9PX, CF32 9UB",382,356,26
W00005236,CF32,"CF32 9DX, CF32 9EJ, CF32 9EX, CF32 9NJ, CF32 9RX",358,336,22
W00005235,CF32,"CF32 9GL, CF32 9JJ, CF32 9JL, CF32 9LP, CF32 9LR, CF32 9LW, CF32 9NA, CF32 9PT, CF32 9US, CF32 9YG",535,463,72
W00005234,CF32,"CF32 9JA, CF32 9JB, CF32 9JD, CF32 9JE, CF32 9JF, CF32 9UJ, CF32 9UX, CF32 9YJ, CF35 6BU, CF35 6DN, CF35 6DW",160,134,26
W00010367,CF32,"CF32 8UY, CF32 8YB, CF32 8YG, CF32 9LH, CF32 9LN",324,285,39
W00005239,CF32,"CF32 9HX, CF32 9NU, CF32 9RJ, CF32 9SP, CF32 9UQ",245,231,14
W00005570,CF33,"CF33 6BN, CF33 6BP, CF33 6BX, CF33 6FJ, CF33 6NN, CF33 6NP, CF33 6NR, CF33 6NS",293,262,31
W00005571,CF33,"CF33 6AG, CF33 6AL, CF33 6AN, CF33 6AR",304,275,29
W00005572,CF33,"CF33 6AH, CF33 6AP, CF33 6AS, CF33 6AT, CF33 6AU, CF33 6AW",337,308,29
W00005573,CF33,"CF33 6AJ, CF33 6AX, CF33 6EJ, CF33 6EN, CF33 6EP, CF33 6EQ, CF33 6EW, CF33 6FH",402,374,28
W00005574,CF33,"CF33 6HE, CF33 6HY, CF33 6LA, CF33 6LB, CF33 6LD, CF33 6LT",223,210,13
W00005575,CF33,"CF33 6EF, CF33 6EG, CF33 6EH, CF33 6FA, CF33 6HL, CF33 6PY",413,368,45
W00005576,CF33,"CF33 6AZ, CF33 6DP, CF33 6ED, CF33 6EE, CF33 6EL, CF33 6FB, CF33 6GB",385,352,33
W00009962,CF33,"CF33 4DU, CF33 4PF, CF33 4PX, CF33 4PY, CF33 4QA, CF33 4QB, CF33 4QD",250,229,21
W00005578,CF33,"CF33 6BF, CF33 6DH, CF33 6DN, CF33 6DR, CF33 6DW, CF33 6EA, CF33 6EX, CF33 6FE, CF33 6FG",335,309,26
W00009934,CF33,"CF33 6PT, SA13 2BH, SA13 2SZ, SA13 2TP, SA13 2TX, SA13 2TZ",330,299,31
W00009944,CF33,"CF33 6PU, CF33 6RA, CF33 6RE, SA13 2TQ, SA13 2XX, SA13 2XY",275,235,40
W00005579,CF33,"CF33 6DL, CF33 6ES, CF33 6ET, CF33 6TR",283,266,17
W00009943,CF33,"CF33 6RB, CF33 6RD, SA13 2TL, SA13 2TN, SA13 2TR, SA13 2TS, SA13 2UQ, SA13 2UZ",320,278,42
W00009965,CF33,"CF33 4LL, CF33 4LW, CF33 4NF, CF33 4PB, CF33 4PD",271,243,28
W00009964,CF33,"CF33 4NZ, CF33 4PZ",354,320,34
W00005577,CF33,"CF33 6DT, CF33 6DU, CF33 6ER",280,251,29
W00005569,CF33,"CF33 6AY, CF33 6BA, CF33 6BD, CF33 6BE",292,268,24
W00005567,CF33,"CF33 6AA, CF33 6AB, CF33 6AD, CF33 6AE, CF33 6AF, CF33 6BH, CF33 6BJ, CF33 6BQ, CF33 6BS, CF33 6BT, CF33 6BZ, CF33 6HS, CF33 6NA, CF33 6ND, CF33 6NU, CF33 6NY, CF33 6PA, CF33 6PB, CF33 6PD, CF33 6PE, CF33 6PG, CF33 6PH, CF33 6PL, CF33 6PP",327,289,38
W00005566,CF33,"CF33 6BY, CF33 6NG, CF33 6NH, CF33 6NL, CF33 6NT, CF33 6NW, CF33 6YD",303,273,30
W00005298,CF33,"CF33 4HN, CF33 4HQ, CF33 4HR, CF33 4HS, CF33 4LY, CF33 4NA",261,230,31
W00005297,CF33,"CF33 4DF, CF33 4DG, CF33 4DH, CF33 4PG, CF33 4PH, CF33 4PL, CF33 4PN, CF33 4PP",282,249,33
W00005470,CF33,"CF33 4RB, CF33 4RD, CF33 4RP, CF33 4RR, CF36 3EJ, CF36 3NE, CF36 3NR, CF36 3PF, CF36 3SR, CF36 3ST, CF36 3SY, CF36 3TA, CF36 3TB, CF36 3TE, CF36 3TF, CF36 3TG, CF36 3TH, CF36 5EJ, CF36 5TA, CF36 5TB",260,235,25
W00005296,CF33,"CF33 4AA, CF33 4AG, CF33 4AH, CF33 4RE, CF33 4RF, CF33 4RG, CF33 4RH, CF33 4RJ, CF33 4RL, CF33 4RN, CF33 4RQ, CF33 4RW, CF33 4RX, CF33 4RY, CF33 4RZ, CF33 4SA, CF33 4SB, CF33 4SE, CF33 4SG",390,356,34
W00005299,CF33,"CF33 4DL, CF33 4DP, CF33 4DQ, CF33 4DT, CF33 4DW",290,264,26
W00005300,CF33,"CF33 4LA, CF33 4LT, CF33 4LU",158,150,8
W00005301,CF33,"CF33 4DE, CF33 4DR, CF33 4DS, CF33 4LG, CF33 4LP",252,223,29
W00005302,CF33,"CF33 4AT, CF33 4AU, CF33 4BD, CF33 4LR",258,241,17
W00005303,CF33,"CF33 4HB, CF33 4HH, CF33 4HJ, CF33 4HL, CF33 4HT, CF33 4HU, CF33 4HW, CF33 4HX, CF33 4HZ, CF33 4NT, CF33 4NX, CF33 4NY",371,329,42
W00005304,CF33,"CF33 4AP, CF33 4AS, CF33 4AY, CF33 4BA, CF33 4BB, CF33 4BN, CF33 4DN, CF33 4HY, CF33 4LE, CF33 4LF",303,266,37
W00005305,CF33,"CF33 4AR, CF33 4BE, CF33 4BG, CF33 4BL",284,261,23
W00005306,CF33,"CF33 4EL, CF33 4EN, CF33 4EP, CF33 4ER, CF33 4ET, CF33 4EW, CF33 4HA",254,228,26
W00004958,CF33,"CF33 6PS, CF33 6RL, SA13 2NP, SA13 2NR, SA13 2NS, SA13 2NT, SA13 2NU, SA13 2NW, SA13 2NY, SA13 2PA, SA13 2PB, SA13 2PD, SA13 2PE, SA13 2PF, SA13 2PG, SA13 2PH, SA13 2PL, SA13 2PN, SA13 2PP, SA13 2PQ, SA13 2PR, SA13 2PS, SA13 2PU, SA13 2PW, SA13 2SU, SA13 2SY, SA13 2TA, SA13 2TB, SA13 2TD, SA13 2TF, SA13 2TG, SA13 2TH, SA13 2TJ, SA13 2TW, SA13 2UA",374,349,25
W00005307,CF33,"CF33 4AD, CF33 4AW, CF33 4AX, CF33 4BH, CF33 4BP, CF33 4BW, CF33 4ES, CF33 4EU, CF33 4EY",435,382,53
W00005309,CF33,"CF33 4DA, CF33 4DB, CF33 4DD, CF33 4LB, CF33 4LD, CF33 4LH, CF33 4LN, CF33 4YA, CF33 4YD",273,259,14
W00005310,CF33,"CF33 4NB, CF33 4NG, CF33 4NL, CF33 4NP, CF33 4PA, CF33 4PE",334,311,23
W00005311,CF33,"CF33 4NR, CF33 4NU, CF33 4NW, CF33 4QE",327,307,20
W00005565,CF33,"CF33 6AQ, CF33 6DQ, CF33 6DX, CF33 6DZ, CF33 6EZ, CF33 6GA",285,262,23
W00005564,CF33,"CF33 6BL, CF33 6DS, CF33 6EB, CF33 6FF, CF33 6HN, CF33 6HP",206,195,11
W00005563,CF33,"CF33 6DG, CF33 6DJ, CF33 6DY",201,196,5
W00005562,CF33,"CF33 6BU, CF33 6DA, CF33 6LL, CF33 6LN",276,251,25
W00005561,CF33,"CF33 6DB, CF33 6DD, CF33 6DE, CF33 6DF, CF33 6FD",354,328,26
W00005560,CF33,"CF33 6BB, CF33 6BG, CF33 6JG, CF33 6LP, CF33 6LR",325,298,27
W00005568,CF33,"CF33 6NB, CF33 6NE, CF33 6NF, CF33 6PF, CF33 6RP, CF33 6RX, CF33 6WA",302,280,22
W00005559,CF33,"CF33 6HT, CF33 6HW, CF33 6LS",194,184,10
W00005557,CF33,"CF33 6EU, CF33 6EY, CF33 6HA, CF33 6HB, CF33 6HD, CF33 6HF, CF33 6HG, CF33 6HH, CF33 6YA, CF33 6YG, CF33 6YN, CF33 6YQ, CF33 6YR, CF33 6YS, CF33 6YT",293,270,23
W00005556,CF33,"CF33 6HR, CF33 6JA, CF33 6JB, CF33 6JD, CF33 6JE, CF33 6JF, CF33 6JH",225,207,18
W00005294,CF33,"CF33 4PR, CF33 4PS, CF33 4PT, CF33 4PU, CF33 4PW, CF33 4RA, CF33 4SD, CF33 4SF, CF33 4YF, CF33 4ZR, CF36 3EX, CF36 3PJ",275,253,22
W00009957,CF33,"CF33 4DJ, CF33 4PJ, CF33 4PQ",285,255,30
W00005313,CF33,"CF33 4AJ, CF33 4AL, CF33 4AN, CF33 4AQ, CF33 4EG, CF33 4HE, CF33 4NS",517,475,42
W00005295,CF33,"CF33 4EA, CF33 4EB, CF33 4ED, CF33 4EE, CF33 4EF, CF33 4EH, CF33 4HD, CF33 4HP",354,321,33
W00005558,CF33,"CF33 6HU, CF33 6LE, CF33 6LF, CF33 6LG, CF33 6LH, CF33 6LW",306,280,26
W00005312,CF33,"CF33 4ND, CF33 4NE, CF33 4NH, CF33 4NN",359,326,33
W00005364,CF34,"CF34 9HH, CF34 9HN, CF34 9HP, CF34 9LA, CF34 9LB",257,238,19
W00005375,CF34,"CF34 0AB, CF34 0LQ, CF34 0XB, CF34 0XF, CF34 0XG, CF34 0XJ, CF34 0XL, CF34 0XN, CF34 0XP, CF34 4AA, CF34 4AB, CF34 4AD, CF34 4AE, CF34 4AF, CF34 4AG, CF34 4AH, CF34 4AJ, CF34 4AL, CF34 4AN, CF34 4AP, CF34 9AA, CF34 9AB, CF34 9BL, CF34 9BN, CF34 9BP, CF34 9BS, CF34 9BW, CF34 9BY, CF34 9BZ, CF34 9DA, CF34 9TU, CF34 9UL, CF34 9UN, CF34 9UP, CF34 9UR, CF34 9UT, CF34 9UU, CF34 9UY, CF34 9WD, CF34 9WR, CF34 9WZ, CF34 9XA, CF34 9XD, CF34 9XE, CF34 9XF, CF34 9XZ, CF34 9YD, CF34 9YZ, CF34 9ZA, CF34 9ZB, CF34 9ZZ",257,228,29
W00005390,CF34,"CF34 9AD, CF34 9AL, CF34 9DE, CF34 9DF, CF34 9DH, CF34 9DL, CF34 9DP, CF34 9DW, CF34 9HJ",201,181,20
W00005389,CF34,"CF34 9BT, CF34 9BU, CF34 9DB, CF34 9DD, CF34 9EB, CF34 9EE, CF34 9EF, CF34 9EW, CF34 9PB, CF34 9PD",268,228,40
W00005388,CF34,"CF34 0AY, CF34 9DS, CF34 9DT, CF34 9DU, CF34 9DY, CF34 9EA, CF34 9ED, CF34 9UW",285,235,50
W00005396,CF34,"CF34 9AN, CF34 9AQ, CF34 9AR, CF34 9BD",247,199,48
W00005387,CF34,"CF34 9ER, CF34 9PE, CF34 9PF, CF34 9PG, CF34 9PH, CF34 9PL, CF34 9PP, CF34 9PW, CF34 9PZ, CF34 9RF",275,236,39
W00005386,CF34,"CF34 9AS, CF34 9AT, CF34 9AU, CF34 9BA, CF34 9BB",285,243,42
W00005385,CF34,"CF34 0BF, CF34 0DB, CF34 0DD, CF34 0NE, CF34 0NF, CF34 9GX, CF34 9HY",281,258,23
W00005391,CF34,"CF34 9AY, CF34 9AZ, CF34 9DJ, CF34 9DX, CF34 9EJ, CF34 9EX, CF34 9LJ, CF34 9LX, CF34 9PJ, CF34 9PX, CF34 9TP",266,243,23
W00005384,CF34,"CF34 0JD, CF34 0NG, CF34 0TJ, CF34 0UJ, CF34 0YJ, CF34 0YT, CF34 0YU",243,225,18
W00005382,CF34,"CF34 0HJ, CF34 0NJ, CF34 0NX, CF34 0PJ, CF34 0PX, CF34 0RJ, CF34 0SJ",283,264,19
W00005381,CF34,"CF34 0EJ, CF34 0LR, CF34 0LS, CF34 0LU",311,260,51
W00005380,CF34,"CF34 0NL, CF34 0NN, CF34 0NW",255,233,22
W00005397,CF34,"CF34 9UA, CF34 9UB",236,219,17
W00005379,CF34,"CF34 0BJ, CF34 0DJ, CF34 0LJ, CF34 0LP, CF34 0LT, CF34 0LX",284,238,46
W00005378,CF34,"CF34 9YP, CF34 9YR, CF34 9YS, CF34 9YT, CF34 9YU, CF34 9YY",258,238,20
W00005377,CF34,"CF34 9AJ, CF34 9AX, CF34 9YH, CF34 9YL, CF34 9YN, CF34 9YQ, CF34 9YW",262,236,26
W00005383,CF34,"CF34 0HX, CF34 0JB, CF34 0LY, CF34 0NA, CF34 0NB, CF34 0ND, CF34 0RX",312,283,29
W00005376,CF34,"CF34 0AA, CF34 0AD, CF34 0AE, CF34 0AJ, CF34 0AX, CF34 0AZ, CF34 0BA, CF34 0LG",290,265,25
W00005395,CF34,"CF34 9AG, CF34 9AH",254,213,41
W00005393,CF34,"CF34 9BF, CF34 9ES, CF34 9ET, CF34 9TR, CF34 9TS, CF34 9TT, CF34 9TY",284,258,26
W00005276,CF34,"CF34 0SD, CF34 0SG, CF34 0SU, CF34 0SZ, CF34 0UA",232,211,21
W00005275,CF34,"CF34 0PU, CF34 0RN, CF34 0RP, CF34 0RW, CF34 0ST",255,235,20
W00005274,CF34,"CF34 0PA, CF34 0PY, CF34 0RA, CF34 0RB, CF34 0RD",275,257,18
W00005273,CF34,"CF34 0SP, CF34 0SS, CF34 0SW, CF34 0YL",251,234,17
W00005272,CF34,"CF34 0PB, CF34 0PD, CF34 0PR, CF34 0PS",275,260,15
W00005271,CF34,"CF34 0PT, CF34 0UW, CF34 0UY, CF34 0WZ, CF34 0YN, CF34 0YR, CF34 0YS",275,255,20
W00005270,CF34,"CF34 0AQ, CF34 0DW, CF34 0RE, CF34 0RF, CF34 0RG, CF34 0TL, CF34 0TN, CF34 0TP, CF34 0TR, CF34 0TS, CF34 0TT, CF34 0TU, CF34 0TW, CF34 0TY, CF34 0UB, CF34 0UG, CF34 0UL",297,278,19
W00005394,CF34,"CF34 9AE, CF34 9AF, CF34 9DN, CF34 9PA",283,256,27
W00005269,CF34,"CF34 0PE, CF34 0PG, CF34 0PL, CF34 0PN, CF34 0PW, CF34 0UE",251,240,11
W00005267,CF34,"CF34 0PF, CF34 0PP, CF34 0RR, CF34 0RT, CF34 0UD, CF34 0UF, CF34 0UH",257,245,12
W00005266,CF34,"CF34 0SB, CF34 0SH, CF34 0SL, CF34 0SN, CF34 0SQ, CF34 0SR",253,229,24
W00005265,CF34,"CF34 0YA, CF34 0YB, CF34 0YD, CF34 0YF, CF34 0YG, CF34 0YH",389,353,36
W00005264,CF34,"CF34 0PH, CF34 0RS, CF34 0UP, CF34 0UR, CF34 0UT, CF34 0YE",212,201,11
W00005263,CF34,"CF34 0BL, CF34 0BN, CF34 0BS",285,266,19
W00005262,CF34,"CF34 0EP, CF34 0ER, CF34 0ET, CF34 0EW, CF34 0EY, CF34 0LA",289,249,40
W00005392,CF34,"CF34 9DZ, CF34 9EG, CF34 9EH, CF34 9EL, CF34 9EN, CF34 9LN, CF34 9NS, CF34 9YE",310,270,40
W00005268,CF34,"CF34 0UU, CF34 0YP, CF34 0YW",288,262,26
W00005277,CF34,"CF34 0AU, CF34 0RH, CF34 0RL, CF34 0SY, CF34 0TE, CF34 0TF, CF34 0TG",330,309,21
W00005278,CF34,"CF34 0AF, CF34 0QA, CF34 0QB, CF34 0QD, CF34 0RU, CF34 0RY, CF34 0SE, CF34 0SF, CF34 0TA",415,381,34
W00005373,CF34,"CF34 0BX, CF34 0BY, CF34 0DG, CF34 0DH, CF34 0DL, CF34 0DN, CF34 0DX, CF34 0EX, CF34 0LH, CF34 0LL, CF34 0LW",268,236,32
W00005256,CF34,"CF34 0TB, CF34 0TD, CF34 0TH",222,207,15
W00005257,CF34,"CF34 0AT, CF34 0BD, CF34 0BG, CF34 0BH, CF34 0BQ, CF34 0EU, CF34 0HA, CF34 9PN",259,225,34
W00005258,CF34,"CF34 0AH, CF34 0AS, CF34 0BB, CF34 0BE, CF34 0BP, CF34 0BT, CF34 0BW",233,211,22
W00005259,CF34,"CF34 0BU, CF34 0HB, CF34 0HD, CF34 0HE, CF34 0HF, CF34 0HL, CF34 0HR, CF34 0SA",322,292,30
W00005260,CF34,"CF34 0HG, CF34 0HH, CF34 0HP, CF34 0HW",317,294,23
W00005261,CF34,"CF34 0ES, CF34 0HN, CF34 0HS, CF34 0HT, CF34 0HU, CF34 0HY, CF34 0XA, CF34 0XD, CF34 0XE, CF34 0XH, CF34 0YQ, CF34 0YY, CF34 0YZ",259,231,28
W00005405,CF34,"CF34 9EY, CF34 9HB, CF34 9HD, CF34 9HE, CF34 9HF, CF34 9HG, CF34 9HZ",263,232,31
W00005374,CF34,"CF34 0AL, CF34 0AN, CF34 0AP, CF34 0AR, CF34 0AW, CF34 9YA, CF34 9YG",230,207,23
W00005403,CF34,"CF34 9EU, CF34 9HA, CF34 9UD",232,213,19
W00005402,CF34,"CF34 9LU, CF34 9LY, CF34 9NA, CF34 9ND, CF34 9NG, CF34 9NH, CF34 9PR, CF34 9PS, CF34 9PT, CF34 9PU, CF34 9PY, CF34 9RA, CF34 9RB, CF34 9RD, CF34 9RE",334,311,23
W00005401,CF34,"CF34 9NB, CF34 9NE, CF34 9NF, CF34 9NJ, CF34 9NN, CF34 9NP",296,267,29
W00005400,CF34,"CF34 9BE, CF34 9BG, CF34 9LP, CF34 9LR",300,259,41
W00005399,CF34,"CF34 9AP, CF34 9DG, CF34 9DQ, CF34 9DR",302,262,40
W00005404,CF34,"CF34 9AW, CF34 9HL, CF34 9LS, CF34 9LT, CF34 9XB, CF34 9YB, CF34 9YF, CF34 9YJ, CF34 9YX",326,284,42
W00005359,CF34,"CF34 9SP, CF34 9SR, CF34 9SS, CF34 9SW, CF34 9TE, CF34 9TH",283,261,22
W00005372,CF34,"CF34 0DE, CF34 0DP, CF34 0DQ",229,213,16
W00005371,CF34,"CF34 0NP, CF34 0NR, CF34 0NS, CF34 9BJ, CF34 9BX",279,244,35
W00005370,CF34,"CF34 0JY, CF34 0LN, CF34 0NT",278,255,23
W00005369,CF34,"CF34 0JA, CF34 0SX, CF34 0TX, CF34 0UX, CF34 0YX, CF34 0ZJ",275,239,36
W00005398,CF34,"CF34 9LW, CF34 9NL, CF34 9NR, CF34 9NW",285,247,38
W00005367,CF34,"CF34 9HX, CF34 9SN, CF34 9TB, CF34 9TD",341,289,52
W00005368,CF34,"CF34 9RG, CF34 9RH, CF34 9TG",266,222,44
W00005366,CF34,"CF34 9HQ, CF34 9JL, CF34 9LD",246,200,46
W00005365,CF34,"CF34 9GA, CF34 9GB, CF34 9GD, CF34 9GE, CF34 9GF, CF34 9GG, CF34 9GH, CF34 9GJ, CF34 9LE",434,356,78
W00005363,CF34,"CF34 9HR, CF34 9HS, CF34 9HT, CF34 9HU",320,270,50
W00005360,CF34,"CF34 9ST, CF34 9SU, CF34 9SY, CF34 9TA",266,240,26
W00005362,CF34,"CF34 0DF, CF34 0EH, CF34 9SG, CF34 9SH, CF34 9TF",301,268,33
W00005507,CF35,"CF35 6HH, CF35 6HJ, CF35 6HX, CF35 6HY, CF35 6HZ, CF35 6QG",282,255,27
W00005516,CF35,"CF35 6SJ, CF35 6SQ, CF35 6ST, CF35 6SU",375,335,40
W00005515,CF35,"CF35 6RN, CF35 6RP, CF35 6RW",167,158,9
W00005514,CF35,"CF35 6PN, CF35 6RR, CF35 6RS, CF35 6RT, CF35 6RU",221,201,20
W00005512,CF35,"CF35 6LG, CF35 6LU, CF35 6NX, CF35 6RY, CF35 6SA, CF35 6SE",263,238,25
W00005190,CF35,"CF35 6ED, CF35 6EE, CF35 6EF",232,216,16
W00005511,CF35,"CF35 6SN, CF35 6YJ, CF35 6YL, CF35 6YN, CF35 6YW",252,232,20
W00005506,CF35,"CF35 6EW, CF35 6LA, CF35 6LB, CF35 6LD, CF35 6LE, CF35 6LF, CF35 6LL, CF35 6NA, CF35 6ND, CF35 6NE, CF35 6NF, CF35 6NG, CF35 6NH, CF35 6NL, CF35 6NN, CF35 6NP, CF35 6NR, CF35 6NS, CF35 6NT, CF35 6NW, CF35 6NY, CF7 9QN, CF72 9QN",330,292,38
W00005510,CF35,"CF35 6RG, CF35 6RH, CF35 6RJ, CF35 6RL, CF35 6SS, CF35 6SX, CF35 6SY, CF35 6SZ",287,264,23
W00005508,CF35,"CF35 6GB, CF35 6HL, CF35 6HN, CF35 6HR, CF35 6HS, CF35 6HT, CF35 6HU, CF35 6HW, CF35 6NB",259,239,20
W00005513,CF35,"CF35 6LW, CF35 6SP",127,114,13
W00005189,CF35,"CF35 6EG, CF35 6EH, CF35 6EL, CF35 6EU, CF39 8FG",120,113,7
W00010397,CF35,"CF35 6DQ, CF35 6EZ",198,172,26
W00010444,CF35,"CF35 6BY, CF35 6GA, CF35 6GR, CF35 6HQ",291,247,44
W00005320,CF35,"CF35 5PE, CF35 5PF, CF35 5PG, CF35 5PL",327,295,32
W00005321,CF35,"CF35 5JA, CF35 5NA, CF35 5NB, CF35 5ND, CF35 5NE",254,233,21
W00005322,CF35,"CF35 5HT, CF35 5LZ, CF35 5NH, CF35 5NL, CF35 5PB, CF35 5PD, CF35 5PH",194,170,24
W00005324,CF35,"CF35 5LE, CF35 5LF, CF35 5LG, CF35 5PR, CF35 5PS, CF35 5PT, CF35 5PU",296,272,24
W00005325,CF35,"CF35 5LU, CF35 5LY, CF35 5NF, CF35 5NG, CF35 5NJ, CF35 5NN, CF35 5PN",214,187,27
W00005326,CF35,"CF35 5NP, CF35 5NW, CF35 5NX, CF35 5PP, CF35 5PW, CF35 5PY, CF35 5RA",198,183,15
W00005327,CF35,"CF35 6LJ, CF35 6LN, CF35 6LS, CF35 6PP, CF35 6PQ, CF35 6TL, CF35 6TN, CF35 6TR",531,465,66
W00005329,CF35,"CF35 6YA, CF35 6YD, CF35 6YE, CF35 6YQ, CF35 6YZ",205,185,20
W00005330,CF35,"CF35 6JQ, CF35 6PW, CF35 6TT, CF35 6UA, CF35 6XB, CF35 6XE, CF35 6XF, CF35 6XH, CF35 6XQ, CF35 6XR, CF35 6XT, CF35 6XU",324,283,41
W00005331,CF35,"CF35 6UR, CF35 6UT, CF35 6UU, CF35 6YB, CF35 6YF, CF35 6YG",319,297,22
W00005317,CF35,"CF35 5HH, CF35 5HP, CF35 5HQ, CF35 5HR, CF35 5HS, CF35 5TA, CF35 6AB, CF35 6AD, CF35 6AE",282,257,25
W00005332,CF35,"CF35 6TB, CF35 6YH, CF35 6YP, CF35 6YR, CF35 6YS, CF35 6YT",225,204,21
W00005333,CF35,"CF35 6JA, CF35 6TP, CF35 6TS, CF35 6TU, CF35 6TW, CF35 6TY, CF35 6XD, CF35 6XJ, CF35 6XY",289,259,30
W00005334,CF35,"CF35 6TE, CF35 6TF, CF35 6TG, CF35 6TH, CF35 6YX",255,238,17
W00005335,CF35,"CF35 6TD, CF35 6UP, CF35 6UW, CF35 6UY, CF35 6WD, CF35 6WE, CF35 6YY",274,245,29
W00005336,CF35,"CF35 6JH, CF35 6JL, CF35 6JN, CF35 6JR, CF35 6JS, CF35 6JW",229,212,17
W00005337,CF35,"CF35 6RD, CF35 6RF",288,267,21
W00005338,CF35,"CF35 6JB, CF35 6JD, CF35 6JE, CF35 6JF, CF35 6JG, CF35 6JJ, CF35 6JP",272,236,36
W00005316,CF35,"CF35 5ET, CF35 5EU, CF35 5HD, CF35 5HG, CF35 5TD, CF35 5TE, CF35 5WA, CF35 5WJ, CF35 5XR, CF35 5YE, CF35 5YF, CF35 5YZ",258,227,31
W00005319,CF35,"CF35 5PA, CF35 5PJ, CF35 5PX, CF35 5QJ",274,253,21
W00010402,CF35,"CF35 6DE, CF35 6QB, CF35 6QQ",253,212,41
W00010404,CF35,"CF35 6HP, CF35 6NQ, CF35 6NU, CF35 6NZ, CF35 6PA, CF35 6QH, CF35 6QJ, CF35 6QN",265,232,33
W00010443,CF35,"CF35 6BZ, CF35 6DF, CF35 6FD, CF35 6FE, CF35 6FF",257,216,41
W00010405,CF35,"CF35 6AW, CF35 6JY",138,115,23
W00010407,CF35,"CF35 6FR, CF35 6FW, CF35 6FX",205,179,26
W00005318,CF35,"CF35 5LR, CF35 5LS, CF35 5LT",211,187,24
W00010421,CF35,"CF35 6FN, CF35 6FP, CF35 6GD, CF35 6GE, CF35 6GF, CF35 6GG, CF35 6GL",219,189,30
W00010410,CF35,"CF35 6SL, CF35 6SR, CF35 6SW",307,284,23
W00010373,CF35,"CF35 6AH, CF35 6AJ, CF35 6AR, CF35 6AS, CF35 6AT, CF35 6BE, CF35 6BL",184,168,16
W00010374,CF35,"CF35 6BF, CF35 6DH, CF35 6DJ, CF35 6HG",371,317,54
W00010377,CF35,"CF35 6FH, CF35 6FJ, CF35 6FL, CF35 6GH, CF35 6GJ",188,170,18
W00010385,CF35,"CF35 6AP, CF35 6BJ, CF35 6BQ, CF35 6DG",1814,1692,122
W00010395,CF35,"CF35 6LT, CF35 6LY, CF35 6QF, CF35 6SB, CF35 6SD, CF35 6SF, CF35 6SG, CF35 6SH",311,281,30
W00009969,CF35,"CF35 5HJ, CF35 5HX",126,112,14
W00010412,CF35,"CF35 6DZ, CF35 6JZ",101,84,17
W00010417,CF35,"CF35 6BG, CF35 6BH, CF35 6DA, CF35 6FY, CF35 6FZ, CF35 6GP",265,237,28
W00010427,CF35,"CF35 6AN, CF35 6AQ, CF35 6AX, CF35 6DD, CF35 6DX",317,273,44
W00010434,CF35,"CF35 6EX, CF35 6FA, CF35 6FB",149,133,16
W00010441,CF35,"CF35 6FQ, CF35 6FS, CF35 6FT, CF35 6FU",254,224,30
W00009974,CF35,"CF35 6BN, CF35 6BP, CF35 6BS, CF35 6BT, CF35 6BW, CF35 6JX, CF35 6RA, CF35 6RB",214,176,38
W00009967,CF35,"CF35 6LH, CF35 6LP, CF35 6LQ, CF35 6LR, CF35 6LX, CF35 6LZ, CF35 6PR, CF35 6PT, CF35 6PU, CF35 6PZ, CF35 6RE",417,368,49
W00005315,CF35,"CF35 5BQ, CF35 5BU, CF35 5DB, CF35 5EH, CF35 5HA, CF35 5HB, CF35 5HE, CF35 5HF, CF35 5HL, CF35 5HN, CF35 5HW, CF35 5TB, CF35 5YG, CF35 5YJ, CF35 5YL, CF35 5YN, CF35 5YP, CF35 5YT, CF35 5YY, CF35 6AF, CF35 6AG",290,270,20
W00005836,CF35,"CF35 5AY, CF7 7NF, CF7 7NG, CF7 7NH, CF7 7NJ, CF7 7NL, CF7 7NN, CF7 7NP, CF71 7BF, CF71 7NB, CF71 7ND, CF71 7NE, CF71 7NF, CF71 7NG, CF71 7NH, CF71 7NJ, CF71 7NL, CF71 7NN, CF71 7NP, CF71 7PL",602,515,87
W00005837,CF35,"CF35 5AE, CF35 5AF, CF35 5AG, CF35 5AH, CF35 5AL, CF35 5AS, CF35 5AT, CF35 5BA, CF35 5BB, CF35 5BD, CF35 5BE, CF35 5BG, CF35 5BH, CF35 5BJ, CF35 5BT, CF35 5BW, CF35 5SA",421,350,71
W00005838,CF35,"CF35 5AB, CF35 5AD, CF35 5AR, CF35 5AX, CF35 5BL, CF35 5BN, CF35 5BP, CF35 5BZ, CF35 5DJ, CF35 5DQ, CF35 5RG, CF35 5RH",303,262,41
W00005842,CF35,"CF35 5AZ, CF35 5BY, CF35 5DA, CF35 5DD, CF35 5DN, CF35 5DP, CF35 5DR, CF35 5DS, CF35 5DT, CF35 5DU, CF35 5DX, CF35 5EA, CF35 5EB, CF35 5ED, CF35 5EF",343,299,44
W00005737,CF35,"CF35 5DY, CF7 7RW, CF7 7SY, CF7 7SZ, CF7 7TD, CF7 7TF, CF7 7TQ, CF7 7TU, CF7 9JX, CF7 9JY, CF71 7RW, CF71 7SR, CF71 7SY, CF71 7SZ, CF71 7TD, CF71 7TF, CF71 7TQ, CF71 7TU, CF71 7TW, CF71 7TY, CF71 7TZ, CF72 9JR, CF72 9JX, CF72 9JY",424,352,72
W00005841,CF35,"CF35 5DE, CF35 5DF, CF35 5DG, CF35 5DH, CF35 5DL, CF35 5DW, CF35 5EE, CF35 5EG, CF35 5EQ, CF35 5EX",409,364,45
W00006212,CF35,"CF35 6EN, CF39 8JQ, CF39 8TU, CF39 8TY, CF39 8UH, CF39 8UL, CF39 8YH, CF39 8YL",271,244,27
W00006122,CF35,"CF35 5BF, CF35 5HU, CF35 5LA, CF35 5LB, CF35 5LD, CF35 5LH, CF35 5NQ, CF35 5PZ, CF35 6PB, CF35 6PD, CF35 6PE, CF35 6PF, CF35 6PG, CF35 6PH, CF35 6PJ, CF35 6PL, CF72 4AF",383,343,40
W00009949,CF35,"CF35 5AQ, CF35 5BX, CF35 5HY, CF35 5HZ, CF35 5LJ, CF35 5LL, CF35 5LN, CF35 5LP, CF35 5LQ, CF35 5LW, CF35 5LX, CF35 5NR, CF35 5PQ, CF35 5QA",476,430,46
W00009950,CF35,"CF35 6TA, CF35 6UG, CF35 6UH, CF35 6UJ, CF35 6UL, CF35 6UN, CF35 6UQ, CF35 6US, CF35 6YU",390,351,39
W00005450,CF36,"CF36 5BF, CF36 5RL, CF36 5RS, CF36 5RT, CF36 5SL",290,268,22
W00005456,CF36,"CF36 5AQ, CF36 5AU, CF36 5AX, CF36 5AZ, CF36 5BQ, CF36 5BZ, CF36 5DP",281,255,26
W00005454,CF36,"CF36 5AH, CF36 5AN, CF36 5AP, CF36 5AT, CF36 5NQ, CF36 5SJ, CF36 5UA, CF36 5WA, CF36 5WR, CF36 5XD, CF36 5YD, CF36 5YH, CF36 5YJ, CF36 5YL, CF36 5YN",250,234,16
W00005453,CF36,"CF36 5AG, CF36 5AL, CF36 5AS, CF36 5HD, CF36 5NP, CF36 5NR, CF36 5NS, CF36 5NU, CF36 5NY, CF36 5PA, CF36 5PB, CF36 5PJ, CF36 5PN, CF36 5RJ, CF36 5RN, CF36 5RW, CF36 5SN",286,256,30
W00005451,CF36,"CF36 5PG, CF36 5RP, CF36 5RR, CF36 5RU, CF36 5RY, CF36 5SA, CF36 5SB, CF36 5SD, CF36 5SH",263,234,29
W00005455,CF36,"CF36 5AB, CF36 5AD, CF36 5AE, CF36 5AF, CF36 5AR, CF36 5AY, CF36 5RB",264,252,12
W00005449,CF36,"CF36 5AA, CF36 5AW, CF36 5RA, CF36 5RD, CF36 5RE",280,244,36
W00005587,CF36,"CF36 3QA, CF36 3QB, CF36 3QD, CF36 3QF, CF36 3UU",260,225,35
W00005583,CF36,"CF36 3TD, CF36 3TQ, CF36 3TS, CF36 3TT, CF36 3TY, CF36 3UA, CF36 3UL, CF36 3UN, CF36 3UP, CF36 3UW",324,302,22
W00005584,CF36,"CF36 3LE, CF36 3LF, CF36 3LL, CF36 3LX, CF36 3LY, CF36 3TR, CF36 3UB",301,275,26
W00005585,CF36,"CF36 3DZ, CF36 3HU, CF36 3HY, CF36 3LA, CF36 3LB, CF36 3LG, CF36 3LH, CF36 3TU",392,363,29
W00005586,CF36,"CF36 3LD, CF36 3LN, CF36 3LP, CF36 3LR, CF36 3LW",315,281,34
W00005457,CF36,"CF36 5AJ, CF36 5BJ, CF36 5BX, CF36 5PR, CF36 5XB, CF36 5YW",279,253,26
W00005552,CF36,"CF36 3JA, CF36 3JB, CF36 3JE, CF36 3JF, CF36 3JH, CF36 3JR, CF36 3NA",220,203,17
W00005448,CF36,"CF36 5NN, CF36 5NT, CF36 5NW, CF36 5NX, CF36 5PD, CF36 5PE, CF36 5PF, CF36 5PH, CF36 5PL, CF36 5PP",316,293,23
W00005458,CF36,"CF36 5BA, CF36 5BD, CF36 5BE, CF36 5DJ, CF36 5DQ, CF36 5NG, CF36 5SE, CF36 5SF, CF36 5SG, CF36 5XA, CF36 5YE, CF36 5YS, CF36 5YU, CF36 5YZ",482,440,42
W00005551,CF36,"CF36 3DA, CF36 3DB, CF36 3DD, CF36 3DS, CF36 3JD, CF36 3JG, CF36 3JJ, CF36 3JL, CF36 3JN, CF36 3JP",307,285,22
W00005460,CF36,"CF36 3SF, CF36 3SG, CF36 3SH, CF36 3SJ, CF36 3SP, CF36 3SU, CF36 3SW",263,241,22
W00005537,CF36,"CF36 5DD, CF36 5DH, CF36 5LG, CF36 5LP, CF36 5LR, CF36 5LS, CF36 5LT, CF36 5LU, CF36 5LY",326,306,20
W00005538,CF36,"CF36 5HU, CF36 5HY, CF36 5LH, CF36 5LL, CF36 5LN, CF36 5LW",299,275,24
W00005539,CF36,"CF36 5BB, CF36 5BG, CF36 5BH, CF36 5BL, CF36 5DA, CF36 5DB, CF36 5HN",270,245,25
W00005540,CF36,"CF36 3BN, CF36 3BY, CF36 3XA, CF36 5BP, CF36 5BS, CF36 5BT, CF36 5BU, CF36 5BW, CF36 5BY, CF36 5DE, CF36 5DF, CF36 5DG",288,274,14
W00005541,CF36,"CF36 5DL, CF36 5DN, CF36 5LF, CF36 5TN, CF36 5TP, CF36 5TR, CF36 5TS, CF36 5TW",250,238,12
W00005542,CF36,"CF36 5DY, CF36 5EA, CF36 5EB, CF36 5ED, CF36 5EE, CF36 5EF, CF36 5EG, CF36 5EH",262,251,11
W00005459,CF36,"CF36 5NE, CF36 5NF, CF36 5NH, CF36 5NL, CF36 5PW",282,247,35
W00005553,CF36,"CF36 3DE, CF36 3DF, CF36 3DG, CF36 3DL, CF36 3DU, CF36 3ED, CF36 3EF",294,267,27
W00005544,CF36,"CF36 3EP, CF36 3ER, CF36 3ES, CF36 3HD, CF36 3HE, CF36 3HF",283,247,36
W00005545,CF36,"CF36 3AJ, CF36 3AX, CF36 3BJ, CF36 3LT, CF36 3YY",289,269,20
W00005546,CF36,"CF36 3AA, CF36 3AB, CF36 3AD, CF36 3AE, CF36 3AF, CF36 3AG, CF36 3BQ, CF36 3BZ, CF36 3DX, CF36 3HB, CF36 3HG, CF36 3HH, CF36 3WZ, CF36 3XF, CF36 3XG, CF36 3XJ, CF36 3XL, CF36 3XN, CF36 3XQ, CF36 3XR, CF36 3XS, CF36 3XT, CF36 3XU, CF36 3XZ, CF36 3YJ, CF36 3YN, CF36 3YT, CF36 3YZ, CF36 3ZB, CF36 3ZT, CF36 3ZY, CF36 5WB, CF36 5WE, CF36 5WF, CF36 5WT, CF36 5WZ, CF36 5XE, CF36 5XJ, CF36 5YA, CF36 5YB, CF36 5YF, CF36 5YG, CF36 5YP, CF36 5YQ, CF36 5YR, CF36 5YT, CF36 5YX, CF36 5YY, CF36 5ZP, CF36 5ZY, CF36 9AA, CF36 9AB, CF36 9AD, CF36 9AE, CF36 9AF, CF36 9AG, CF36 9AH, CF36 9AJ, CF36 9AL, CF36 9AN, CF36 9AP, CF36 9AQ, CF36 9AR, CF36 9AS, CF36 9AT, CF36 9AU, CF36 9AW, CF36 9AX, CF36 9AY, CF36 9AZ, CF36 9BA, CF36 9BB, CF36 9BD, CF36 9BE, CF36 9BF, CF36 9BG, CF36 9BH, CF36 9BJ, CF36 9BL, CF36 9BN, CF36 9BP, CF36 9BQ, CF36 9BR, CF36 9BS, CF36 9BT, CF36 9BU, CF36 9BW, CF36 9BX, CF36 9BY, CF36 9BZ, CF36 9DA, CF36 9DB, CF36 9DD, CF36 9DE, CF36 9DF, CF36 9DG, CF36 9DH, CF36 9DJ, CF36 9DL, CF36 9DN, CF36 9DP, CF36 9DQ, CF36 9DR, CF36 9DS, CF36 9DT, CF36 9DU, CF36 9DW, CF36 9DX, CF36 9DY, CF36 9DZ, CF36 9EA, CF36 9EB",303,284,19
W00005547,CF36,"CF36 3DH, CF36 3DN, CF36 3DP, CF36 3DQ, CF36 3DW",251,237,14
W00005548,CF36,"CF36 3AQ, CF36 3BF, CF36 3FA, CF36 3LU, CF36 3YF, CF36 3YG, CF36 3YL, CF36 3YQ, CF36 3YS, CF36 3YU, CF36 3YW",358,325,33
W00005549,CF36,"CF36 3AH, CF36 3AL, CF36 3AN, CF36 3AP, CF36 3AR, CF36 3AS, CF36 3AT, CF36 3AU, CF36 3AW, CF36 3AY, CF36 3AZ, CF36 3BA, CF36 3BB, CF36 3BD, CF36 3BE, CF36 3BG, CF36 3BH, CF36 3BL, CF36 3BP, CF36 3BS, CF36 3BT, CF36 3BU, CF36 3BW, CF36 3LJ, CF36 3XB, CF36 3XD, CF36 3YA, CF36 3YE, CF36 3YP, CF36 3YR",363,346,17
W00005550,CF36,"CF36 3BX, CF36 3ET, CF36 3EU, CF36 3EY, CF36 3HA, CF36 3HS, CF36 3HT, CF36 3LS",287,251,36
W00005536,CF36,"CF36 5BN, CF36 5HP, CF36 5HR, CF36 5HS, CF36 5HT, CF36 5HX",236,226,10
W00005535,CF36,"CF36 5LE, CF36 5NA, CF36 5TH, CF36 5TL",167,160,7
W00005543,CF36,"CF36 5EY, CF36 5HA, CF36 5HB",301,287,14
W00005533,CF36,"CF36 5DT, CF36 5DU, CF36 5EL, CF36 5EP, CF36 5ER, CF36 5ES, CF36 5ET, CF36 5EU",268,253,15
W00005469,CF36,"CF36 3HQ, CF36 3QJ, CF36 3QL, CF36 3QW, CF36 3RY, CF36 3SE, CF36 3TL, CF36 3TN, CF36 3TP, CF36 3TW",266,253,13
W00005467,CF36,"CF36 3EZ, CF36 3HJ, CF36 3HR, CF36 3HW, CF36 3SA",287,264,23
W00005468,CF36,"CF36 3RL, CF36 3RN, CF36 3SL, CF36 3SN",306,268,38
W00005534,CF36,"CF36 5LA, CF36 5LB, CF36 5LD, CF36 5NB, CF36 5ND",289,262,27
W00005471,CF36,"CF36 3NF, CF36 3NG, CF36 3NH, CF36 3NL, CF36 3PH, CF36 3PS",198,192,6
W00005582,CF36,"CF36 3RF, CF36 3UE, CF36 3UF, CF36 3UG, CF36 3UH, CF36 3UT",207,192,15
W00005466,CF36,"CF36 3DJ, CF36 3HL, CF36 3HP, CF36 3RS, CF36 3RT, CF36 3RU",341,307,34
W00005465,CF36,"CF36 3QG, CF36 3QN, CF36 3QP, CF36 3SB, CF36 3SD, CF36 3TJ",286,268,18
W00005581,CF36,"CF36 3PN, CF36 3RB, CF36 3RD, CF36 3RE, CF36 3RH, CF36 3UD, CF36 3UR",219,201,18
W00005463,CF36,"CF36 3NN, CF36 3NP, CF36 3NS, CF36 3NW, CF36 3PD, CF36 3PE, CF36 3PG",247,224,23
W00005462,CF36,"CF36 3PP, CF36 3PR, CF36 3RP, CF36 3RW, CF36 3SS",199,180,19
W00005461,CF36,"CF36 3NT, CF36 3NU, CF36 3NY, CF36 3PA, CF36 3PB, CF36 3RG",290,269,21
W00005580,CF36,"CF36 3QE, CF36 3QH, CF36 3QR, CF36 3RA, CF36 3RR",307,269,38
W00005555,CF36,"CF36 3DR, CF36 3DT, CF36 3DY, CF36 3EA, CF36 3EB, CF36 3EE, CF36 3EQ",322,298,24
W00005554,CF36,"CF36 3EG, CF36 3EH, CF36 3EL, CF36 3EN, CF36 3EW, CF36 3HN",239,217,22
W00005532,CF36,"CF36 5DR, CF36 5EN, CF36 5EW, CF36 5HH, CF36 5HL, CF36 5HW",272,265,7
W00005464,CF36,"CF36 3PT, CF36 3PU, CF36 3PW, CF36 3PY, CF36 3XE, CF36 3XH, CF36 3XP, CF36 3XW, CF36 3XX, CF36 3XY, CF36 3YB, CF36 3YD, CF36 3YH, CF36 3YX",225,205,20
W00006142,CF37,"CF37 4EB, CF37 4EN, CF37 4HA",289,251,38
W00006221,CF37,"CF37 3AS, CF37 3AT, CF37 3AU, CF37 3AY, CF37 3AZ, CF37 3BA",369,311,58
W00006220,CF37,"CF37 3AE, CF37 3DD, CF37 3DE",285,268,17
W00006117,CF37,"CF37 1PL, CF37 1PU, CF37 1PW, CF37 1PX, CF37 1PY, CF37 1PZ, CF37 1QA, CF38 2RB, CF38 2RD, CF38 2RJ",233,193,40
W00006141,CF37,"CF37 4HG, CF37 4HH, CF37 4HX, CF37 4HY, CF37 4HZ, CF37 4JA, CF37 4JB, CF37 4JD, CF37 4JE, CF37 4JF",334,288,46
W00006143,CF37,"CF37 4EJ, CF37 4EU, CF37 4EX, CF37 4EY",315,275,40
W00006191,CF37,"CF37 2LL, CF37 2LN, CF37 2LP, CF37 2LU, CF37 2LW, CF37 2LZ, CF37 2NN, CF37 2NP, CF37 2NW, CF37 2PD",236,218,18
W00006145,CF37,"CF37 4HD, CF37 4HJ, CF37 4HU, CF37 4NE, CF37 4NF, CF37 4NT, CF37 4NU",386,322,64
W00006146,CF37,"CF37 4HB, CF37 4HE, CF37 4HF, CF37 4HT",276,246,30
W00006193,CF37,"CF37 2NQ, CF37 2NR, CF37 2NS, CF37 2NT, CF37 2PA",236,222,14
W00006192,CF37,"CF37 2NG, CF37 2NH, CF37 2NL, CF37 2NU, CF37 2NY, CF37 2PB",255,232,23
W00006222,CF37,"CF37 3BQ, CF37 3DF, CF37 3DW, CF37 3DZ, CF37 3NB",238,208,30
W00006147,CF37,"CF37 4DP, CF37 4DW, CF37 4DX, CF37 4LQ, CF37 4LY, CF37 4NA, CF37 4NB, CF37 4ND, CF37 4NQ",309,269,40
W00006148,CF37,"CF37 4EP, CF37 4ER, CF37 4ES, CF37 4ET, CF37 4EW, CF37 4HL, CF37 4HN, CF37 4HS, CF37 4HW, CF37 4NN, CF37 4NW, CF37 4NX, CF37 4WX",286,238,48
W00006149,CF37,"CF37 4EG, CF37 4EH, CF37 4NP",334,287,47
W00006144,CF37,"CF37 4EL, CF37 4NG, CF37 4NH, CF37 4NJ, CF37 4NL, CF37 4NR, CF37 4NS, CF37 4SF",293,270,23
W00006223,CF37,"CF37 3BS, CF37 3PR, CF37 3PS, CF37 3YA, CF37 3YH, CF37 3YQ, CF37 3YU, CF37 3ZA",273,240,33
W00006228,CF37,"CF37 3AH, CF37 3AL, CF37 3AW, CF37 3BB, CF37 3BD, CF37 3HE, CF37 3HF, CF37 3HG",301,261,40
W00006225,CF37,"CF37 3BG, CF37 3BH, CF37 3BL, CF37 3BN, CF37 3BP, CF37 3BU, CF37 3BW, CF37 3DN",245,216,29
W00006546,CF37,"CF37 1DJ, CF37 1DN, CF38 1EN, CF38 1EW, CF38 1EX, CF38 1HE, CF38 1HF, CF38 1HR, CF38 1HS, CF38 1SR, CF38 1SW, CF38 1SY, CF38 1UY, CF38 1WZ, CF38 1XE",331,295,36
W00006251,CF37,"CF37 5NT, CF37 5NU, CF37 5NX, CF37 5NY, CF37 5PA, CF37 5PB, CF37 5PQ, CF37 5PX, CF37 5RP",442,387,55
W00006250,CF37,"CF37 5BT, CF37 5NH, CF37 5PD, CF37 5PE, CF37 5PF, CF37 5PG, CF37 5PH, CF37 5PY, CF37 5RD",400,350,50
W00006249,CF37,"CF37 5AA, CF37 5AB, CF37 5AD, CF37 5AE, CF37 5AF, CF37 5AG, CF37 5AL, CF37 5AN, CF37 5AP, CF37 5AZ, CF37 5BN, CF37 5BS, CF37 5LH, CF37 5LW",528,476,52
W00006248,CF37,"CF37 5AH, CF37 5AW, CF37 5BB, CF37 5BD, CF37 5BE, CF37 5BG, CF37 5BH, CF37 5BP, CF37 5BW, CF37 5DN, CF37 5DS, CF37 5DU",296,262,34
W00006246,CF37,"CF37 5AR, CF37 5AT, CF37 5AY, CF37 5LQ, CF37 5LU",241,221,20
W00006245,CF37,"CF37 5AS, CF37 5AU, CF37 5BA",266,240,26
W00006244,CF37,"CF37 5HY, CF37 5LD, CF37 5LE, CF37 5LF, CF37 5LG",293,254,39
W00006243,CF37,"CF37 5AQ, CF37 5LS, CF37 5LT, CF37 5LY, CF37 5NA, CF37 5NG, CF37 5NW, CF37 5XH, CF37 5XJ, CF37 5XN, CF37 5YS, CF37 5YZ",278,244,34
W00006242,CF37,"CF37 5LL, CF37 5LN, CF37 5LP",199,177,22
W00006241,CF37,"CF37 5HP, CF37 5HR, CF37 5HS, CF37 5HT, CF37 5HU, CF37 5LB, CF37 5RG, CF37 5RH, CF37 5RL",265,229,36
W00006224,CF37,"CF37 3BE, CF37 3BT, CF37 3DB",235,215,20
W00006240,CF37,"CF37 5NB, CF37 5NE, CF37 5NL, CF37 5NN, CF37 5NR, CF37 5PJ, CF37 5PL, CF37 5RN, CF37 5RW, CF37 5RZ",485,427,58
W00006237,CF37,"CF37 1NF, CF37 1NG, CF37 1NH, CF37 1NQ, CF37 1NT, CF37 1QP, CF37 1QY, CF37 1RD, CF37 1XH, CF37 1YD, CF37 1YF, CF37 1YH, CF37 1YJ, CF37 1YN, CF37 1YP, CF37 1YQ, CF37 1YR, CF37 1YT, CF37 1YW, CF37 1YX, CF37 1YZ",246,217,29
W00006236,CF37,"CF37 1LP, CF37 1LR, CF37 1LS, CF37 1LT, CF37 1LU, CF37 1PF, CF37 1PG, CF37 1PH, CF37 1PQ, CF37 1XJ, CF37 1YA, CF37 1YY",283,261,22
W00006235,CF37,"CF37 1LY, CF37 1LZ, CF37 1QL",205,188,17
W00006234,CF37,"CF37 1NA, CF37 1NB, CF37 1ND",255,227,28
W00006233,CF37,"CF37 1LH, CF37 1LL, CF37 1LN, CF37 1LQ, CF37 1LW, CF37 1LX, CF37 1NE, CF37 1PA",245,217,28
W00006232,CF37,"CF37 1NJ, CF37 1NL, CF37 1NN, CF37 1NW, CF37 1PN, CF37 1RG",244,206,38
W00006231,CF37,"CF37 1AB, CF37 1QR, CF37 1QS, CF37 1QU, CF37 1QZ, CF37 1RA, CF37 1RE, CF37 1SD, CF37 1SF, CF37 2UA, CF37 4SP",215,184,31
W00006230,CF37,"CF37 1BA, CF37 1BB, CF37 1DT, CF37 1DU, CF37 1DX, CF37 1DY, CF37 1HB, CF37 1JN, CF37 1JR, CF37 1JS, CF37 1JU, CF37 1JW, CF37 1JX, CF37 1JY, CF37 1JZ, CF37 1LA, CF37 1LB, CF37 1LD, CF37 1LE, CF37 1LF, CF37 1LG, CF37 1LJ, CF37 1NZ, CF37 1PT, CF37 1QF, CF37 1QJ, CF37 1QN, CF37 1QW, CF37 1QX, CF37 1RB, CF37 1SB, CF37 1XX, CF37 1YB, CF37 2TT, CF37 2UE, CF37 4ST, CF37 4TZ, CF37 4UY, CF37 4YJ",296,270,26
W00006229,CF37,"CF37 3AB, CF37 3AD, CF37 3AJ",211,180,31
W00006227,CF37,"CF37 3AF, CF37 3AG, CF37 3AN, CF37 3AP, CF37 3AR",300,254,46
W00006226,CF37,"CF37 3AA, CF37 3BY, CF37 3DA",367,324,43
W00006239,CF37,"CF37 5LR, CF37 5LX, CF37 5NP, CF37 5NS, CF37 5RS",198,176,22
W00006238,CF37,"CF37 1PJ, CF37 1PP, CF37 1XA, CF37 1XB, CF37 1XD, CF37 1XE, CF37 1XF, CF37 1XG, CF37 1XL, CF37 1YG, CF37 1YU, CF37 1ZS",207,173,34
W00006723,CF37,"CF37 3ET, CF37 3HH",189,171,18
W00006633,CF37,"CF37 1BD, CF37 1BN, CF37 1BP, CF37 1BR, CF37 1BS, CF37 1BW, CF37 4BW",433,386,47
W00006503,CF37,"CF37 4BS, CF37 5BZ, CF37 5EU, CF37 5EY, CF37 5HJ, CF37 5HN, CF37 5HW",418,371,47
W00006502,CF37,"CF37 5DP, CF37 5DZ, CF37 5EE, CF37 5EL, CF37 5SJ",250,221,29
W00006501,CF37,"CF37 5DG, CF37 5DH, CF37 5DR, CF37 5SD",335,299,36
W00006500,CF37,"CF37 5PN, CF37 5PT, CF37 5PU, CF37 5QA",294,254,40
W00006499,CF37,"CF37 1DZ, CF37 1EA, CF37 1EB, CF37 1ED, CF37 1EG, CF37 1HA, CF37 1HF, CF37 1HQ, CF37 2UD",239,200,39
W00006498,CF37,"CF37 1EL, CF37 1EW, CF37 1EY, CF37 1EZ, CF37 1QD, CF37 1QE",320,273,47
W00006497,CF37,"CF37 1EN, CF37 1EP, CF37 1ES, CF37 1JQ",298,259,39
W00006496,CF37,"CF37 1DW, CF37 1EE, CF37 1ER, CF37 1FA, CF37 1JB, CF37 1JG",371,345,26
W00006495,CF37,"CF37 1HH, CF37 1HJ, CF37 1HL, CF37 1HN, CF37 1HP, CF37 1HR, CF37 1HW, CF37 1HZ",291,247,44
W00006504,CF37,"CF37 5EP, CF37 5ER, CF37 5ET",270,249,21
W00006494,CF37,"CF37 1HS, CF37 1HT, CF37 1HU, CF37 1HX, CF37 1JE, CF37 1JH, CF37 2AS, CF37 2PT, CF37 2QQ",278,238,40
W00006492,CF37,"CF37 2PR, CF37 2RB, CF37 2RL, CF37 2RN, CF37 2RP, CF37 2RW, CF37 2SF",266,243,23
W00006491,CF37,"CF37 1ET, CF37 1EU, CF37 2SD, CF37 2SG, CF37 2SJ",207,190,17
W00006490,CF37,"CF37 1EX, CF37 1QB, CF37 2NB, CF37 2ND, CF37 2NE, CF37 2NF, CF37 2PE, CF37 2PF, CF37 2PG, CF37 2PH, CF37 2SE, CF37 3NW",327,295,32
W00006314,CF37,"CF37 1PR, CF38 2FR, CF38 2PL, CF38 2PR, CF38 2PU, CF38 2PY, CF38 2RF, CF38 2RG, CF38 2RH",292,246,46
W00006488,CF37,"CF37 2RU, CF37 2SA, CF37 2SH, CF37 2SQ",263,221,42
W00006487,CF37,"CF37 2AP, CF37 2RR, CF37 2RS, CF37 2RT, CF37 2RY, CF37 2SB, CF37 2YE, CF37 2YF, CF37 2YG, CF37 2YH, CF37 2YJ, CF37 2YP, CF37 2YR",261,232,29
W00006486,CF37,"CF37 1AA, CF37 1EF, CF37 1EH, CF37 1EJ, CF37 1EQ, CF37 1NY, CF37 1PB, CF37 1PD, CF37 1PE, CF37 1UN, CF37 1WZ, CF37 1XN, CF37 1YL, CF37 1YS, CF37 1ZA, CF37 1ZY, CF37 2WB, CF37 2WS, CF37 2YB, CF37 2YL, CF37 2YN, CF37 2YQ, CF37 3YE, CF37 3YG, CF37 4WZ, CF37 4YA, CF37 4YR, CF37 5RA, CF37 5WQ, CF37 5XA, CF37 5XP, CF37 9AJ, CF37 9AL, CF37 9AN, CF37 9AP, CF37 9AQ, CF37 9AR, CF37 9AS, CF37 9AT, CF37 9AU, CF37 9AW, CF37 9AX, CF37 9AY, CF37 9AZ, CF37 9BA, CF37 9BB, CF37 9BD, CF37 9BE, CF37 9BF, CF37 9BG, CF37 9BH, CF37 9BJ, CF37 9BL, CF37 9BN, CF37 9BP, CF37 9BQ, CF37 9BR, CF37 9BS, CF37 9BT, CF37 9BU, CF37 9BW, CF37 9BX, CF37 9BY, CF37 9BZ, CF37 9DA, CF37 9DB, CF37 9DD, CF37 9DE, CF37 9DF, CF37 9DG, CF37 9DH, CF37 9DJ, CF37 9DL, CF37 9DN, CF37 9DP, CF37 9DQ, CF37 9DR, CF37 9DS, CF37 9DT, CF37 9DU, CF37 9DW, CF37 9DX, CF37 9DY, CF37 9DZ, CF37 9EA, CF37 9EB, CF37 9ED, CF37 9EE, CF37 9EF, CF37 9EG, CF37 9EH, CF37 9EJ, CF37 9EL, CF37 9EN, CF37 9EP, CF37 9EQ, CF37 9ER, CF37 9ET, CF37 9EU, CF37 9EX, CF37 9EY, CF37 9EZ, CF37 9FA, CF37 9FB, CF37 9FD, CF37 9FE, CF37 9FF, CF37 9FG, CF37 9WZ, CF37 9ZZ, CF38 1WW, CF38 1WY, CF38 1XD, CF38 1YR, CF38 1ZB, CF38 2WD, CF38 2WY, CF38 2XA, CF38 2XE, CF38 2YA, CF46 6XT, CF46 6YG, CF46 6ZH, CF46 6ZY, CF46 9AQ",268,220,48
W00006485,CF37,"CF37 1HY, CF37 1JA, CF37 1JD, CF37 1JF, CF37 1JJ, CF37 1JL, CF37 1JP, CF37 1JT",390,321,69
W00006484,CF37,"CF37 2PS, CF37 2RF, CF37 2RG, CF37 2RH",298,268,30
W00006493,CF37,"CF37 2PU, CF37 2PY, CF37 2RA, CF37 2RD, CF37 2RE",264,245,19
W00006735,CF37,"CF37 1BG, CF37 3DR, CF37 3DS, CF37 3ED, CF37 3EP, CF37 3ER, CF37 3ES, CF37 3EU, CF37 3EY, CF37 3HP, CF37 3LY, CF37 3YB, CF37 3YD, CF37 3YZ",303,262,41
W00006505,CF37,"CF37 5PP, CF37 5PS, CF37 5PW, CF37 5RB",224,203,21
W00006507,CF37,"CF37 5BX, CF37 5DT, CF37 5DY, CF37 5EF, CF37 5EG, CF37 5EH, CF37 5HD",310,282,28
W00006724,CF37,"CF37 3HA, CF37 3HB, CF37 3HD, CF37 3HJ, CF37 3HN",249,213,36
W00006725,CF37,"CF37 3JF, CF37 3JH, CF37 3JJ, CF37 3JL",428,318,110
W00006726,CF37,"CF37 3DG, CF37 3DH, CF37 3DJ, CF37 3DL, CF37 3DP, CF37 3DQ, CF37 3DX, CF37 3EQ",313,255,58
W00006536,CF37,"CF37 5UA, CF37 5YJ, CF38 1LJ, CF38 1LL, CF38 1LN, CF38 1LY, CF38 1NA, CF38 1SS, CF38 1SU, CF38 1TA, CF38 1TB, CF38 1TE, CF38 1TF, CF38 1TH",293,260,33
W00006727,CF37,"CF37 3NU, CF37 3PA, CF37 3PB, CF37 3PD",292,263,29
W00006728,CF37,"CF37 3HU, CF37 3HZ, CF37 3JP, CF37 3LA, CF37 3LB",269,222,47
W00006729,CF37,"CF37 3HW, CF37 3LP, CF37 3LS, CF37 3LW, CF37 3LX, CF37 3NY",283,238,45
W00006730,CF37,"CF37 3HS, CF37 3HX, CF37 3HY, CF37 3LD, CF37 3LG, CF37 3LL, CF37 3LN, CF37 3LT, CF37 3LU",256,216,40
W00006731,CF37,"CF37 3HR, CF37 3HT, CF37 3LE, CF37 3LF, CF37 3LH",317,275,42
W00006506,CF37,"CF37 5ES, CF37 5HA, CF37 5HB, CF37 5HL, CF37 5HQ",273,251,22
W00006732,CF37,"CF37 3DT, CF37 3DU, CF37 3DY, CF37 3EN, CF37 3YX",314,275,39
W00006734,CF37,"CF37 3EA, CF37 3EB, CF37 3EH, CF37 3EL, CF37 3EW",282,247,35
W00009904,CF37,"CF37 1TS, CF37 1TX, CF37 1TY, CF37 1TZ, CF37 1UA, CF37 1UB, CF37 1UE, CF37 1UJ",186,163,23
W00006514,CF37,"CF37 5DJ, CF37 5DW, CF37 5EA, CF37 5EB, CF37 5ED, CF37 5EZ",312,279,33
W00006513,CF37,"CF37 5EN, CF37 5EW, CF37 5SN",194,175,19
W00006512,CF37,"CF37 5DQ, CF37 5DX, CF37 5EJ, CF37 5EQ, CF37 5SX",293,249,44
W00006511,CF37,"CF37 5DB, CF37 5DE, CF37 5DF, CF37 5SB",313,287,26
W00006510,CF37,"CF37 5DA, CF37 5DD, CF37 5DL, CF37 5ND",212,190,22
W00006509,CF37,"CF37 5BU, CF37 5BY, CF37 5PR, CF37 5RR, CF37 5RT, CF37 5RU, CF37 5RX, CF37 5RY, CF37 5SA, CF37 5SZ",307,275,32
W00006508,CF37,"CF37 5HE, CF37 5HF, CF37 5HG, CF37 5HH, CF37 5SE",314,272,42
W00006733,CF37,"CF37 3EE, CF37 3EF, CF37 3EG, CF37 3EZ",305,279,26
W00006596,CF37,"CF37 4PS, CF37 4PU, CF37 4SD, CF37 4SH",253,231,22
W00006489,CF37,"CF37 2LR, CF37 2LS, CF37 2LT, CF37 2LY, CF37 2NA, CF37 2PP",282,246,36
W00006722,CF37,"CF37 3LR, CF37 3NP, CF37 3NR, CF37 3NS, CF37 3NT, CF37 3PE, CF37 3PF, CF37 3PG, CF37 3PH, CF37 3PJ, CF37 3PL, CF37 3PN, CF37 3PP",302,244,58
W00006607,CF37,"CF37 4AD, CF37 4AH, CF37 4AL, CF37 4AN, CF37 4AP, CF37 4AQ, CF37 4AW, CF37 4AX, CF37 4DJ",250,213,37
W00006608,CF37,"CF37 4LF, CF37 4LG, CF37 4PJ, CF37 4PL, CF37 4PN, CF37 4PQ, CF37 4SA, CF37 4SB",200,183,17
W00006622,CF37,"CF37 1DB, CF37 4AR, CF37 4AS, CF37 4AT, CF37 4AU, CF37 4AY, CF37 4BA, CF37 4BB, CF37 4BD, CF37 4BE, CF37 4BG, CF37 4BH, CF37 4BL, CF37 4BN, CF37 4LX, CF37 5LJ",275,243,32
W00006623,CF37,"CF37 1SL, CF37 1TF, CF37 1TG, CF37 1TH, CF37 1TJ, CF37 1TL, CF37 1TQ",333,293,40
W00006624,CF37,"CF37 1BE, CF37 1BF, CF37 1BH, CF37 1BJ, CF37 1BT, CF37 1BU, CF37 1BX, CF37 1BY, CF37 1BZ, CF37 1DA",357,324,33
W00006625,CF37,"CF37 1BL, CF37 1NP, CF37 1NR, CF37 1NS, CF37 1NX, CF37 1RF, CF37 1RQ, CF37 1SA",431,391,40
W00006453,CF37,"CF37 2EP, CF37 2ER, CF37 2ES, CF37 2HG",321,254,67
W00006606,CF37,"CF37 4DD, CF37 4DE, CF37 4DF, CF37 4DG, CF37 4DR, CF37 4DT, CF37 4DU, CF37 4EA",363,315,48
W00006454,CF37,"CF37 2EH, CF37 2EL, CF37 2HA",269,227,42
W00006456,CF37,"CF37 2EB, CF37 2ED, CF37 2EE, CF37 2EF, CF37 2EG, CF37 2EQ, CF37 2JA, CF37 2JP, CF37 2LF, CF37 3NL",286,222,64
W00006626,CF37,"CF37 1DD, CF37 1QT, CF37 1RH, CF37 1RJ, CF37 1SG, CF37 1SH, CF37 1SN, CF37 1SQ, CF37 1TB, CF37 1TE, CF37 1UL",470,439,31
W00006597,CF37,"CF37 4BP, CF37 4BY, CF37 4DA, CF37 4DB, CF37 4LB, CF37 4LD, CF37 4LE, CF37 4PD, CF37 4PE, CF37 4PF, CF37 4PG, CF37 4PH, CF37 4PR, CF37 4SE",261,222,39
W00006627,CF37,"CF37 1ST, CF37 1SU, CF37 1SZ, CF37 1TA, CF37 1TD, CF37 5RE, CF37 5RF",225,203,22
W00006630,CF37,"CF37 1AD, CF37 1NU, CF37 1RT, CF37 1RU, CF37 1SE, CF37 1SJ, CF37 1TN, CF37 1TP, CF37 1TW",342,325,17
W00006629,CF37,"CF37 1RN, CF37 1RP, CF37 1RR, CF37 1RS",334,294,40
W00006628,CF37,"CF37 1AE, CF37 1RL, CF37 1RW, CF37 1RX, CF37 1RY, CF37 1RZ",535,489,46
W00006455,CF37,"CF37 2EN, CF37 2EU, CF37 2EW, CF37 2EY, CF37 2HB",240,208,32
W00006452,CF37,"CF37 2AA, CF37 2AB, CF37 2AD, CF37 2AE, CF37 2AF, CF37 2AG, CF37 2AH, CF37 2AJ, CF37 2AL, CF37 2AN, CF37 2AQ, CF37 2DS, CF37 2TR, CF37 4XA",312,256,56
W00006605,CF37,"CF37 4PP, CF37 4PT, CF37 4PW",248,213,35
W00009894,CF37,"CF37 1DL, CF37 1PS, CF37 1TR, CF37 1TT, CF37 1TU, CF37 1UF, CF37 1UG, CF37 1UH, CF37 5LA",838,760,78
W00006598,CF37,"CF37 4AA, CF37 4AB, CF37 4AE, CF37 4AF, CF37 4AG",297,244,53
W00006599,CF37,"CF37 4LR, CF37 4LS, CF37 4LT, CF37 4LU, CF37 4RB, CF37 4RE, CF37 4RF, CF37 4RJ, CF37 4YB, CF37 4YF, CF37 4YH, CF37 4YL, CF37 4YN, CF37 4YP, CF37 4YQ",294,254,40
W00006600,CF37,"CF37 4RG, CF37 4RL, CF37 4RU, CF37 4RW",277,239,38
W00006601,CF37,"CF37 4DY, CF37 4LH, CF37 4LJ, CF37 4LP, CF37 4RN, CF37 4RX, CF37 4RY",314,279,35
W00006602,CF37,"CF37 4DH, CF37 4DL, CF37 4DN, CF37 4DQ, CF37 4DS, CF37 4DZ, CF37 4LL, CF37 4LN, CF37 4LW",294,248,46
W00006604,CF37,"CF37 4RH, CF37 4RR, CF37 4RS, CF37 4RT, CF37 4RZ, CF37 4SG",250,221,29
W00006721,CF37,"CF37 3EJ, CF37 3EX, CF37 3JA, CF37 3JB, CF37 3JD, CF37 3JE, CF37 3JG",305,250,55
W00006032,CF37,"CF37 3NA, CF37 3ND, CF45 4BF, CF45 4NJ, CF45 4NL, CF45 4PE, CF45 4PP, CF45 4PQ, CF45 4RS, CF45 4RT, CF45 4SB, CF45 4SD, CF45 4SE, CF45 4SH, CF45 4SN, CF45 4UQ, CF45 4UZ, CF45 4XA, CF45 4XQ",370,305,65
W00007220,CF37,"CF37 4HP, CF37 4HR, CF46 6BN, CF46 6HX, CF46 6PH, CF46 6PL, CF46 6PN, CF46 6PP, CF46 6PR, CF46 6PS, CF46 6PW, CF46 6PX",219,193,26
W00006631,CF37,"CF37 1SP, CF37 1SR, CF37 1SS, CF37 1SW, CF37 1SX, CF37 1SY, CF37 1UD",302,267,35
W00006448,CF37,"CF37 2AU, CF37 2AY, CF37 2BD, CF37 2BE, CF37 2BG, CF37 2BH, CF37 2BL, CF37 2BN, CF37 2BP, CF37 2BS, CF37 2BW, CF37 2DB, CF37 2DD, CF37 2DE, CF37 2DF, CF37 2DH, CF37 2DJ, CF37 2DL, CF37 2DP, CF37 2DR, CF37 2DT, CF37 2DU, CF37 2DW, CF37 2DY, CF37 2HU, CF37 2HX, CF37 2SN, CF37 2SP, CF37 2SR, CF37 2SS, CF37 2ST, CF37 2SU, CF37 2SW, CF37 2SY, CF37 2TA, CF37 2TB, CF37 2TD, CF37 2TE, CF37 2TF, CF37 2TG, CF37 2TH, CF37 2TL, CF37 2TN, CF37 2TP, CF37 2TU, CF37 2UF, CF37 2UG, CF37 2WA, CF37 2YA, CF37 2YD, CF37 2YS, CF37 3NN, CF37 4AJ, CF37 4SJ, CF37 4SL, CF37 4SN, CF37 4SR, CF37 4SS, CF37 4SU, CF37 4SZ, CF37 4TA, CF37 4TB, CF37 4TD, CF37 4TE, CF37 4TF, CF37 4TG, CF37 4TH, CF37 4TJ, CF37 4TL, CF37 4TN, CF37 4TP, CF37 4TR, CF37 4TS, CF37 4TT, CF37 4TU, CF37 4TW, CF37 4TX, CF37 4UA, CF37 4UB, CF37 4UD, CF37 4UE, CF37 4UF, CF37 4UG, CF37 4UH, CF37 4UL, CF37 4UN, CF37 4UP, CF37 4UR, CF37 4UT, CF37 4UU, CF37 4UW, CF37 4UX, CF37 4XX, CF37 4YD, CF37 4YE, CF37 4YG, CF37 4YS, CF37 4YT, CF37 4YY, CF37 4ZB, CF37 4ZQ, CF37 9SA",475,391,84
W00006449,CF37,"CF37 2DG, CF37 2HD, CF37 2HE, CF37 2HN, CF37 2HW, CF37 2HY, CF37 2HZ, CF37 2LA, CF37 2LB, CF37 2LD, CF37 2LE, CF37 2LG",340,269,71
W00006450,CF37,"CF37 2HF, CF37 2HH, CF37 2HL, CF37 2HP, CF37 2HR, CF37 2HS, CF37 2HT",286,243,43
W00006451,CF37,"CF37 1HE, CF37 2AT, CF37 2BA, CF37 2BB, CF37 2BT, CF37 2BU, CF37 2BY, CF37 2DA, CF37 2TS, CF37 2TW, CF37 2TX, CF37 2UB, CF37 4TY",279,236,43
W00006603,CF37,"CF37 4PY, CF37 4RA, CF37 4RD, CF37 4RP",269,235,34
W00006139,CF38,"CF38 1AE, CF38 1DF, CF38 1DG, CF38 1DH, CF38 1SD, CF38 1SE",362,294,68
W00006138,CF38,"CF38 1DD, CF38 1UA, CF38 1UB, CF38 1UD, CF38 1UF",266,235,31
W00006708,CF38,"CF38 2BA, CF38 2BY, CF38 2DA, CF38 2DT, CF38 2DW, CF38 2FD",282,254,28
W00006707,CF38,"CF38 2AQ, CF38 2BT, CF38 2BU, CF38 2DB",228,201,27
W00006140,CF38,"CF38 1UH, CF38 1UJ, CF38 1UL, CF38 1UN, CF38 1UP",306,228,78
W00006137,CF38,"CF38 1EB, CF38 1ED, CF38 1EF, CF38 1EJ, CF38 1EP, CF38 1TL, CF38 1UE",442,337,105
W00006114,CF38,"CF38 2TF, CF38 2TG, CF38 2TN, CF38 2YG, CF38 2YH, CF38 2YJ, CF38 2YL, CF38 2YN, CF38 2YT",274,231,43
W00006131,CF38,"CF38 1DA, CF38 1DE, CF38 1DP, CF38 1DZ",271,238,33
W00006115,CF38,"CF38 2JD, CF38 2JE, CF38 2JF",283,218,65
W00009911,CF38,"CF38 1AZ, CF38 1BN, CF38 2AX, CF38 2AZ, CF38 2BF, CF38 2BQ, CF38 2GE, CF38 2GG",373,282,91
W00006113,CF38,"CF38 2JH, CF38 2JJ, CF38 2TA, CF38 2TW, CF38 2WA, CF38 2WB, CF38 2WZ, CF38 2XJ, CF38 2XL, CF38 2XN, CF38 2YB, CF38 2YD, CF38 2YE, CF38 2YF, CF38 2YP, CF38 2ZT",273,249,24
W00006112,CF38,"CF38 2SP, CF38 2SR, CF38 2SS, CF38 2SU, CF38 2SX",253,223,30
W00006111,CF38,"CF38 2SF, CF38 2SG, CF38 2SW, CF38 2TL",273,237,36
W00006110,CF38,"CF38 2LP, CF38 2LW",208,192,16
W00006109,CF38,"CF38 2HT, CF38 2HU, CF38 2LD, CF38 2RL, CF38 2ST, CF38 2SY",283,259,24
W00006108,CF38,"CF38 2HY, CF38 2LA, CF38 2LB",227,201,26
W00006107,CF38,"CF38 2AY, CF38 2RN, CF38 2SH, CF38 2SL",283,257,26
W00006106,CF38,"CF38 2AA, CF38 2AB, CF38 2AD, CF38 2BD, CF38 2BG, CF38 2BH, CF38 2FB, CF38 2FE, CF38 2RA",357,327,30
W00006133,CF38,"CF38 1DN, CF38 1DT, CF38 1DW",214,193,21
W00006105,CF38,"CF38 2AE, CF38 2AH, CF38 2AU, CF38 2BB, CF38 2BE, CF38 2BN",313,283,30
W00006706,CF38,"CF38 2DE, CF38 2DF, CF38 2DN",252,238,14
W00006705,CF38,"CF38 2AW, CF38 2DD",297,255,42
W00006704,CF38,"CF38 2AF, CF38 2AN, CF38 2AP, CF38 2BW, CF38 2BX, CF38 2PS",300,256,44
W00006703,CF38,"CF38 2LE, CF38 2LF, CF38 2LG, CF38 2RS",262,233,29
W00006701,CF38,"CF38 2DG, CF38 2RR, CF38 2SA, CF38 2SD, CF38 2XB, CF38 2XD, CF38 2XF, CF38 2XG, CF38 2XH, CF38 2YQ, CF38 2YR, CF38 2YS, CF38 2YU, CF38 2YW, CF38 2YX, CF38 2YY, CF38 2YZ",312,279,33
W00006700,CF38,"CF38 2DH, CF38 2LL, CF38 2LN, CF38 2RP, CF38 2SB",268,237,31
W00006699,CF38,"CF38 2BL, CF38 2DP, CF38 2EA, CF38 2GF",249,235,14
W00006698,CF38,"CF38 2DL, CF38 2DR, CF38 2DS, CF38 2SE",286,249,37
W00006697,CF38,"CF38 2AG, CF38 2AL, CF38 2AR, CF38 2AS, CF38 2AT, CF38 2JQ",281,251,30
W00006130,CF38,"CF38 1DB, CF38 1DR, CF38 1DS, CF38 1DU, CF38 1DY, CF38 1EA, CF38 1PT, CF38 1PU, CF38 1RB, CF38 1RJ, CF38 1RQ, CF38 1UZ, CF38 1XA, CF38 1XB, CF38 1YB, CF38 1YF, CF38 1YH, CF38 1YL, CF38 1YN, CF38 1YP, CF38 1YQ, CF38 1YS, CF38 1YT, CF38 1YU, CF38 1YX, CF38 1YZ",269,238,31
W00006116,CF38,"CF38 2JN, CF38 2JS, CF38 2JT, CF38 2ND",312,281,31
W00006702,CF38,"CF38 2FF, CF38 2LH, CF38 2LS, CF38 2RT, CF38 2RU, CF38 2RW, CF38 2RY",248,228,20
W00006545,CF38,"CF38 1LH, CF38 1SP, CF38 1TD, CF38 1TG, CF38 1UG",273,225,48
W00006310,CF38,"CF38 2JA, CF38 2TB, CF38 2TD, CF38 2TE",290,236,54
W00006317,CF38,"CF38 2EY, CF38 2NN, CF38 2NT, CF38 2NU, CF38 2NW",272,248,24
W00006316,CF38,"CF38 2DU, CF38 2DY, CF38 2FA, CF38 2HN, CF38 2HS, CF38 2HZ, CF38 2LJ, CF38 2PN, CF38 2PP, CF38 2PW, CF38 2RE, CF38 2UB",462,380,82
W00006315,CF38,"CF38 1AD, CF38 1AN, CF38 1AP, CF38 1AW, CF38 1AX",331,250,81
W00006313,CF38,"CF38 1EQ, CF38 2NP, CF38 2NS",227,202,25
W00006312,CF38,"CF38 1EE, CF38 1NP, CF38 2DQ, CF38 2HJ, CF38 2HQ, CF38 2JB, CF38 2JG",274,215,59
W00006311,CF38,"CF38 2DJ, CF38 2EB, CF38 2ED, CF38 2EJ, CF38 2EL, CF38 2EZ",242,207,35
W00006309,CF38,"CF38 1BH, CF38 1BJ, CF38 1BL, CF38 2JU, CF38 2JW, CF38 2JX, CF38 2LQ, CF38 2LX, CF38 2LY, CF38 2NZ",274,229,45
W00006308,CF38,"CF38 1AT, CF38 1BA, CF38 1BB, CF38 1BD, CF38 1BE, CF38 1BG, CF38 1BP, CF38 1YA, CF38 1YD, CF38 1YE, CF38 1YG, CF38 1YJ, CF38 1YW, CF38 1YY, CF38 1ZP",283,225,58
W00009897,CF38,"CF38 1BT, CF38 1DX, CF38 1GA, CF38 1GD, CF38 1RA, CF38 1RF, CF38 1RG, CF38 1TJ, CF38 1TN, CF38 1UQ",399,294,105
W00006307,CF38,"CF38 1AR, CF38 1AS, CF38 1AU, CF38 1AY, CF38 1BW",264,180,84
W00006305,CF38,"CF38 2LR, CF38 2NB, CF38 2NR, CF38 2NY, CF38 2PA",312,277,35
W00006304,CF38,"CF38 2DZ, CF38 2HE, CF38 2HG, CF38 2HP, CF38 2HR, CF38 2HW, CF38 2NA, CF38 2NG, CF38 2NH, CF38 2PJ, CF38 2TS",360,285,75
W00006303,CF38,"CF38 2BJ, CF38 2EP, CF38 2ER, CF38 2ES, CF38 2ET, CF38 2EU, CF38 2HA, CF38 2HB, CF38 2HD, CF38 2HF, CF38 2HH, CF38 2HL, CF38 2LZ, CF38 2NL",285,247,38
W00006302,CF38,"CF38 2EE, CF38 2EF, CF38 2EG, CF38 2EH, CF38 2EN, CF38 2EQ, CF38 2EW, CF38 2EX, CF38 2FG, CF38 2GA, CF38 2GB, CF38 2GD, CF38 2HX, CF38 2LT, CF38 2LU, CF38 2SN",310,248,62
W00006301,CF38,"CF38 1AA, CF38 1AJ, CF38 1SN",304,229,75
W00006300,CF38,"CF38 2NE, CF38 2NF, CF38 2NQ, CF38 2PE, CF38 2PF, CF38 2PG, CF38 2PH, CF38 2PX",292,258,34
W00010312,CF38,"CF38 1QA, CF38 1QB",370,276,94
W00009898,CF38,"CF38 2BP, CF38 2TH, CF38 2TJ, CF38 2TP, CF38 2TQ",322,259,63
W00006306,CF38,"CF38 2NJ, CF38 2NX, CF38 2PQ, CF38 2PZ",272,246,26
W00010308,CF38,"CF38 2JY, CF38 2JZ, CF38 2QA",214,178,36
W00006318,CF38,"CF38 2PB, CF38 2PD",308,265,43
W00006548,CF38,"CF38 1EL, CF38 1HA, CF38 1HG, CF38 1HH, CF38 1HL",234,194,40
W00006544,CF38,"CF38 1NT, CF38 1NU, CF38 1NW, CF38 1NY, CF38 1PL",251,223,28
W00006543,CF38,"CF38 1NE, CF38 1NF, CF38 1NN, CF38 1NR, CF38 1NS, CF38 1PA, CF38 1PB, CF38 1PD, CF38 1PG",269,225,44
W00006542,CF38,"CF38 1ET, CF38 1LF, CF38 1ND, CF38 1PR, CF38 1PS, CF38 1SA, CF38 1SB",247,206,41
W00006541,CF38,"CF38 1EG, CF38 1EH, CF38 1ES, CF38 1EY, CF38 1PP, CF38 1PW, CF38 1PX",273,226,47
W00006540,CF38,"CF38 1LP, CF38 1LR, CF38 1LS, CF38 1LW, CF38 1PE, CF38 1PF, CF38 1PN, CF38 1ST",262,228,34
W00006539,CF38,"CF38 1HU, CF38 1LA, CF38 1LB, CF38 1LD, CF38 1LE, CF38 1LG",246,220,26
W00006538,CF38,"CF38 1DL, CF38 1HN, CF38 1HP, CF38 1HT, CF38 1HW",297,261,36
W00006537,CF38,"CF38 1ER, CF38 1EU, CF38 1HB, CF38 1HD, CF38 1HY",288,253,35
W00006549,CF38,"CF38 1LT, CF38 1LU, CF38 1NB",302,257,45
W00009909,CF38,"CF38 1AB, CF38 1DQ, CF38 1GE, CF38 1GP, CF38 1RW, CF38 1UR",380,273,107
W00010295,CF38,"CF38 1AF, CF38 1AG, CF38 1PY, CF38 1RD, CF38 1RN, CF38 1RP",153,132,21
W00010286,CF38,"CF38 2JL, CF38 2JP, CF38 2JR, CF38 2PT, CF38 2SJ, CF7 8LR, CF7 8LS, CF7 8LT, CF72 8FQ, CF72 8LR, CF72 8LS, CF72 8LT",431,347,84
W00010282,CF38,"CF38 1RR, CF38 1RS, CF38 1RT, CF38 1RU, CF38 1RY",235,209,26
W00009905,CF38,"CF38 1BU, CF38 1BY, CF38 1RE, CF38 1RL, CF38 1RZ, CF38 1TP, CF38 1TQ",250,196,54
W00009903,CF38,"CF38 1GB, CF38 1GF, CF38 1GL, CF38 1RX",321,234,87
W00010307,CF38,"CF38 1AH, CF38 1AL, CF38 1AQ, CF38 1BZ, CF38 1DJ, CF38 1PJ, CF38 1PQ",559,409,150
W00009907,CF38,"CF38 1BF, CF38 1BQ, CF38 1BS, CF38 1BX, CF38 2AJ",310,249,61
W00009896,CF38,"CF38 1RH, CF38 2BS, CF38 2BZ, CF38 2DX, CF38 2TR, CF7 8NY, CF72 8NY",348,290,58
W00006458,CF39,"CF39 9TP, CF39 9TT, CF39 9TY",306,273,33
W00009901,CF39,"CF39 8JA, CF39 8JB, CF39 8JE, CF39 8JF, CF39 8JW, CF39 8QD, CF39 8QE, CF39 8QF, CF39 8QG, CF39 8QJ",353,307,46
W00006457,CF39,"CF39 9PB, CF39 9PF, CF39 9SE, CF39 9SH",260,229,31
W00010311,CF39,"CF39 8BA, CF39 8BB, CF39 8BD, CF39 8BT, CF39 8BU, CF39 8PX",302,271,31
W00010306,CF39,"CF39 8AZ, CF39 8HG, CF39 8HH, CF39 8HL, CF39 8HQ, CF39 8JR, CF39 8JT, CF39 8JU, CF39 8YN, CF39 8YW",491,407,84
W00010315,CF39,"CF39 8EZ, CF39 8HN, CF39 8HZ, CF39 8WA, CF39 8WQ, CF39 8WW, CF39 8YQ",217,181,36
W00006177,CF39,"CF39 9ER, CF39 9ES, CF39 9ET, CF39 9HF, CF39 9HG, CF39 9HH, CF39 9HL, CF39 9HP, CF39 9HR",220,212,8
W00006178,CF39,"CF39 9AZ, CF39 9BJ, CF39 9BX, CF39 9DJ, CF39 9LJ, CF39 9LX, CF39 9PX",199,188,11
W00006720,CF39,"CF39 0EN, CF39 0ER, CF39 0ES, CF39 0HA, CF39 0HB, CF39 0HD, CF39 0HE, CF39 0HF, CF39 0HN",256,236,20
W00006719,CF39,"CF39 0EP, CF39 0HG, CF39 0HH, CF39 0HL, CF39 0HP, CF39 0RF",244,203,41
W00006718,CF39,"CF39 0EF, CF39 0EL, CF39 0EW, CF39 0EX",219,200,19
W00006459,CF39,"CF39 9NP, CF39 9NR, CF39 9NT, CF39 9NY, CF39 9PA, CF39 9PH, CF39 9PL, CF39 9PU, CF39 9PY, CF39 9RE, CF39 9RF, CF39 9RH, CF39 9RL, CF39 9RP, CF39 9RR, CF39 9RS, CF39 9RT, CF39 9RU, CF39 9RW, CF39 9SB, CF39 9SD, CF39 9SL, CF39 9SR, CF39 9SS, CF39 9ST, CF42 6UF",273,253,20
W00006717,CF39,"CF39 0HR, CF39 0HS, CF39 0HT, CF39 0HW",283,227,56
W00006716,CF39,"CF39 0AH, CF39 0PA, CF39 0PB, CF39 0PD, CF39 0PJ, CF39 0PL, CF39 0RD",189,169,20
W00006715,CF39,"CF39 0PG, CF39 0PH, CF39 0PN, CF39 0PW",286,242,44
W00006714,CF39,"CF39 0PE, CF39 0PF, CF39 0PU, CF39 0PY, CF39 0RA, CF39 0RB",287,257,30
W00006713,CF39,"CF39 0PP, CF39 0PR, CF39 0PS, CF39 0PT",308,283,25
W00006712,CF39,"CF39 0AN, CF39 0AT, CF39 0LA, CF39 0LB, CF39 0NS, CF39 0RG, CF39 0RH, CF39 0WB, CF39 0XA",228,213,15
W00006711,CF39,"CF39 0AS, CF39 0DU, CF39 0DY, CF39 0EA, CF39 0EB, CF39 0EE, CF39 0EH, CF39 0HU, CF39 0NH",265,221,44
W00009895,CF39,"CF39 8DQ, CF39 8DZ, CF39 8EE, CF39 8EQ, CF39 8ET, CF39 8EU, CF39 8FA, CF39 8FD, CF39 8YP",406,351,55
W00006460,CF39,"CF39 9BB, CF39 9TF, CF39 9TH, CF39 9TL, CF39 9TR",264,229,35
W00006466,CF39,"CF39 9UE, CF39 9UU, CF39 9UX, CF39 9YB, CF39 9YD, CF39 9YG, CF39 9YQ",314,266,48
W00006462,CF39,"CF39 9BH, CF39 9BU, CF39 9BY, CF39 9DA, CF39 9DB, CF39 9DE, CF39 9DL",280,238,42
W00006577,CF39,"CF39 8AH, CF39 8AN, CF39 8AW",301,277,24
W00006576,CF39,"CF39 8PA, CF39 8PB, CF39 8PY, CF39 8PZ",280,258,22
W00006575,CF39,"CF39 8AA, CF39 8AB, CF39 8AE, CF39 8AF, CF39 8AG, CF39 8AR, CF39 8BP, CF39 8EN, CF39 8PD",295,260,35
W00006574,CF39,"CF39 8LJ, CF39 8PE, CF39 8PF, CF39 8PT",256,227,29
W00006573,CF39,"CF39 8PP, CF39 8PR, CF39 8PW",367,326,41
W00006572,CF39,"CF39 8EL, CF39 8ER, CF39 8PG, CF39 8PH",262,231,31
W00006571,CF39,"CF39 8ND, CF39 8NE, CF39 8NH",242,222,20
W00006570,CF39,"CF39 8LE, CF39 8NS, CF39 8NT",279,247,32
W00006569,CF39,"CF39 8AD, CF39 8LF, CF39 8LL, CF39 8LS, CF39 8PL, CF39 8PN, CF39 8PQ, CF39 8PU, CF39 8QA, CF39 8QB",330,298,32
W00006568,CF39,"CF39 8NB, CF39 8NF, CF39 8NG",221,202,19
W00006567,CF39,"CF39 8EH, CF39 8LD, CF39 8NP, CF39 8NR",299,272,27
W00006566,CF39,"CF39 8LG, CF39 8LH, CF39 8LN, CF39 8LP, CF39 8LR, CF39 8LT, CF39 8LU, CF39 8LW",376,339,37
W00006565,CF39,"CF39 8LA, CF39 8NL, CF39 8NN, CF39 8NW, CF39 8XA, CF39 8XG, CF39 8YF, CF39 8YG, CF39 8YT",298,260,38
W00006564,CF39,"CF39 8AX, CF39 8BE, CF39 8BG, CF39 8BH, CF39 8BL, CF39 8BN, CF39 8FP, CF39 8GB, CF39 8GD, CF39 8HJ, CF39 8HX, CF39 8PJ, CF39 8PS, CF39 8YS, CF39 8YX, CF39 8YY, CF39 8YZ, CF39 8ZY, CF7 8LQ, CF72 8LQ",571,494,77
W00006562,CF39,"CF39 8AJ, CF39 8FJ, CF39 8LB, CF39 8LX, CF39 8LY, CF39 8NA, CF39 8YU",283,247,36
W00006561,CF39,"CF39 9SU, CF40 1BA, CF40 2AA, CF40 2AB, CF40 2AD, CF40 2AE, CF40 2JZ, CF40 2QZ, CF40 2RA, CF40 2RB, CF40 2RE, CF40 2RF, CF40 2RG",255,231,24
W00009915,CF39,"CF39 8EJ, CF39 8FB, CF39 8FE",266,211,55
W00010291,CF39,"CF39 8BJ, CF39 8BS, CF39 8GA",347,305,42
W00009914,CF39,"CF39 8JJ, CF39 8JL, CF39 8JN, CF39 8JP",330,285,45
W00010294,CF39,"CF39 8HP, CF39 8HW",149,142,7
W00009908,CF39,"CF39 8DJ, CF39 8DT, CF39 8EX, CF39 8FR, CF39 8JD, CF39 8JG, CF39 8JH, CF39 8JS, CF39 8QH, CF39 8QL",515,426,89
W00006578,CF39,"CF39 8AU, CF39 8AY, CF39 8BX, CF39 8BY",272,250,22
W00006579,CF39,"CF39 8AL, CF39 8AP, CF39 8AQ, CF39 8AS, CF39 8AT, CF39 8BW, CF39 8FS",299,271,28
W00006580,CF39,"CF39 8DD, CF39 8DH, CF39 8DP, CF39 8EB",275,254,21
W00006581,CF39,"CF39 8DE, CF39 8DF, CF39 8DG, CF39 8DL, CF39 8DN, CF39 8DW",292,269,23
W00006463,CF39,"CF39 9PD, CF39 9PG, CF39 9PN, CF39 9PP, CF39 9RA, CF39 9RB, CF39 9RD, CF39 9SG, CF39 9SW, CF39 9TD",256,216,40
W00006464,CF39,"CF39 0AU, CF39 0AY, CF39 0BA, CF39 9YH, CF39 9YJ",274,236,38
W00006465,CF39,"CF39 0LP, CF39 0LR, CF39 0LS, CF39 0LT, CF39 0NE, CF39 0NF, CF39 0NG, CF39 0NP",306,269,37
W00006618,CF39,"CF39 8XE, CF39 8YE, CF39 9XD, CF39 9XJ, CF39 9XL, CF39 9XT, CF40 1YB, CF40 1YD, CF40 1YE, CF40 1YH, CF40 1YJ, CF40 1YN, CF40 1YP, CF40 1YQ, CF40 2PT, CF40 2PU, CF40 2PZ, CF40 2QP, CF40 2UD, CF40 2UE, CF40 2US, CF40 2UY, CF40 2UZ, CF40 2WA, CF40 2XA, CF40 2XB, CF40 2YF",312,283,29
W00006710,CF39,"CF39 0ED, CF39 0NL, CF39 0NN, CF39 0NR, CF39 0NT, CF39 0NW, CF39 0NY, CF39 0YA",297,263,34
W00006467,CF39,"CF39 0BG, CF39 0BH, CF39 0BJ, CF39 0BL, CF39 0BN",257,209,48
W00006468,CF39,"CF39 0BB, CF39 0DD, CF39 0LU, CF39 0LW, CF39 0LY, CF39 0NB, CF39 0ND",299,263,36
W00006469,CF39,"CF39 0AB, CF39 0AD, CF39 0AG, CF39 9UL, CF39 9UN, CF39 9UY, CF39 9WR, CF39 9YA, CF39 9YE, CF39 9YF",276,240,36
W00006470,CF39,"CF39 0DG, CF39 0DL, CF39 0DN, CF39 0DP, CF39 0DW, CF39 0LZ",280,238,42
W00006471,CF39,"CF39 0BS, CF39 0BT, CF39 0BW, CF39 0DA, CF39 0DB, CF39 0DF, CF39 0DH, CF39 0DR",360,308,52
W00006461,CF39,"CF39 9FP, CF39 9SJ, CF39 9SP, CF39 9TE, CF39 9TG, CF39 9TS, CF39 9TU, CF39 9TW",299,248,51
W00006472,CF39,"CF39 0AA, CF39 0AL, CF39 0BU, CF39 0BY, CF39 0LD, CF39 0LE, CF39 0LF, CF39 0LG, CF39 0LH, CF39 0LL, CF39 0LN, CF39 0NA, CF39 9AA, CF39 9AQ, CF39 9BE, CF39 9BL, CF39 9BN, CF39 9BQ, CF39 9BS, CF39 9BT, CF39 9BW, CF39 9NS, CF39 9NU, CF39 9RG, CF39 9RN, CF39 9RY, CF39 9SN",326,281,45
W00006475,CF39,"CF39 9SA, CF39 9SF, CF39 9TA, CF39 9UH, CF39 9UP, CF39 9UR, CF39 9UT, CF39 9UW",241,210,31
W00006476,CF39,"CF39 9TB, CF39 9TN, CF39 9TQ, CF39 9UA, CF39 9UB, CF39 9UD, CF39 9UG",264,225,39
W00006594,CF39,"CF39 8HR, CF39 8HS, CF39 8HT, CF39 8XF",287,271,16
W00006593,CF39,"CF39 8HU, CF39 8HY",225,210,15
W00006592,CF39,"CF39 8DA, CF39 8DB, CF39 8HE, CF39 8HF",277,249,28
W00006590,CF39,"CF39 8ES, CF39 8EW, CF39 8EY, CF39 8FQ, CF39 8HA, CF39 8HB, CF39 8HD, CF39 8YR, CF40 1SL",286,265,21
W00006586,CF39,"CF39 8XB, CF40 1NF, CF40 1NG, CF40 1NN, CF40 1NP, CF40 1NQ, CF40 1NR, CF40 1NW, CF40 1NX",459,420,39
W00006585,CF39,"CF39 8BZ, CF39 8DS, CF39 8DU, CF39 8ED, CF39 8EP",269,238,31
W00006584,CF39,"CF39 8DX, CF39 8DY, CF39 8EA",334,305,29
W00006583,CF39,"CF39 8DR, CF39 8EF, CF39 8EG",260,244,16
W00006474,CF39,"CF39 9BG, CF39 9BP, CF40 1HT, CF40 1JG, CF40 1JH, CF40 1JJ, CF40 1JL",157,144,13
W00006709,CF39,"CF39 0EG, CF39 0ET, CF39 0EU, CF39 0EY",284,240,44
W00006183,CF39,"CF39 9DN, CF39 9DS, CF39 9DT, CF39 9DU, CF39 9DW, CF39 9YR, CF39 9YS, CF39 9YW",290,262,28
W00006215,CF39,"CF39 8BF, CF39 8RA, CF39 8SN, CF39 8SP, CF39 8SR, CF39 8ST",333,299,34
W00006188,CF39,"CF39 9LS, CF39 9LT, CF39 9LU, CF39 9LY, CF39 9NF, CF39 9NL",268,235,33
W00006209,CF39,"CF39 8BQ, CF39 8TN, CF39 8TT, CF39 8TW",405,336,69
W00006152,CF39,"CF39 0YB, CF39 0YD, CF39 0YS, CF39 8WB, CF39 8WH, CF39 8WR, CF39 8WX, CF39 8WY, CF39 8WZ, CF39 8XD, CF39 8XH, CF39 8XP, CF39 8XQ, CF39 8YJ, CF39 8ZH, CF39 8ZQ, CF39 9XB, CF39 9XE, CF39 9XF, CF39 9XG, CF39 9XH, CF39 9YL, CF39 9YP, CF39 9YX, CF39 9ZJ, CF40 1YA, CF40 1YL, CF40 1YU, CF40 2BA, CF40 2BB, CF40 2BY, CF40 2DA, CF40 2XX, CF40 2XY, CF40 2YB, CF40 2YD, CF40 2YG, CF40 2YH, CF40 2YL, CF40 2ZA, CF40 2ZB, CF40 2ZD, CF40 9AA, CF40 9AB, CF40 9AD, CF40 9AE, CF40 9AF, CF40 9AG, CF40 9AH, CF40 9AJ, CF40 9AL, CF40 9AN, CF40 9AP, CF40 9AQ, CF40 9AR, CF40 9AS, CF40 9AT, CF40 9AU, CF40 9AW, CF40 9AX, CF40 9AZ, CF40 9BA, CF40 9BB, CF40 9BD, CF40 9BE, CF40 9BF, CF40 9BG, CF40 9BH, CF40 9BJ, CF40 9BL, CF40 9BN, CF40 9BP, CF40 9BQ, CF40 9BR, CF40 9BS, CF40 9BT, CF40 9BU, CF40 9BX, CF40 9BY, CF40 9YF, CF40 9ZW, CF40 9ZX, CF40 9ZY",281,238,43
W00006210,CF39,"CF39 8TF, CF39 8TG, CF39 8TP, CF39 8UG",274,250,24
W00006211,CF39,"CF39 8FF, CF39 8FL, CF39 8TL, CF39 8TR, CF39 8UN, CF39 8UW, CF39 8YB",355,333,22
W00006213,CF39,"CF39 8UA, CF39 8UB, CF39 8UD, CF39 8UE, CF39 8YD",228,218,10
W00006214,CF39,"CF39 8RY, CF39 8SA, CF39 8SB, CF39 8SF, CF39 8SG, CF39 8SH, CF39 8SL, CF39 8SW",315,298,17
W00006216,CF39,"CF39 8RB, CF39 8SS, CF39 8SU, CF39 8SX",210,196,14
W00006219,CF39,"CF39 8UR, CF39 8UU, CF39 8UY",264,246,18
W00006218,CF39,"CF39 8FH, CF39 8SY, CF39 8TA, CF39 8TB, CF39 8TD, CF39 8TE, CF39 8TH, CF39 8TJ, CF39 8UF",308,283,25
W00006217,CF39,"CF39 8UP, CF39 8UT, CF39 8YA",267,257,10
W00006189,CF39,"CF39 9HT, CF39 9HW, CF39 9LA, CF39 9LE, CF39 9LL",275,225,50
W00006187,CF39,"CF39 9BA, CF39 9LG, CF39 9LN, CF39 9LP, CF39 9LR, CF39 9LW, CF39 9PE, CF39 9PR, CF39 9PW",286,241,45
W00006186,CF39,"CF39 9NA, CF39 9NB, CF39 9ND, CF39 9NE, CF39 9NG, CF39 9NH, CF39 9NN",262,220,42
W00006185,CF39,"CF39 9EU, CF39 9EY, CF39 9HA",322,287,35
W00006190,CF39,"CF39 9AB, CF39 9AD, CF39 9AE, CF39 9AF, CF39 9AW, CF39 9HB, CF39 9HD",265,231,34
W00006176,CF39,"CF39 9HN, CF39 9HS, CF39 9HU, CF39 9HY",270,247,23
W00006181,CF39,"CF39 9ED, CF39 9EE, CF39 9EF, CF39 9EL, CF39 9EP, CF39 9EW",299,274,25
W00006175,CF39,"CF39 9AR, CF39 9AS, CF39 9AT, CF39 9AU",247,234,13
W00006174,CF39,"CF39 9AG, CF39 9AH, CF39 9AL, CF39 9AN, CF39 9AP, CF39 9AY, CF39 9BD, CF39 9LB, CF39 9LD, CF39 9LF, CF39 9LH, CF39 9XA, CF39 9YN, CF39 9YZ",253,218,35
W00005185,CF39,"CF39 8RD, CF39 8RH, CF39 8RL, CF39 8RN, CF39 8RP, CF39 8RW, CF39 8SD",306,280,26
W00006179,CF39,"CF39 9EA, CF39 9EB, CF39 9EG, CF39 9EH, CF39 9EN",286,259,27
W00006180,CF39,"CF39 9EX, CF39 9HJ, CF39 9PJ",294,274,20
W00005191,CF39,"CF39 8RE, CF39 8RF, CF39 8RG",277,264,13
W00006184,CF39,"CF39 9DX, CF39 9EJ, CF39 9HX, CF39 9RJ, CF39 9RX",279,266,13
W00006182,CF39,"CF39 9AJ, CF39 9AX, CF39 9DY, CF39 9YT, CF39 9YU, CF39 9YY",240,228,12
W00005192,CF39,"CF39 8GT, CF39 8RR, CF39 8RS, CF39 8RT, CF39 8RU",355,331,24
W00009193,CF4,"CF4 2QG, CF5 2AB, CF5 2AT, CF5 2AZ, CF5 2DL, CF5 2DQ, CF5 2DT, CF5 2ED, CF5 2YB, CF5 2YH",207,169,38
W00010596,CF4,"CF4 8EL, CF4 8ER, CF5 3DQ, CF5 6DR, CF5 6DS, CF5 6FP, CF5 6FQ, CF5 6FR, CF5 6FS, CF5 6HF, CF5 6HG, CF5 6HJ, CF5 6HL, CF5 6HU",283,236,47
W00006610,CF40,"CF40 2NP, CF40 2NY, CF40 2PP, CF40 2PR, CF40 2PS, CF40 2QE, CF40 2QN, CF40 2QW, CF40 2TY, CF40 2UA",328,300,28
W00006611,CF40,"CF40 2NZ, CF40 2PA, CF40 2PH, CF40 2PJ, CF40 2PL, CF40 2PN, CF40 2PW, CF40 2UF, CF40 2UU, CF40 2UX",302,278,24
W00006404,CF40,"CF40 1AZ, CF40 1ND, CF40 1NE, CF40 1NH, CF40 1PB",268,245,23
W00006473,CF40,"CF40 1HX, CF40 1HY, CF40 1JD, CF40 1JE, CF40 1JF, CF40 1JP, CF40 1JQ",199,182,17
W00006613,CF40,"CF40 2LP, CF40 2LW, CF40 2NL",243,211,32
W00006589,CF40,"CF40 1NS, CF40 1NT, CF40 1NU, CF40 1NY, CF40 1PX, CF40 1PY, CF40 1SA, CF40 1SB, CF40 1SD, CF40 1SE, CF40 1SF, CF40 1SG, CF40 1SH, CF40 1SJ, CF40 1SN, CF40 1SQ, CF40 1XX",329,303,26
W00006588,CF40,"CF40 1AG, CF40 1RG, CF40 1RN, CF40 1RR, CF40 1RS, CF40 1RT, CF40 1RX, CF40 1RZ",296,265,31
W00006612,CF40,"CF40 2LG, CF40 2LJ, CF40 2LL, CF40 2LN",247,227,20
W00006609,CF40,"CF40 2PB, CF40 2PD, CF40 2PE, CF40 2PF, CF40 2PG",315,300,15
W00006551,CF40,"CF40 1BF, CF40 1BH, CF40 1BU, CF40 1BX, CF40 1BY, CF40 1BZ, CF40 1DA, CF40 1DB, CF40 1DU, CF40 1DX, CF40 1XA, CF40 1XB, CF40 1YT",606,523,83
W00006552,CF40,"CF40 1AA, CF40 1AB, CF40 1AE, CF40 1AH, CF40 1BG, CF40 1BJ, CF40 1BL, CF40 1DL, CF40 1DQ, CF40 1DR, CF40 1DW",215,200,15
W00006405,CF40,"CF40 1EA, CF40 1LF, CF40 1LL, CF40 1LT, CF40 1LX",299,272,27
W00006403,CF40,"CF40 1PR, CF40 1QL, CF40 1QY, CF40 1RD",197,191,6
W00006406,CF40,"CF40 1EB, CF40 1EH, CF40 1EN, CF40 1ER, CF40 1EW, CF40 1HQ",295,276,19
W00006402,CF40,"CF40 1PG, CF40 1PP, CF40 1PQ, CF40 1PW",312,289,23
W00006401,CF40,"CF40 1HR, CF40 1HS, CF40 1TF, CF40 1TH, CF40 1TJ, CF40 1TL, CF40 1TN, CF40 1TQ, CF40 1TW",330,299,31
W00006400,CF40,"CF40 1HH, CF40 1HN, CF40 1HW, CF40 1PL, CF40 1SU, CF40 1SZ, CF40 1TA, CF40 1TE",272,248,24
W00006410,CF40,"CF40 1EG, CF40 1HA, CF40 1HB, CF40 1HD, CF40 1JY, CF40 1QA",194,189,5
W00006411,CF40,"CF40 1TB, CF40 1TD, CF40 1TR, CF40 1TS",266,251,15
W00006412,CF40,"CF40 1ED, CF40 1EJ, CF40 1EL, CF40 1ES, CF40 1ET, CF40 1EU, CF40 1EX, CF40 1EY, CF40 1LU, CF40 1RA",291,271,20
W00006413,CF40,"CF40 1NJ, CF40 1NL, CF40 1NZ, CF40 1PA, CF40 1PD, CF40 1PE, CF40 1PF, CF40 1PZ",314,288,26
W00006407,CF40,"CF40 1DZ, CF40 1EQ, CF40 1HE, CF40 1HF, CF40 1HG, CF40 1HU",200,192,8
W00006415,CF40,"CF40 1EZ, CF40 1PS, CF40 1PT, CF40 1PU, CF40 1QU, CF40 1QX, CF40 1RB, CF40 1RE",296,266,30
W00006416,CF40,"CF40 1HL, CF40 1HZ, CF40 1JA, CF40 1JB, CF40 1JN, CF40 1JR, CF40 1JS, CF40 1LY, CF40 1SX",332,307,25
W00006417,CF40,"CF40 1EP, CF40 1LN, CF40 1LP, CF40 1LR, CF40 1LS, CF40 1LW, CF40 1LZ, CF40 2AZ",293,259,34
W00006418,CF40,"CF40 1HP, CF40 1SY, CF40 1TG, CF40 1TP",224,209,15
W00006550,CF40,"CF40 1BN, CF40 1BP, CF40 1BS, CF40 1BT, CF40 1BW, CF40 2QU",259,220,39
W00006414,CF40,"CF40 1QN, CF40 1QP, CF40 1QR, CF40 1QS, CF40 1QT, CF40 1QW",289,258,31
W00006155,CF40,"CF40 2BZ, CF40 2RL, CF40 2RN, CF40 2RW, CF40 2RZ",296,265,31
W00006614,CF40,"CF40 2NR, CF40 2NW, CF40 2NX, CF40 2XD",323,252,71
W00006587,CF40,"CF40 1RF, CF40 1RH, CF40 1RJ, CF40 1RL, CF40 1RP, CF40 1RQ, CF40 1RU, CF40 1RW, CF40 1RY",322,294,28
W00006555,CF40,"CF40 1BD, CF40 1DD, CF40 1DE, CF40 2QT",255,225,30
W00006554,CF40,"CF40 1AQ, CF40 1BQ, CF40 1DF, CF40 1DG, CF40 1DS",294,262,32
W00006553,CF40,"CF40 1AD, CF40 1AF, CF40 1AJ, CF40 1AL, CF40 1AN, CF40 1AP, CF40 1AR, CF40 1AS, CF40 1AT, CF40 1AU, CF40 1AW, CF40 1AX, CF40 1AY, CF40 1BB, CF40 1BE, CF40 1DH, CF40 1DJ, CF40 1DN, CF40 1DP, CF40 1DT, CF40 1QB, CF40 1QD, CF40 1QE, CF40 1QF, CF40 1QG, CF40 1QQ, CF40 2LD, CF40 2LE, CF40 2LF, CF40 2NJ, CF40 2QX, CF40 2QY, CF40 2TS, CF40 2TT, CF40 2TU, CF40 2TX, CF40 2TZ, CF40 2XE, CF40 2XF, CF40 2YN",298,285,13
W00006157,CF40,"CF40 2DT, CF40 2DU, CF40 2DX",229,218,11
W00006616,CF40,"CF40 2LH, CF40 2QD, CF40 2QG, CF40 2QH, CF40 2QQ",262,232,30
W00006324,CF40,"CF40 2HN, CF40 2HP, CF40 2HR, CF40 2HS, CF40 2HW, CF40 2JA, CF40 2JB, CF40 2JD, CF40 2JE, CF40 2JF, CF40 2JU, CF40 2JY",325,292,33
W00006617,CF40,"CF40 2QF, CF40 2QJ, CF40 2QL",289,246,43
W00006620,CF40,"CF40 2UG, CF40 2UL, CF40 2UN, CF40 2UR, CF40 2UT, CF40 2UW",314,289,25
W00006621,CF40,"CF40 2BF, CF40 2PQ, CF40 2UH, CF40 2UJ, CF40 2UP, CF40 2UQ",314,282,32
W00006748,CF40,"CF40 2SS, CF41 7SD, CF41 7SJ, CF41 7SR, CF41 7SU, CF41 7SW, CF41 7TJ",308,262,46
W00006158,CF40,"CF40 2BH, CF40 2BQ, CF40 2DH, CF40 2DQ",225,213,12
W00006159,CF40,"CF40 2BG, CF40 2BL, CF40 2BN, CF40 2BP, CF40 2BW, CF40 2DN, CF40 2DW",326,310,16
W00006754,CF40,"CF40 2SN, CF40 2SP, CF40 2SR, CF40 2ST, CF40 2SU, CF40 2SW, CF40 2SX",322,278,44
W00006619,CF40,"CF40 2PX, CF40 2PY, CF40 2QA, CF40 2QB, CF40 2UB",329,303,26
W00006615,CF40,"CF40 2LQ, CF40 2NS, CF40 2NT, CF40 2NU",325,278,47
W00006325,CF40,"CF40 2EP, CF40 2EU, CF40 2EX, CF40 2EY, CF40 2EZ, CF40 2GX, CF40 2HA, CF40 2HB, CF40 2HD, CF40 2HE, CF40 2HF, CF40 2HJ, CF40 2HL, CF40 2HU",324,302,22
W00006322,CF40,"CF40 2LR, CF40 2LT, CF40 2LU, CF40 2ND, CF40 2NE, CF40 2SQ",285,263,22
W00006150,CF40,"CF40 2BS, CF40 2DL, CF40 2DP",289,271,18
W00006151,CF40,"CF40 2BJ, CF40 2BT, CF40 2BU",255,239,16
W00006153,CF40,"CF40 2EG, CF40 2RP, CF40 2RR, CF40 2RS, CF40 2RT, CF40 2RU, CF40 2RX, CF40 2RY",267,252,15
W00006154,CF40,"CF40 2BD, CF40 2BE, CF40 2BX, CF40 2DG, CF40 2ED, CF40 2EE, CF40 2EF",255,229,26
W00006323,CF40,"CF40 2EH, CF40 2ER, CF40 2ES, CF40 2ET, CF40 2HT, CF40 2HX, CF40 2HY, CF40 2HZ, CF40 2JH, CF40 2JJ, CF40 2JL, CF40 2JN, CF40 2JP, CF40 2JQ, CF40 2JR, CF40 2JS, CF40 2JW, CF40 2LS, CF40 2NA, CF40 2NN",296,270,26
W00006156,CF40,"CF40 2DJ, CF40 2DR, CF40 2DS, CF40 2DY, CF40 2DZ, CF40 2EA, CF40 2EB",263,235,28
W00006560,CF40,"CF40 2EL, CF40 2EW, CF40 2HH, CF40 2LA, CF40 2LB, CF40 2RD, CF40 2SY, CF40 2YA, CF40 2YE",169,165,4
W00006408,CF40,"CF40 1EE, CF40 1EF, CF40 1JT, CF40 1JU, CF40 1JX, CF40 1JZ, CF40 1LA, CF40 1LB, CF40 1LD, CF40 1LE, CF40 1LG, CF40 1LH, CF40 1LJ, CF40 1LQ",259,242,17
W00006558,CF40,"CF40 2RH, CF40 2RJ, CF40 2RQ",238,219,19
W00006557,CF40,"CF40 2AR, CF40 2AS, CF40 2AT, CF40 2AU, CF40 2AX, CF40 2AY, CF40 2HG, CF40 2HQ",280,245,35
W00006556,CF40,"CF40 2AF, CF40 2AG, CF40 2AH, CF40 2AP, CF40 2AQ",285,253,32
W00006319,CF40,"CF40 2LX, CF40 2NB, CF40 2NF, CF40 2NG, CF40 2NH, CF40 2NQ, CF40 2SF, CF40 2SG, CF40 2SH, CF40 2SJ, CF40 2SL, CF40 2TN",354,317,37
W00006320,CF40,"CF40 2SZ, CF40 2TA, CF40 2TF, CF40 2TG, CF40 2TH, CF40 2TJ, CF40 2TQ",316,285,31
W00006321,CF40,"CF40 2JG, CF40 2JT, CF40 2LY, CF40 2LZ, CF40 2SE, CF40 2TB, CF40 2TD, CF40 2TE, CF40 2TL",291,261,30
W00006559,CF40,"CF40 2AJ, CF40 2AL, CF40 2AN, CF40 2AW",314,289,25
W00006409,CF40,"CF40 1HJ, CF40 1PH, CF40 1PJ, CF40 1PN, CF40 1SS, CF40 1ST, CF40 1YF, CF40 1YG",253,225,28
W00006749,CF41,"CF41 7NE, CF41 7NF, CF41 7TR, CF41 7TS, CF41 7TW",296,254,42
W00006755,CF41,"CF41 7PG, CF41 7PP, CF41 7PR, CF41 7PT, CF41 7PW, CF41 7QN, CF41 7XB, CF41 7YB, CF41 7YF, CF41 7YL, CF41 7YN",243,216,27
W00006753,CF41,"CF41 7TG, CF41 7TH, CF41 7TL, CF41 7TN, CF41 7TT, CF41 7TU, CF41 7UJ, CF41 7UT",277,254,23
W00006752,CF41,"CF41 7NS, CF41 7NT, CF41 7NU, CF41 7NX, CF41 7NZ",281,247,34
W00006750,CF41,"CF41 7NA, CF41 7NH, CF41 7NJ, CF41 7NL, CF41 7NP, CF41 7NR",297,246,51
W00006398,CF41,"CF41 7HA, CF41 7HE, CF41 7HF, CF41 7HG, CF41 7HH, CF41 7HJ, CF41 7HQ",322,269,53
W00006746,CF41,"CF41 7SE, CF41 7SF, CF41 7SG, CF41 7SQ, CF41 7ST, CF41 7SX, CF41 7SY, CF41 7SZ, CF41 7TB",293,253,40
W00006745,CF41,"CF41 7NY, CF41 7RA, CF41 7RB, CF41 7RD, CF41 7RE, CF41 7RF, CF41 7TQ, CF41 7YA, CF41 7YD",273,241,32
W00006744,CF41,"CF41 7RP, CF41 7RR, CF41 7RS, CF41 7SH, CF41 7SL, CF41 7SN, CF41 7SS",259,217,42
W00006743,CF41,"CF41 7LW, CF41 7LY, CF41 7LZ, CF41 7NB, CF41 7ND, CF41 7NG, CF41 7TP",252,221,31
W00006678,CF41,"CF41 7WZ, CF41 7YE, CF41 7YG, CF41 7YH, CF41 7YJ, CF41 7ZE, CF41 7ZR, CF41 7ZY, CF42 5AJ, CF42 5YA, CF42 5YB, CF42 5YH, CF42 5ZR, CF42 6NP, CF42 6NR, CF42 6NT, CF42 6PU, CF42 6PY, CF42 6RG, CF42 6RH, CF42 6RS, CF42 6RT, CF42 6RU, CF42 6YB, CF42 6YD, CF42 6YE, CF42 6YF, CF42 6YL, CF42 6YQ, CF42 6YX, CF42 6ZZ, CF42 9AA, CF42 9AB, CF42 9AD, CF42 9AE, CF42 9AF, CF42 9AG, CF42 9AH, CF42 9AJ, CF42 9AL, CF42 9AN, CF42 9AP, CF42 9AQ, CF42 9AR, CF42 9AS, CF42 9AT, CF43 9AG, CF43 9AH, CF43 9AJ, CF43 9AL",256,223,33
W00006736,CF41,"CF41 7QD, CF41 7QF, CF41 7QG, CF41 7QH, CF41 7QJ",201,177,24
W00006737,CF41,"CF41 7QA, CF41 7RH, CF41 7RJ, CF41 7RL, CF41 7RN, CF41 7RT, CF41 7RW, CF41 7SA",281,255,26
W00006738,CF41,"CF41 7PU, CF41 7PY, CF41 7PZ, CF41 7QB, CF41 7QQ, CF41 7QR, CF41 7QW, CF41 7RU, CF41 7SP",322,272,50
W00006739,CF41,"CF41 7QE, CF41 7QU, CF41 7QX, CF41 7QY, CF41 7QZ, CF41 7RX, CF41 7RZ, CF41 7SB",342,291,51
W00006740,CF41,"CF41 7PS, CF41 7PX, CF41 7UB, CF41 7UD, CF41 7UG, CF41 7UH, CF41 7UN, CF41 7UP, CF41 7UQ",345,315,30
W00006741,CF41,"CF41 7QP, CF41 7QS, CF41 7QT, CF41 7UE, CF41 7UF, CF41 7UL, CF41 7UW",260,238,22
W00006747,CF41,"CF41 7RG, CF41 7RQ, CF41 7RY",128,104,24
W00006656,CF41,"CF41 7LB, CF42 6EJ, CF42 6EQ, CF42 6ET, CF42 6EU, CF42 6HD, CF42 6NX, CF42 6NZ, CF42 6PB, CF42 6PD, CF42 6PE, CF42 6PF, CF42 6PN",296,267,29
W00006751,CF41,"CF41 7NN, CF41 7NW, CF41 7TD, CF41 7TE, CF41 7TF",284,241,43
W00006742,CF41,"CF41 7NQ, CF41 7TA, CF41 7TX, CF41 7TY, CF41 7TZ, CF41 7UA",289,257,32
W00006382,CF41,"CF41 7EJ, CF41 7EL, CF41 7EN, CF41 7EP, CF41 7ER, CF41 7EW",297,239,58
W00006383,CF41,"CF41 7AT, CF41 7BH, CF41 7DX, CF41 7DY, CF41 7DZ",340,302,38
W00006397,CF41,"CF41 7AB, CF41 7AD, CF41 7AF, CF41 7AG, CF41 7AL, CF41 7EF, CF41 7PH, CF41 7PJ, CF41 7PL, CF41 7PN, CF41 7PQ, CF41 7QL",244,225,19
W00006396,CF41,"CF41 7ES, CF41 7ET, CF41 7EU, CF41 7EX, CF41 7EY, CF41 7HP, CF41 7LJ",272,226,46
W00006395,CF41,"CF41 7AE, CF41 7JA, CF41 7JB, CF41 7JE, CF41 7JF, CF41 7LE",262,230,32
W00006394,CF41,"CF41 7HU, CF41 7HX, CF41 7HY, CF41 7HZ, CF41 7JG, CF41 7JQ",280,257,23
W00006393,CF41,"CF41 7BU, CF41 7BX, CF41 7DL, CF41 7DP, CF41 7DQ, CF41 7DT, CF41 7DU, CF41 7DW, CF41 7HR, CF41 7HS, CF41 7HT, CF41 7JP",238,209,29
W00006392,CF41,"CF41 7JN, CF41 7JT, CF41 7JW, CF41 7JX, CF41 7LH",283,256,27
W00006399,CF41,"CF41 7AA, CF41 7AQ, CF41 7EA, CF41 7EB, CF41 7ED, CF41 7EE, CF41 7EG, CF41 7EH, CF41 7EQ, CF41 7EZ, CF41 7HB, CF41 7HD",307,279,28
W00006391,CF41,"CF41 7JD, CF41 7JH, CF41 7JJ, CF41 7JL, CF41 7JY, CF41 7JZ, CF41 7LA",292,255,37
W00006389,CF41,"CF41 7DA, CF41 7DB, CF41 7DD, CF41 7DE, CF41 7DF, CF41 7LD, CF41 7LF, CF41 7LG",278,250,28
W00006388,CF41,"CF41 7BE, CF41 7BF, CF41 7BJ, CF41 7BL, CF41 7BN, CF41 7BP, CF41 7BQ, CF41 7BS, CF41 7BT, CF41 7BW, CF41 7DH, CF41 7DN, CF41 7DR, CF41 7DS, CF41 7PE, CF41 7PF, CF41 7XW",198,185,13
W00006387,CF41,"CF41 7BA, CF41 7BB, CF41 7BD, CF41 7BG, CF41 7LU, CF41 7LX",253,214,39
W00006386,CF41,"CF41 7AU, CF41 7AX, CF41 7AY, CF41 7AZ",336,298,38
W00006385,CF41,"CF41 7AH, CF41 7AJ, CF41 7AP, CF41 7AR, CF41 7AW",276,247,29
W00006384,CF41,"CF41 7AN, CF41 7AS, CF41 7LP, CF41 7LR, CF41 7LS, CF41 7LT",316,291,25
W00006390,CF41,"CF41 7BY, CF41 7BZ, CF41 7DG, CF41 7DJ, CF41 7JR, CF41 7JS, CF41 7JU, CF41 7LQ",330,303,27
W00006676,CF42,"CF42 6BE, CF42 6BG, CF42 6BH, CF42 6BL, CF42 6BN, CF42 6BY",322,257,65
W00006657,CF42,"CF42 6HL, CF42 6NL, CF42 6NN, CF42 6NW, CF42 6UH, CF42 6UL, CF42 6UW, CF42 6YA, CF42 6YN, CF42 6YP, CF42 6YR",321,261,60
W00006665,CF42,"CF42 6SA, CF42 6SB, CF42 6SD, CF42 6SE, CF42 6SF, CF42 6SJ, CF42 6SR, CF42 6SS, CF42 6SU, CF42 6SX, CF42 6SY, CF42 6TA, CF42 6TB",387,320,67
W00006664,CF42,"CF42 6LE, CF42 6LH",186,141,45
W00006663,CF42,"CF42 6LD, CF42 6LN, CF42 6LW",244,198,46
W00006640,CF42,"CF42 5PF, CF42 5PG, CF42 5PL, CF42 5PN, CF42 5PP, CF42 5PQ, CF42 5PR, CF42 5PS, CF42 5PW, CF42 5PX",342,267,75
W00006662,CF42,"CF42 6LB, CF42 6LR, CF42 6LS, CF42 6LT, CF42 6NB",201,178,23
W00006661,CF42,"CF42 6HU, CF42 6LA, CF42 6LY, CF42 6ND, CF42 6UY, CF42 6XA",312,272,40
W00006660,CF42,"CF42 6DH, CF42 6HB, CF42 6HS, CF42 6NE, CF42 6UN, CF42 6UP, CF42 6UT, CF42 6UU",298,264,34
W00006641,CF42,"CF42 5JJ, CF42 5LG, CF42 5LH, CF42 5LL, CF42 5LN, CF42 5LW, CF42 5PJ, CF42 5YE",218,208,10
W00006642,CF42,"CF42 5NS, CF42 5NT, CF42 5NU, CF42 5PA, CF42 5RB, CF42 5RD, CF42 5RE",306,260,46
W00006643,CF42,"CF42 5NP, CF42 5NR, CF42 5PT, CF42 5PU, CF42 5PY, CF42 5RA, CF42 5RJ",309,262,47
W00006644,CF42,"CF42 5BE, CF42 5BG, CF42 5BH, CF42 5LF, CF42 5LJ, CF42 5NH",219,196,23
W00006645,CF42,"CF42 5DH, CF42 5HT, CF42 5HU, CF42 5HY, CF42 5LD, CF42 5LE, CF42 5PE",295,258,37
W00006646,CF42,"CF42 5AB, CF42 5AD, CF42 5AF, CF42 5AG, CF42 5AH, CF42 5AN, CF42 5HZ, CF42 5LA, CF42 5LB, CF42 5NY, CF42 5PB, CF42 5PD",234,213,21
W00006679,CF42,"CF42 6AP, CF42 6AW, CF42 6AX",195,162,33
W00006680,CF42,"CF42 6AB, CF42 6PA, CF42 6PL, CF42 6PP, CF42 6PR, CF42 6PS, CF42 6PW, CF42 6UB, CF42 6UD, CF42 6UE, CF42 6UG, CF42 6YG",284,242,42
W00006647,CF42,"CF42 5AA, CF42 5AE, CF42 5AL, CF42 5HE, CF42 5HH, CF42 5HL, CF42 5HN, CF42 5HW, CF42 5RH",302,262,40
W00006648,CF42,"CF42 5AQ, CF42 5EL, CF42 5EN, CF42 5ES, CF42 5EU, CF42 5EW, CF42 5HB, CF42 5HD, CF42 5RF, CF42 5RG, CF42 5RL, CF42 5RN",357,303,54
W00006649,CF42,"CF42 5AX, CF42 5RS, CF42 5RT, CF42 5RY, CF42 5SA, CF42 5SB, CF42 5SE, CF42 5SF, CF42 5SG",303,261,42
W00006650,CF42,"CF42 5SH, CF42 5SL, CF42 5SN, CF42 5SW, CF42 5SY, CF42 5XA, CF42 5YD",271,239,32
W00006659,CF42,"CF42 6LP, CF42 6LU, CF42 6LX, CF42 6NA",267,235,32
W00006658,CF42,"CF42 6NY, CF42 6PG, CF42 6PH, CF42 6RA, CF42 6RB",253,223,30
W00006651,CF42,"CF42 5ND, CF42 5NF, CF42 5NG, CF42 5NL, CF42 5NN, CF42 5SR, CF42 5ST",253,239,14
W00006655,CF42,"CF42 6HP, CF42 6HT, CF42 6HY, CF42 6LF, CF42 6LG, CF42 6LL",269,239,30
W00006654,CF42,"CF42 6HA, CF42 6HN, CF42 6HR, CF42 6HW, CF42 6LJ, CF42 6UR",283,257,26
W00006653,CF42,"CF42 5DD, CF42 5DE, CF42 5DG, CF42 5DL, CF42 5DN, CF42 5SD, CF42 5SP, CF42 5SS, CF42 5SX",338,292,46
W00006639,CF42,"CF42 5BL, CF42 5BN, CF42 5BP, CF42 5BW, CF42 5LR",270,237,33
W00006652,CF42,"CF42 5BT, CF42 5BY, CF42 5DB, CF42 5DF, CF42 5NE, CF42 5SU",224,182,42
W00006666,CF42,"CF42 6DT, CF42 6DY, CF42 6DZ, CF42 6EL",249,216,33
W00006634,CF42,"CF42 5AW, CF42 5EP, CF42 5ER, CF42 5ET, CF42 5EY, CF42 5HA, CF42 5HF, CF42 5HG, CF42 6TF",299,284,15
W00006635,CF42,"CF42 5DP, CF42 5DR, CF42 5DS, CF42 5DT, CF42 5DU, CF42 5DW, CF42 5DY, CF42 5EA, CF42 5EB, CF42 5ED",274,253,21
W00006638,CF42,"CF42 5LP, CF42 5LS, CF42 5LT",239,188,51
W00006677,CF42,"CF42 6BP, CF42 6BU, CF42 6DA, CF42 6DD, CF42 6DE, CF42 6DF, CF42 6DG",261,222,39
W00006637,CF42,"CF42 5LU, CF42 5LY, CF42 5NA, CF42 5NB, CF42 5PH, CF42 5YU, CF42 5YY",239,192,47
W00006675,CF42,"CF42 6AA, CF42 6AD, CF42 6AE, CF42 6AF, CF42 6AG, CF42 6AH, CF42 6AL, CF42 6AN, CF42 6AR, CF42 6AS, CF42 6AT, CF42 6AU, CF42 6AY, CF42 6BA, CF42 6BB, CF42 6BJ, CF42 6NS, CF42 6NU, CF42 6PT, CF42 6UA",220,188,32
W00006674,CF42,"CF42 6RD, CF42 6RE, CF42 6RF, CF42 6RL, CF42 6RN",319,254,65
W00006636,CF42,"CF42 5BS, CF42 5BU, CF42 5DA",250,223,27
W00006672,CF42,"CF42 6TH, CF42 6TJ, CF42 6TT, CF42 6TU",214,195,19
W00006671,CF42,"CF42 6SN, CF42 6TG, CF42 6TP, CF42 6TR",356,281,75
W00006670,CF42,"CF42 6DL, CF42 6DP, CF42 6DU, CF42 6EA, CF42 6EE, CF42 6EF, CF42 6EG, CF42 6EH, CF42 6EN, CF42 6EW, CF42 6EY, CF42 6NF",261,223,38
W00006669,CF42,"CF42 6BD, CF42 6BS, CF42 6DB, CF42 6TD, CF42 6TE, CF42 6TL, CF42 6TN, CF42 6TW",315,254,61
W00006668,CF42,"CF42 6DR, CF42 6EB, CF42 6ED, CF42 6EP, CF42 6YH, CF42 6YJ, CF42 6YS",293,257,36
W00006667,CF42,"CF42 5AP, CF42 5AR, CF42 5AS, CF42 5AT, CF42 5AU, CF42 5BA, CF42 5HP, CF42 6DS",284,251,33
W00006673,CF42,"CF42 6RY, CF42 6SG, CF42 6SH, CF42 6SL, CF42 6SP, CF42 6ST, CF42 6SW, CF42 6TS",291,235,56
W00006329,CF43,"CF43 4ST, CF43 4SU, CF43 4SX, CF43 4SY, CF43 4TA, CF43 4YB",275,246,29
W00006330,CF43,"CF43 4AA, CF43 4TB, CF43 4TD, CF43 4TR, CF43 4TS",265,243,22
W00006331,CF43,"CF43 4AG, CF43 4AL, CF43 4AY, CF43 4TG, CF43 4TH, CF43 4TW",223,208,15
W00006332,CF43,"CF43 4DE, CF43 4DF, CF43 4DG, CF43 4DH",223,208,15
W00006333,CF43,"CF43 4DS, CF43 4DT, CF43 4DY, CF43 4EB, CF43 4ED",292,258,34
W00006336,CF43,"CF43 4AE, CF43 4BA, CF43 4BT, CF43 4BU, CF43 4DW",184,174,10
W00006335,CF43,"CF43 4DL, CF43 4DN, CF43 4DP, CF43 4DR, CF43 4DU",262,242,20
W00006337,CF43,"CF43 4AH, CF43 4AN, CF43 4AU, CF43 4BH",299,266,33
W00006681,CF43,"CF43 3AB, CF43 3AD, CF43 3AE, CF43 3AF, CF43 3AG, CF43 3AH, CF43 3AL, CF43 3DP, CF43 3DR, CF43 3DT, CF43 3DU",271,251,20
W00006326,CF43,"CF43 4BN, CF43 4BP, CF43 4BS, CF43 4BW, CF43 4DB, CF43 4DD, CF43 4DJ, CF43 4EA, CF43 4FP",224,206,18
W00006334,CF43,"CF43 4AF, CF43 4BD, CF43 4BE, CF43 4BG, CF43 4BL, CF43 4BQ, CF43 4DA",227,211,16
W00006695,CF43,"CF43 3ED, CF43 3EE, CF43 3EH, CF43 3LH, CF43 3LJ, CF43 3LN",228,198,30
W00006196,CF43,"CF43 4EL, CF43 4EN, CF43 4ES, CF43 4EY, CF43 4HA, CF43 4LB, CF43 4SN",287,259,28
W00006194,CF43,"CF43 4ER, CF43 4HB, CF43 4HT, CF43 4LD",261,234,27
W00006694,CF43,"CF43 3AU, CF43 3AY, CF43 3BA, CF43 3LT, CF43 3LY, CF43 3PW",270,228,42
W00006693,CF43,"CF43 3EL, CF43 3LA, CF43 3LB, CF43 3LF, CF43 3LU",275,243,32
W00006692,CF43,"CF43 3EN, CF43 3HB, CF43 3LD, CF43 3LE, CF43 3NA",306,279,27
W00006691,CF43,"CF43 3AJ, CF43 3NB, CF43 3ND",260,221,39
W00006690,CF43,"CF43 3AS, CF43 3BD, CF43 3HD, CF43 3HE, CF43 3NE, CF43 3NF, CF43 3YF",239,221,18
W00006689,CF43,"CF43 3NS, CF43 3PG, CF43 3PH, CF43 3PT, CF43 3PU, CF43 3RL, CF43 3RN, CF43 3RW, CF43 3YA, CF43 3YB, CF43 3YG",233,204,29
W00006688,CF43,"CF43 3EP, CF43 3EQ, CF43 3ER, CF43 3ES, CF43 3ET, CF43 3EU, CF43 3EW, CF43 3EX, CF43 3HA",348,288,60
W00006687,CF43,"CF43 3AA, CF43 3AN, CF43 3AP, CF43 3AR, CF43 3AW, CF43 3DB, CF43 3HF, CF43 3HG, CF43 3HJ",246,233,13
W00006686,CF43,"CF43 3AT, CF43 3BB, CF43 3NH, CF43 3NP, CF43 3NR, CF43 3NU, CF43 3NY, CF43 3PA, CF43 3PB, CF43 3PD, CF43 3PE, CF43 3PF, CF43 3PL, CF43 3PN, CF43 3YE",227,212,15
W00006685,CF43,"CF43 3NT, CF43 3NW, CF43 3PY, CF43 3RA, CF43 3RB, CF43 3RD, CF43 3RE, CF43 3RF, CF43 3RG, CF43 3RH",185,178,7
W00006684,CF43,"CF43 3DA, CF43 3DD, CF43 3HH, CF43 3HL, CF43 3HN, CF43 3HQ",208,188,20
W00006683,CF43,"CF43 3BU, CF43 3BY, CF43 3DE, CF43 3DF, CF43 3DG, CF43 3DH, CF43 3DL, CF43 3DS, CF43 3HP, CF43 3HR",248,231,17
W00006682,CF43,"CF43 3BP, CF43 3BS, CF43 3BT, CF43 3BW, CF43 3DN, CF43 3DW, CF43 3EY, CF43 3HS, CF43 3HW",251,231,20
W00006327,CF43,"CF43 4TE, CF43 4TF, CF43 4TL, CF43 4TN, CF43 4TP",299,273,26
W00006201,CF43,"CF43 4NE, CF43 4NG, CF43 4NH, CF43 4NL, CF43 4NR, CF43 4NS, CF43 4RF",252,223,29
W00006195,CF43,"CF43 4LF, CF43 4LG, CF43 4LH, CF43 4LL",278,238,40
W00006696,CF43,"CF43 3EF, CF43 3LG, CF43 3LL, CF43 3LP, CF43 3LR, CF43 3LS, CF43 3LW",302,270,32
W00006197,CF43,"CF43 4EP, CF43 4EW, CF43 4HD, CF43 4HU, CF43 4RY, CF43 4SE, CF43 4SF",308,257,51
W00006198,CF43,"CF43 3XR, CF43 3YD, CF43 4HN, CF43 4HY, CF43 4LA, CF43 4QA, CF43 4SL, CF43 4UB, CF43 4UD, CF43 4UE, CF43 4UF, CF43 4UG, CF43 4WH, CF43 9AA, CF43 9AB, CF43 9AD, CF43 9AE, CF43 9AF",286,257,29
W00006199,CF43,"CF43 4EH, CF43 4ET, CF43 4EU, CF43 4SG, CF43 4SW, CF43 4UA",258,228,30
W00006200,CF43,"CF43 4NP, CF43 4NT, CF43 4NU, CF43 4NY, CF43 4PA, CF43 4PB, CF43 4PD",240,213,27
W00006208,CF43,"CF43 4HE, CF43 4HP, CF43 4HR, CF43 4HS, CF43 4LE, CF43 4LW, CF43 4RL, CF43 4RN, CF43 4RP, CF43 4RR, CF43 4RT",233,223,10
W00006202,CF43,"CF43 4NN, CF43 4NW, CF43 4PE, CF43 4PF, CF43 4PG, CF43 4PH, CF43 4PL, CF43 4PN, CF43 4SB, CF43 4SD",202,188,14
W00006328,CF43,"CF43 4AB, CF43 4AD, CF43 4AP, CF43 4AR, CF43 4AS, CF43 4AT, CF43 4AW",254,240,14
W00006204,CF43,"CF43 4PU, CF43 4PY, CF43 4RB, CF43 4RD",316,287,29
W00006205,CF43,"CF43 4NA, CF43 4NB, CF43 4ND, CF43 4RS, CF43 4RU, CF43 4SA, CF43 4XX",162,152,10
W00006206,CF43,"CF43 4HG, CF43 4HH, CF43 4HL, CF43 4HX, CF43 4LN, CF43 4LR, CF43 4LT, CF43 4WE, CF43 4WZ, CF43 4YA, CF43 4YD, CF43 4YE",325,275,50
W00006207,CF43,"CF43 4HF, CF43 4HW, CF43 4LU, CF43 4LX, CF43 4LY, CF43 4NF, CF43 4PS, CF43 4PT, CF43 4PW, CF43 4RH",262,242,20
W00006203,CF43,"CF43 4LS, CF43 4RA, CF43 4RE, CF43 4RG",249,227,22
W00010271,CF44,CF44 6AA,143,133,10
W00010269,CF44,"CF44 0AH, CF44 0BY, CF44 0BZ, CF44 0DB, CF44 0DD, CF44 0DQ, CF44 0DR, CF44 0DS, CF44 0DT, CF44 0DZ, CF44 0EQ",529,467,62
W00002654,CF44,"CF44 9JB, CF44 9JD, CF44 9JE, CF44 9JF, CF44 9JG, CF44 9QA, SA10 9LU, SA10 9LY, SA11 5UH, SA11 5UP, SA11 5UR, SA11 5US, SA11 5UT",211,159,52
W00004761,CF44,"CF44 9UR, SA11 5AZ, SA11 5NZ, SA11 5PF, SA11 5PG, SA11 5PH, SA11 5PJ, SA11 5PL, SA11 5PN, SA11 5PP, SA11 5PS, SA11 5PT, SA11 5PU, SA11 5SP, SA11 5SR, SA11 5SS",280,248,32
W00009917,CF44,"CF44 9PT, CF44 9PU, CF44 9PY, CF44 9QE, CF44 9RD, CF44 9RE, CF44 9RF, CF44 9RG, CF44 9RH, CF44 9RL, CF44 9RN, CF44 9RP, CF44 9RW",379,346,33
W00009916,CF44,"CF44 9PG, CF44 9PN",211,170,41
W00009912,CF44,"CF44 9LQ, CF44 9LY, CF44 9QH, CF44 9QT, CF44 9QU, CF44 9QX, CF44 9QY, CF44 9QZ",416,345,71
W00006076,CF44,"CF44 8HR, CF44 8LA, CF44 8LB, CF44 8LG, CF44 8LH, CF44 8LN",284,259,25
W00006255,CF44,"CF44 9PH, CF44 9PL, CF44 9PZ, CF44 9QG",353,292,61
W00006254,CF44,"CF44 9LZ, CF44 9NQ, CF44 9NS, CF44 9NT, CF44 9NU, CF44 9NY, CF44 9PA, CF44 9QF, CF44 9RQ, CF44 9SP",330,280,50
W00006253,CF44,"CF44 9HL, CF44 9NB, CF44 9ND, CF44 9NE, CF44 9NF, CF44 9NG, CF44 9RB",274,235,39
W00006252,CF44,"CF44 9PE, CF44 9PF, CF44 9TA, CF44 9TB, CF44 9TD, CF44 9TE, CF44 9TF, CF44 9TP, CF44 9TQ, CF44 9TW, CF44 9TZ",351,275,76
W00006173,CF44,"CF44 0DH, CF44 0DN, CF44 0EF, CF44 0EG, CF44 0EH, CF44 0EL, CF44 0ER, CF44 0EY",426,402,24
W00006172,CF44,"CF44 0DU, CF44 0EE, CF44 0HH, CF44 0HL, CF44 0HN, CF44 0LB, CF44 0LW, CF44 0NA, CF44 0PG",244,226,18
W00006170,CF44,"CF44 0HP, CF44 0HR, CF44 0HS, CF44 0HT, CF44 0HW",271,248,23
W00006169,CF44,"CF44 0HU, CF44 0HY, CF44 0JG, CF44 0JH, CF44 0JJ, CF44 0JL, CF44 0JN, CF44 0JP, CF44 0JQ",289,260,29
W00006168,CF44,"CF44 0LD, CF44 0LE, CF44 0LG, CF44 0LQ, CF44 0LZ, CF44 0NQ",277,249,28
W00006028,CF44,"CF44 6AQ, CF44 6AU, CF44 6AZ, CF44 6BB, CF44 6BD, CF44 6BG, CF44 6BH, CF44 6BN",265,245,20
W00006167,CF44,"CF44 0LA, CF44 0LF, CF44 0LH, CF44 0NB, CF44 0NH",289,265,24
W00006166,CF44,"CF44 0DY, CF44 0EA, CF44 0EB, CF44 0ED, CF44 0LL, CF44 0LN",256,225,31
W00006164,CF44,"CF44 0AA, CF44 0AB, CF44 0AL, CF44 0AR, CF44 0AS, CF44 0AT, CF44 0AU, CF44 0BB, CF44 0LR, CF44 0LS, CF44 0LT, CF44 0LY, CF44 0PH",265,243,22
W00006163,CF44,"CF44 0DP, CF44 0DW, CF44 0HA, CF44 0HB, CF44 0LU",321,305,16
W00006162,CF44,"CF44 0BQ, CF44 0DE, CF44 0DF, CF44 0DG, CF44 0EN, CF44 0EP, CF44 0EU",400,366,34
W00006161,CF44,"CF44 0JD, CF44 0PL, CF44 0PR, CF44 0PS",236,211,25
W00006160,CF44,"CF44 0AZ, CF44 0PA, CF44 0PB, CF44 0PD, CF44 0PE, CF44 0PF, CF44 0PN",309,263,46
W00006103,CF44,"CF44 0AF, CF44 0AQ, CF44 0TD, CF44 0TE, CF44 0TF, CF44 0TG, CF44 0TH, CF44 0TU, CF44 0TY, CF44 0UA, CF44 0UB, CF44 8PQ, CF44 8PR",426,367,59
W00006102,CF44,"CF44 0TN, CF44 0TP, CF44 0TQ, CF44 0TR, CF44 0TS, CF44 0TT, CF44 0TW, CF44 0UH, CF44 0UL, CF44 0YA, CF44 0YD",378,327,51
W00006101,CF44,"CF44 0UD, CF44 0UF, CF44 0UG, CF44 0UN, CF44 0UP, CF44 0UR, CF44 0US, CF44 0UW, CF44 0YN, CF44 0YW",274,220,54
W00006100,CF44,"CF44 0BJ, CF44 0BX, CF44 0DJ, CF44 0DX, CF44 0LJ, CF44 0TL, CF44 0UT, CF44 0UU, CF44 0UY, CF44 0XD, CF44 0XZ, CF44 0YB, CF44 0YE, CF44 0YF, CF44 0YP, CF44 0YQ",265,231,34
W00006099,CF44,"CF44 0LP, CF44 0YG, CF44 0YH, CF44 0YL",278,261,17
W00006098,CF44,"CF44 8BG, CF44 8BH, CF44 8BL, CF44 8BN, CF44 8BW, CF44 8DQ, CF44 8DY, CF44 8ED",269,250,19
W00006097,CF44,"CF44 8BX, CF44 8BY, CF44 8BZ, CF44 8HA, CF44 8HB, CF44 8HE, CF44 8RQ, CF44 8YA, CF44 8YB, CF44 8YD, CF44 8YE, CF44 8YG",445,380,65
W00006096,CF44,"CF44 8PB, CF44 8PJ, CF44 8PT, CF44 8PU, CF44 8PZ, CF44 8RN, CF44 8RW, CF44 8UA",254,216,38
W00006419,CF44,"CF44 9DH, CF44 9EE, CF44 9EF, CF44 9EG, CF44 9EH, CF44 9EL, CF44 9EN, CF44 9HB, CF44 9HD, CF44 9HE, CF44 9LL, CF44 9LN, CF44 9LP, CF44 9LU, CF44 9LW",287,260,27
W00006420,CF44,"CF44 9HN, CF44 9HP, CF44 9HR, CF44 9HS, CF44 9HW, CF44 9HY, CF44 9LE, CF44 9LF, CF44 9LG, CF44 9LH",219,196,23
W00006421,CF44,"CF44 9BD, CF44 9BG, CF44 9BH, CF44 9BN",328,291,37
W00006422,CF44,"CF44 9BL, CF44 9DU, CF44 9DY, CF44 9EA, CF44 9EB",323,294,29
W00006257,CF44,"CF44 9PQ, CF44 9PR, CF44 9QQ, CF44 9QS, CF44 9QW",379,317,62
W00006095,CF44,"CF44 8BJ, CF44 8PN, CF44 8PX, CF44 8SD, CF44 8SL",385,313,72
W00006259,CF44,"CF44 9NH, CF44 9NL, CF44 9NN, CF44 9NP, CF44 9NW, CF44 9PB, CF44 9RA, CF44 9RS, CF44 9SL, CF44 9SN, CF44 9ST",399,348,51
W00006074,CF44,"CF44 8HX, CF44 8ST, CF44 9AA, CF44 9AB, CF44 9AD, CF44 9AE, CF44 9AF, CF44 9AG, CF44 9BA, CF44 9BB",256,221,35
W00006050,CF44,"CF44 8AE, CF44 8AY, CF44 8BB, CF44 8BE",243,219,24
W00006051,CF44,"CF44 8AS, CF44 8AT, CF44 8AU, CF44 8BA, CF44 8BD, CF44 8DF, CF44 8DG",327,298,29
W00006052,CF44,"CF44 0NE, CF44 0NF, CF44 0NG, CF44 0NL, CF44 0PY, CF44 0PZ, CF44 0RA, CF44 0RB, CF44 0RD, CF44 0RE, CF44 0RF, CF44 7BP, CF44 7BS, CF44 8EN",344,288,56
W00006053,CF44,"CF44 7BH, CF44 7BL, CF44 7BY, CF44 7DA",268,243,25
W00006054,CF44,"CF44 7AA, CF44 7AB, CF44 7AN, CF44 7AP, CF44 7AR, CF44 7AS, CF44 7AT, CF44 7AU, CF44 7AW, CF44 7AX, CF44 7AY, CF44 7BB, CF44 7BD, CF44 7BG, CF44 7BN, CF44 7BQ, CF44 7BT, CF44 7BW, CF44 7DD, CF44 7EA, CF44 7HU, CF44 7NT, CF44 7RW, CF44 8DH",327,294,33
W00006264,CF44,"CF44 9TG, CF44 9TH, CF44 9TL, CF44 9TN, CF44 9TR, CF44 9TS, CF44 9TT, CF44 9TY",316,249,67
W00006055,CF44,"CF44 0JE, CF44 6HQ, CF44 7DG, CF44 7DP, CF44 7DT, CF44 7ED, CF44 7EE, CF44 7EF, CF44 7EL, CF44 7LE, CF44 7LG, CF44 7RP",318,282,36
W00006056,CF44,"CF44 0XF, CF44 6XB, CF44 6XE, CF44 6XQ, CF44 6XR, CF44 6ZZ, CF44 7AD, CF44 7AE, CF44 7HX, CF44 7LS, CF44 7LT, CF44 7LW, CF44 7NP, CF44 7NY, CF44 7PA, CF44 7YA, CF44 7YB, CF44 7YD, CF44 7YE, CF44 7YF, CF44 7YH, CF44 7YQ, CF44 7ZZ, CF44 8XA, CF44 8YN, CF44 8YU, CF44 8YZ, CF44 8ZB, CF44 8ZY, CF44 9XD, CF44 9XF, CF44 9XG, CF44 9XH, CF44 9XL, CF44 9YB, CF44 9YQ",298,257,41
W00006057,CF44,"CF44 7LU, CF44 7NE, CF44 7NF, CF44 7NG, CF44 7NL, CF44 7NU, CF44 7NW",307,291,16
W00006058,CF44,"CF44 7BA, CF44 7DF, CF44 7DH, CF44 7DL, CF44 7DR, CF44 7DS, CF44 7DU, CF44 7DY, CF44 7EB, CF44 7EG, CF44 7EH, CF44 7HR, CF44 7HS, CF44 7HT, CF44 7HY, CF44 7LA, CF44 7LB, CF44 7LD, CF44 7LJ, CF44 7LL, CF44 7LN, CF44 7LP, CF44 7LR, CF44 7PH, CF44 7RN, CF44 7XA, CF44 7XD, CF44 7XS, CF44 7XU",303,282,21
W00006059,CF44,"CF44 7PP, CF44 7PR, CF44 7PS, CF44 7PU",239,216,23
W00006060,CF44,"CF44 7EP, CF44 7ER, CF44 7ES, CF44 7ET, CF44 7EU, CF44 7EY",289,268,21
W00006061,CF44,"CF44 7EN, CF44 7HA, CF44 7HD, CF44 7HF, CF44 7HH, CF44 7HJ, CF44 7LF",305,247,58
W00006062,CF44,"CF44 7LY, CF44 7NB, CF44 7ND, CF44 7NH",310,275,35
W00006063,CF44,"CF44 7EW, CF44 7HB, CF44 7HE, CF44 7HG, CF44 7HL, CF44 7NA, CF44 7NN, CF44 7RD, CF44 7RE",253,225,28
W00006064,CF44,"CF44 0GW, CF44 0SP, CF44 0SR, CF44 0SS, CF44 0ST, CF44 0SU, CF44 0YS, CF44 0YT, CF44 0YZ",286,266,20
W00006263,CF44,"CF44 9BF, CF44 9NA, CF44 9NJ, CF44 9NR, CF44 9NZ, CF44 9PS, CF44 9PW, CF44 9QD, CF44 9RT, CF44 9RZ, CF44 9SG, CF44 9SH",392,336,56
W00006262,CF44,"CF44 9PD, CF44 9PP, CF44 9SB, CF44 9SS, CF44 9SU, CF44 9SW, CF44 9SY, CF44 9XE, CF44 9YD, CF44 9YF, CF44 9YH, CF44 9YP",214,197,17
W00006261,CF44,"CF44 9BU, CF44 9RU, CF44 9RY, CF44 9SA, CF44 9SD, CF44 9SE, CF44 9SF, CF44 9TU, CF44 9UA",264,228,36
W00006065,CF44,"CF44 0NU, CF44 0NX, CF44 0NY, CF44 0QA, CF44 0QB, CF44 0QD, CF44 0QE, CF44 0RY, CF44 0SG, CF44 0SN, CF44 0SW, CF44 0XB",288,261,27
W00006066,CF44,"CF44 0AJ, CF44 0RJ, CF44 0RP, CF44 0RR, CF44 0RS, CF44 0RW, CF44 0SA, CF44 0SB, CF44 0SD, CF44 0SE, CF44 0SF, CF44 0YR, CF44 0YU, CF44 0YY",313,272,41
W00006067,CF44,"CF44 7BU, CF44 8AA, CF44 8AB, CF44 8AF, CF44 8AG, CF44 8AH, CF44 8AL, CF44 8AN, CF44 8AP, CF44 8AR, CF44 8AW, CF44 8DL",246,221,25
W00006068,CF44,"CF44 0RT, CF44 0RU, CF44 0SH",186,172,14
W00006077,CF44,"CF44 8HG, CF44 8HH, CF44 8LL, CF44 8LP, CF44 8LW, CF44 8NA, CF44 8NY",273,243,30
W00006069,CF44,"CF44 8AD, CF44 8DN, CF44 8DP, CF44 8DR, CF44 8DW",273,232,41
W00006070,CF44,"CF44 0NN, CF44 0NR, CF44 0NS, CF44 0NT, CF44 0NW, CF44 0PP, CF44 0RG, CF44 0RH, CF44 0RL, CF44 0RN, CF44 0RQ",339,288,51
W00006071,CF44,"CF44 7HP, CF44 7PD, CF44 7PF, CF44 7PW, CF44 7PY, CF44 7RA, CF44 7RB",227,212,15
W00006072,CF44,"CF44 7AG, CF44 7AH, CF44 7DN, CF44 7DW, CF44 7PB, CF44 7PE, CF44 7PG, CF44 7PL, CF44 7PN, CF44 7RF",327,279,48
W00006073,CF44,"CF44 8BP, CF44 8BS, CF44 8BT, CF44 8BU, CF44 8DA, CF44 8DB, CF44 8DD, CF44 8DJ",314,290,24
W00006075,CF44,"CF44 8PD, CF44 8PE, CF44 8PF, CF44 8PG, CF44 8PH, CF44 8PL, CF44 8PP",289,257,32
W00006424,CF44,"CF44 9AR, CF44 9AS, CF44 9AT, CF44 9AU, CF44 9AW, CF44 9DA, CF44 9DR",305,271,34
W00006423,CF44,"CF44 9ER, CF44 9EW, CF44 9LR, CF44 9LS, CF44 9LT",300,258,42
W00006427,CF44,"CF44 9ED, CF44 9EP, CF44 9ES, CF44 9ET, CF44 9EU, CF44 9EY, CF44 9HA",233,217,16
W00006428,CF44,"CF44 9LA, CF44 9LB, CF44 9LD",346,313,33
W00005999,CF44,"CF44 6RT, CF44 6RY, CF44 6SA, CF44 6SH, CF44 6SJ, CF44 6SL, CF44 6TE",277,243,34
W00010310,CF44,"CF44 0AN, CF44 0BA, CF44 0BD, CF44 0BE, CF44 0BG, CF44 0BH, CF44 0BN, CF44 0BS, CF44 0BW, CF44 0DA, CF44 0DL, CF44 0ES, CF44 0ET, CF44 0EW, CF45 4ED, CF45 4EF",364,336,28
W00005998,CF44,"CF44 6RE, CF44 6SN, CF44 6SP, CF44 6SR, CF44 6SS, CF44 6ST, CF44 6SW, CF44 6SY, CF44 6TA, CF44 6TB, CF44 6TD",323,284,39
W00005997,CF44,"CF44 6ER, CF44 6ES, CF44 6ET, CF44 6SU, CF44 6WB, CF44 6YB, CF44 6YE",293,268,25
W00006090,CF44,"CF44 8TA, CF44 8TB, CF44 8TD, CF44 8TH",214,198,16
W00006089,CF44,"CF44 8EQ, CF44 8EX, CF44 8HP, CF44 8LR, CF44 8RB, CF44 8RD, CF44 8RE, CF44 8RJ, CF44 8RL, CF44 8SR, CF44 8SS, CF44 9BP, CF44 9BQ, CF44 9BS",456,391,65
W00005996,CF44,"CF44 6YD, CF44 6YF, CF44 6YG, CF44 6YH, CF44 6YJ, CF44 6YL",322,292,30
W00006088,CF44,"CF44 8LY, CF44 8NB, CF44 8NE, CF44 8NN, CF44 8NP, CF44 8NU, CF44 8NW, CF44 8NX",257,234,23
W00006087,CF44,"CF44 8HT, CF44 8HU, CF44 8HY, CF44 8LD, CF44 8LE, CF44 8LF, CF44 8PS",339,311,28
W00010305,CF44,"CF44 0XA, CF44 0XY, CF44 4AA, CF44 4AB, CF44 4AD, CF44 4AE, CF44 4AF, CF44 4AG, CF44 4AH, CF44 4AJ, CF44 4AL, CF44 4AN, CF44 4AP, CF44 4AQ, CF44 4AR, CF44 4AS, CF44 4AT, CF44 4AU, CF44 4AW, CF44 4AX, CF44 4AY, CF44 4AZ, CF44 4BA, CF44 4BB, CF44 4BD, CF44 4BE, CF44 4BF, CF44 4BG, CF44 4BH, CF44 4BJ, CF44 4BL, CF44 4BN, CF44 4BP, CF44 4BQ, CF44 4BR, CF44 4BS, CF44 4BT, CF44 4ZZ, CF44 6AX, CF44 6BX, CF44 6BY, CF44 6DA, CF44 6DH, CF44 6DL, CF44 6DN, CF44 6DP, CF44 6DR, CF44 6DS, CF44 6DZ, CF44 6EY, CF44 6HA, CF44 6LJ, CF44 6LP, CF44 6LX, CF44 6RF, CF44 6UZ, CF44 6XD, CF44 6XW, CF44 6XZ, CF44 6ZA, CF44 6ZP, CF44 6ZU, CF44 7LH, CF44 7YG, CF44 8WA, CF44 8XT, CF44 8YF, CF44 8YH, CF44 8YR, CF44 8YS, CF44 8YT, CF44 8YW, CF44 8YX, CF44 9XB, CF44 9ZQ, CF44 9ZR",520,459,61
W00006086,CF44,"CF44 8TE, CF44 8TF, CF44 8TG, CF44 8TL",228,207,21
W00006085,CF44,"CF44 0AX, CF44 8EJ, CF44 8EP, CF44 8ER, CF44 8ES, CF44 8ET, CF44 8EU, CF44 8EW, CF44 8EY, CF44 8EZ, CF44 8HD, CF44 8YY",300,272,28
W00006094,CF44,"CF44 8TT, CF44 8TU, CF44 8TY, CF44 8TZ, CF44 8UB, CF44 8UD, CF44 8UE",238,222,16
W00006084,CF44,"CF44 8NH, CF44 8NL, CF44 8NR, CF44 8NS, CF44 8NT, CF44 8PA, CF44 8PW",324,291,33
W00006082,CF44,"CF44 8AJ, CF44 8AQ, CF44 8AZ, CF44 8BQ, CF44 8DS, CF44 8RT, CF44 8RU, CF44 8RX",373,319,54
W00006081,CF44,"CF44 8DT, CF44 8DU, CF44 8DX, CF44 8DZ, CF44 8EA, CF44 8EB, CF44 8EE, CF44 8EH",343,297,46
W00010304,CF44,"CF44 0BF, CF44 0BP, CF44 0BT, CF44 0BU",296,255,41
W00006477,CF44,"CF44 0SJ, CF44 0SX, CF44 0UJ, CF44 9JA, CF44 9JN, CF44 9JP, CF44 9JR, CF44 9JW, CF44 9TX, CF44 9UJ",261,198,63
W00006080,CF44,"CF44 8AX, CF44 8BF, CF44 8PY, CF44 8SE",366,307,59
W00006478,CF44,"CF44 0NJ, CF44 9JS, CF44 9JT, CF44 9SX, CF44 9TJ, CF44 9US, CF44 9UW, CF44 9UX, CF44 9UY, CF44 9UZ, CF44 9YG, CF44 9YJ, CF44 9YN, CF44 9YX",261,228,33
W00006479,CF44,"CF44 0EJ, CF44 0EX, CF44 0ND, CF44 0PJ, CF44 0PX, CF44 0RX, CF44 0TJ, CF44 0TX, CF44 0UX, CF44 0YJ, CF44 0YX, CF44 9JU, CF44 9JX, CF44 9JY, CF44 9JZ, CF44 9QB, CF44 9QL, CF44 9SJ, CF44 9SQ, CF48 2HU",311,251,60
W00006480,CF44,"CF44 9AJ, CF44 9AX, CF44 9NX, CF44 9PX, CF44 9QJ, CF44 9UG, CF44 9UH, CF44 9UN, CF44 9UP, CF44 9UT, CF44 9WY, CF44 9XN, CF44 9YE, CF44 9YL, CF44 9YW, CF44 9YY, CF44 9YZ",283,244,39
W00006481,CF44,"CF44 9HX, CF44 9RJ, CF44 9RX, CF44 9XJ, CF44 9YR, CF44 9YS, CF44 9YT, CF44 9YU, SA11 5NA, SA11 5NF",173,148,25
W00006482,CF44,"CF44 9AZ, CF44 9DJ, CF44 9DX, CF44 9EJ, CF44 9EX, CF44 9HJ, CF44 9LJ, CF44 9LX, CF44 9PJ, CF44 9UD, CF44 9UE, CF44 9UF, CF44 9UL, CF44 9UU, CF44 9XA, CF44 9YA",346,310,36
W00006483,CF44,"CF44 9BJ, CF44 9BX",147,138,9
W00006079,CF44,"CF44 8RP, CF44 8RR, CF44 8RS, CF44 8SA, CF44 8SB",286,252,34
W00006078,CF44,"CF44 8HL, CF44 8HN, CF44 8HS, CF44 8HW, CF44 8LU, CF44 8ND, CF44 8NF, CF44 8UP, CF44 8US, CF44 8XB, CF44 8YJ, CF44 8YL, CF44 8YP, CF44 8YQ",329,283,46
W00006083,CF44,"CF44 7PT, CF44 7RG, CF44 8DE, CF44 8TS, CF44 8UF, CF44 8UG, CF44 8UH, CF44 8UL, CF44 8UN, CF44 8UR, CF44 8UT",258,236,22
W00006426,CF44,"CF44 9AH, CF44 9AL, CF44 9AN, CF44 9AY, CF44 9BE",227,221,6
W00006425,CF44,"CF44 9AP, CF44 9DE, CF44 9DG, CF44 9DL, CF44 9DN, CF44 9DP, CF44 9DS, CF44 9DT, CF44 9DW",316,287,29
W00006000,CF44,"CF44 6HJ, CF44 6HX, CF44 6RJ, CF44 6RX, CF44 6RZ, CF44 6UA",197,181,16
W00006093,CF44,"CF44 8EF, CF44 8EG, CF44 8EL, CF44 8NG",258,229,29
W00006026,CF44,"CF44 6DB, CF44 6LR, CF44 6LS, CF44 6LT",261,245,16
W00006025,CF44,"CF44 6LB, CF44 6LD, CF44 6LE, CF44 6PR",334,316,18
W00006024,CF44,"CF44 6EA, CF44 6HD, CF44 6LL, CF44 6LN, CF44 6XA, CF44 6XS, CF44 6XT, CF44 6XU, CF44 6XY, CF44 6YQ, CF44 6YX, CF44 6YZ",250,220,30
W00006023,CF44,"CF44 6HR, CF44 6NS, CF44 6NU, CF44 6NY, CF44 6PA, CF44 6PB, CF44 6PD, CF44 6PE, CF44 6PF, CF44 6PP, CF44 6PT, CF44 6PW",284,257,27
W00006022,CF44,"CF44 6AY, CF44 6BA, CF44 6BF, CF44 6BL, CF44 6BP, CF44 6BS, CF44 6BT, CF44 6BU, CF44 6BW, CF44 6DX",368,327,41
W00006021,CF44,"CF44 6HT, CF44 6HU, CF44 6HY, CF44 6PQ",194,185,9
W00006020,CF44,"CF44 6LA, CF44 6LF, CF44 6LG, CF44 6LH",293,270,23
W00006019,CF44,"CF44 6HL, CF44 6HN, CF44 6HP, CF44 6HS, CF44 6HW",316,291,25
W00006018,CF44,"CF44 6AB, CF44 6AF, CF44 6AG, CF44 6AH, CF44 6AN",286,264,22
W00006017,CF44,"CF44 6AD, CF44 6AE, CF44 6AL, CF44 6AP, CF44 6AR, CF44 6AS, CF44 6AT, CF44 6AW, CF44 6BE",257,238,19
W00006016,CF44,"CF44 6LY, CF44 6NA, CF44 6NB, CF44 6ND, CF44 6NE, CF44 6NF, CF44 6NG, CF44 6NH, CF44 6PS",258,237,21
W00006015,CF44,"CF44 6BJ, CF44 6DW, CF44 6LU, CF44 6NL, CF44 6NN, CF44 6NP, CF44 6NR, CF44 6NT, CF44 6NW, CF44 6PG, CF44 6PL, CF44 6PN",312,285,27
W00006014,CF44,"CF44 6HE, CF44 6HF, CF44 6HG, CF44 6HH",328,297,31
W00006013,CF44,"CF44 6EF, CF44 6EG, CF44 6EL, CF44 6EN, CF44 6EP, CF44 6EW",263,236,27
W00006012,CF44,"CF44 6EQ, CF44 6SB, CF44 6SD, CF44 6SE, CF44 6SF, CF44 6SG",303,273,30
W00006011,CF44,"CF44 6EU, CF44 6PY, CF44 6RB, CF44 6RD, CF44 6RL, CF44 6US, CF44 6UY, CF44 6YA",271,240,31
W00006010,CF44,"CF44 6EZ, CF44 6RG, CF44 6RH, CF44 6RN, CF44 6RP, CF44 6RR, CF44 6RS, CF44 6RW, CF44 6TH",247,228,19
W00006009,CF44,"CF44 6RA, CF44 6UP, CF44 6UR, CF44 6UT, CF44 6UU, CF44 6UX, CF44 6XP, CF44 6XX, CF44 6YU, CF44 6YW",283,260,23
W00006008,CF44,"CF44 6TP, CF44 6TR, CF44 6UG, CF44 6UH, CF44 6UL, CF44 6UN, CF44 6UW, CF44 6YY",315,281,34
W00006007,CF44,"CF44 6TS, CF44 6TT, CF44 6TU, CF44 6TY, CF44 6UB, CF44 6UD, CF44 6UE, CF44 6UF",255,224,31
W00006006,CF44,"CF44 6BQ, CF44 6EJ, CF44 6PH, CF44 6PJ, CF44 6TL, CF44 6TN, CF44 6TQ, CF44 6TW, CF44 6TZ, CF44 6YR, CF44 6YS, CF44 6YT",278,260,18
W00006005,CF44,"CF44 6DE, CF44 6DY",213,199,14
W00006004,CF44,"CF44 6DD, CF44 6EB, CF44 6ED, CF44 6EE",343,305,38
W00006003,CF44,"CF44 6DF, CF44 6DG, CF44 6DJ, CF44 6DT, CF44 6DU",246,233,13
W00006092,CF44,"CF44 8RA, CF44 8TN, CF44 8TP, CF44 8TR, CF44 8TW",289,256,33
W00006002,CF44,"CF44 6AJ, CF44 6RU, CF44 6TF, CF44 6TG",138,131,7
W00006001,CF44,"CF44 6EH, CF44 6EX, CF44 6JA, CF44 6JB, CF44 6WY, CF44 6YN, CF44 6YP",367,338,29
W00006091,CF44,"CF44 8RF, CF44 8RG, CF44 8RH",144,137,7
W00010300,CF44,"CF44 0AD, CF44 0AE, CF44 0AG, CF44 0AP, CF44 0AW, CF44 0AY, CF44 0BL, CF44 0NP, CF44 0PU, CF44 0PW",193,183,10
W00010301,CF44,"CF44 0LX, CF48 1BW, CF48 1NS, CF48 1PB, CF48 1PL",379,330,49
W00006049,CF45,"CF45 4EH, CF45 4EL, CF45 4EW, CF45 4UA, CF45 4UB, CF45 4UL, CF45 4UP, CF45 4UR, CF45 4UU, CF45 4UW, CF45 4YA",261,231,30
W00006338,CF45,"CF45 4AL, CF45 4AN, CF45 4AR, CF45 4AS, CF45 4BA, CF45 4DD, CF45 4DE",367,312,55
W00006048,CF45,"CF45 4EN, CF45 4RR, CF45 4SA, CF45 4SW, CF45 4TD, CF45 4TF, CF45 4TG, CF45 4UE, CF45 4UJ, CF45 4UT, CF45 4YX",236,199,37
W00006358,CF45,"CF45 3NU, CF45 3PA, CF45 3PB, CF45 3PD, CF45 3RR, CF45 3RU",246,217,29
W00006046,CF45,"CF45 4LY, CF45 4NA, CF45 4NB, CF45 4ND, CF45 4NE",239,218,21
W00006361,CF45,"CF45 3EU, CF45 3EY, CF45 3HA, CF45 3HD, CF45 3HF, CF45 3NL, CF45 3NN, CF45 3NS, CF45 3NT, CF45 3NW, CF45 3NY, CF45 3PE, CF45 3PF, CF45 3PG, CF45 3PL, CF45 3PN, CF45 3WZ, CF45 3XA, CF45 3XD, CF45 3XJ, CF45 3ZR, CF45 4XB, CF45 4XD, CF45 4XF, CF45 4YQ, CF45 4YZ, CF45 9AA, CF45 9AB, CF45 9AE, CF45 9AF, CF45 9AG",191,176,15
W00006362,CF45,"CF45 3AH, CF45 3AN, CF45 3AW, CF45 3AY",267,245,22
W00006363,CF45,"CF45 3AG, CF45 3DA, CF45 3SD, CF45 3SW, CF45 3UE, CF45 3UF, CF45 3UH, CF45 3UL, CF45 3UN, CF45 3UW",244,227,17
W00006364,CF45,"CF45 3AL, CF45 3BB, CF45 3BD, CF45 3TD, CF45 3XB, CF45 3XE, CF45 3XF, CF45 3XG",314,287,27
W00006365,CF45,"CF45 3BG, CF45 3BH, CF45 3BX, CF45 3ND, CF45 3NE, CF45 3UX",330,303,27
W00006366,CF45,"CF45 3BE, CF45 3BP, CF45 3BT, CF45 3YU, CF45 3YX, CF45 3YY, CF45 3YZ",289,271,18
W00006367,CF45,"CF45 3SG, CF45 3SH, CF45 3TT, CF45 3UR, CF45 3UT, CF45 3UY",246,224,22
W00006047,CF45,"CF45 4SJ, CF45 4TP, CF45 4TR, CF45 4TW",243,212,31
W00006369,CF45,"CF45 3YL, CF45 3YP, CF45 3YW",244,216,28
W00006030,CF45,"CF45 4TY, CF45 4UD, CF45 4UF, CF45 4UG, CF45 4UH, CF45 4UN",276,236,40
W00006370,CF45,"CF45 3BL, CF45 3BN, CF45 3BW, CF45 3YR, CF45 3YS, CF45 3YT",259,234,25
W00006029,CF45,"CF45 4TH, CF45 4TL, CF45 4TN, CF45 4TS, CF45 4TT, CF45 4TU, CF45 4TX",313,263,50
W00006371,CF45,"CF45 3SE, CF45 3SF, CF45 3SL, CF45 3SN, CF45 3SR, CF45 3UU",298,256,42
W00006372,CF45,"CF45 3SJ, CF45 3TJ, CF45 3YA, CF45 3YH",271,249,22
W00006373,CF45,"CF45 3SS, CF45 3SU, CF45 3SY, CF45 3TA, CF45 3TE",287,261,26
W00006374,CF45,"CF45 3SP, CF45 3SQ, CF45 3YB, CF45 3YD, CF45 3YE, CF45 3YF, CF45 3YG, CF45 3YQ",269,238,31
W00006375,CF45,"CF45 3DJ, CF45 3DX, CF45 3EJ, CF45 3EX, CF45 3LJ, CF45 3PJ, CF45 3YJ",378,348,30
W00006376,CF45,"CF45 3HJ, CF45 3LX, CF45 3PX, CF45 3RX",211,198,13
W00006377,CF45,"CF45 3HX, CF45 3NJ, CF45 3NX, CF45 3NZ, CF45 3RJ, CF45 3SX, CF45 3TX",260,241,19
W00006378,CF45,"CF45 3ST, CF45 3TB, CF45 3TL, CF45 3TN",316,284,32
W00006379,CF45,"CF45 3TF, CF45 3TG, CF45 3TH, CF45 3TP, CF45 3TR, CF45 3TU, CF45 3TW, CF45 3UJ",288,265,23
W00006380,CF45,"CF45 3AE, CF45 3AF, CF45 3AP, CF45 3TZ, CF45 3UB, CF45 3UD",265,236,29
W00006381,CF45,"CF45 3AR, CF45 3AS, CF45 3AT, CF45 3AU, CF45 3BA",297,275,22
W00006343,CF45,"CF45 4DR, CF45 4DU, CF45 4DY, CF45 4DZ, CF45 4EA, CF45 4EB, CF45 4EE, CF45 4ET",291,255,36
W00006346,CF45,"CF45 4AA, CF45 4BE, CF45 4BL, CF45 4BN, CF45 4BS, CF45 4EU, CF45 4FJ, CF45 4HU",248,222,26
W00006345,CF45,"CF45 4AD, CF45 4AE, CF45 4AF, CF45 4AG, CF45 4AH, CF45 4AP, CF45 4AQ, CF45 4AW, CF45 4BD, CF45 4DA, CF45 4DF",371,310,61
W00006344,CF45,"CF45 4BZ, CF45 4DB, CF45 4DG, CF45 4DH, CF45 4DL, CF45 4DN, CF45 4DP, CF45 4DS, CF45 4DT, CF45 4DW, CF45 4ES",240,212,28
W00006031,CF45,"CF45 4NG, CF45 4RU, CF45 4SP, CF45 4ST, CF45 4UY",302,267,35
W00006033,CF45,"CF45 4NN, CF45 4NP, CF45 4NW, CF45 4PR, CF45 4PS, CF45 4PT, CF45 4QA, CF45 4SR, CF45 4SS",229,210,19
W00006368,CF45,"CF45 3AJ, CF45 3BS, CF45 3BU, CF45 3BY, CF45 3DB, CF45 3UG, CF45 3UP, CF45 3YN",225,197,28
W00006035,CF45,"CF45 4PU, CF45 4PW, CF45 4PY, CF45 4RL, CF45 4RN, CF45 4RW",263,237,26
W00006045,CF45,"CF45 4AJ, CF45 4BJ, CF45 4LJ, CF45 4LT, CF45 4SF, CF45 4YU, CF45 4YY",322,300,22
W00006044,CF45,"CF45 4AX, CF45 4BU, CF45 4BX, CF45 4BY, CF45 4DQ, CF45 4EJ, CF45 4LU, CF45 4NF, CF45 4NH, CF45 4RJ, CF45 4RX",324,298,26
W00006043,CF45,"CF45 4DJ, CF45 4DX, CF45 4LX, CF45 4XE, CF45 4XZ, CF45 4YP, CF45 4YR, CF45 4YS, CF45 4YT, CF45 4YW",322,292,30
W00006042,CF45,"CF45 4YE, CF45 4YF, CF45 4YG, CF45 4YH, CF45 4YJ, CF45 4YL, CF45 4YN",316,288,28
W00006339,CF45,"CF45 4AT, CF45 4AU, CF45 4AY, CF45 4BB, CF45 4BG, CF45 4BH, CF45 4LF",326,289,37
W00006347,CF45,"CF45 3AA, CF45 3AB, CF45 3AD, CF45 3TS, CF45 3UA, CF45 3UQ, CF45 3US, CF45 3UZ",329,297,32
W00006340,CF45,"CF45 4BP, CF45 4BQ, CF45 4BW, CF45 4HY, CF45 4LB, CF45 4LD, CF45 4LE, CF45 4LH, CF45 4LW",274,249,25
W00006341,CF45,"CF45 4AB, CF45 4EY, CF45 4FB, CF45 4FD, CF45 4FE, CF45 4FF, CF45 4FG, CF45 4FH, CF45 4HA, CF45 4HB, CF45 4HD, CF45 4HE, CF45 4HF, CF45 4HR, CF45 4HS, CF45 4HT, CF45 4LA, CF45 4LG, CF45 4LL, CF45 4LN",500,429,71
W00006034,CF45,"CF45 4RA, CF45 4RD, CF45 4RF, CF45 4RG, CF45 4SU, CF45 4SY, CF45 4YB, CF45 4YD",243,223,20
W00006041,CF45,"CF45 4EX, CF45 4PJ",388,345,43
W00006040,CF45,"CF45 4AZ, CF45 4BT, CF45 4EP, CF45 4LP, CF45 4LR, CF45 4LS, CF45 4SG",430,378,52
W00006349,CF45,"CF45 3LG, CF45 3LH, CF45 3LR, CF45 3LS",301,272,29
W00006342,CF45,"CF45 4EG, CF45 4ER, CF45 4HG, CF45 4HH, CF45 4HJ, CF45 4HL, CF45 4HN, CF45 4HP, CF45 4HW",278,256,22
W00006348,CF45,"CF45 3HS, CF45 3LE, CF45 3LF, CF45 3NG, CF45 3RL, CF45 3RN, CF45 3RP, CF45 3RS, CF45 3RT, CF45 3RW",250,217,33
W00006039,CF45,"CF45 4PG, CF45 4PH, CF45 4PL, CF45 4PN",281,258,23
W00006360,CF45,"CF45 3DU, CF45 3EL",307,268,39
W00006359,CF45,"CF45 3EE, CF45 3EP, CF45 3ER, CF45 3EW",225,213,12
W00006357,CF45,"CF45 3NR, CF45 3PP, CF45 3PR, CF45 3PS, CF45 3PT, CF45 3PU, CF45 3PW, CF45 3PY, CF45 3RA, CF45 3RB",259,233,26
W00006350,CF45,"CF45 3HB, CF45 3HE, CF45 3HG, CF45 3HH, CF45 3HL, CF45 3HN, CF45 3HP, CF45 3HR, CF45 3HT, CF45 3HW, CF45 3HY, CF45 3LA, CF45 3LD, CF45 3PH",236,220,16
W00006355,CF45,"CF45 3EF, CF45 3EG, CF45 3EH, CF45 3EN",343,324,19
W00006354,CF45,"CF45 3LU, CF45 3LW, CF45 3NB, CF45 3NF",234,220,14
W00006036,CF45,"CF45 4NR, CF45 4NS, CF45 4NT, CF45 4NU, CF45 4NY",267,235,32
W00006353,CF45,"CF45 3RD, CF45 3RE, CF45 3RF, CF45 3RG, CF45 3RH",273,240,33
W00006356,CF45,"CF45 3DG, CF45 3DH, CF45 3DL, CF45 3DN, CF45 3DP, CF45 3DR, CF45 3DS, CF45 3DT, CF45 3DW",356,309,47
W00006038,CF45,"CF45 4FA, CF45 4PA, CF45 4PB, CF45 4PD, CF45 4PF, CF45 4RP, CF45 4TQ",251,222,29
W00006352,CF45,"CF45 3HU, CF45 3LB, CF45 3LL, CF45 3LN, CF45 3LP",251,222,29
W00006351,CF45,"CF45 3LT, CF45 3LY, CF45 3NA",325,280,45
W00006037,CF45,"CF45 4RB, CF45 4RE, CF45 4RH, CF45 4TA, CF45 4TB, CF45 4TE, CF45 4TJ",280,259,21
W00006914,CF46,"CF46 5LA, CF46 5LB, CF46 5PP",231,206,25
W00006930,CF46,"CF46 5AY, CF46 5BW",211,195,16
W00006927,CF46,"CF46 5NJ, CF46 5NR, CF46 5NT, CF46 5NU, CF46 5NY, CF46 5NZ, CF46 5PA, CF46 5PQ, CF46 5PU",336,297,39
W00006925,CF46,"CF46 5AD, CF46 5AJ, CF46 5AP, CF46 5AS, CF46 5AT, CF46 5AU, CF46 5AW, CF46 5BN, CF46 5DY, CF46 5YB",304,265,39
W00006924,CF46,"CF46 5AE, CF46 5AF, CF46 5LP, CF46 5LW, CF46 5NA, CF46 5NB, CF46 5NG, CF46 5NL, CF46 5NQ",317,286,31
W00006923,CF46,"CF46 5EL, CF46 5ET, CF46 5EY, CF46 5HB, CF46 5HE, CF46 5HF, CF46 5LE, CF46 5LF, CF46 5PR, CF46 5PS, CF46 5YA, CF46 5YE, CF46 5YF, CF46 5YQ, CF46 6XZ, CF46 6YA, CF46 6YB, CF46 6YF, CF46 6YH, CF46 6YQ, CF46 6YU, CF46 9AB, CF46 9AD, CF46 9AE, CF46 9AF, CF46 9AG, CF46 9AH, CF46 9AJ, CF46 9AL, CF46 9AN, CF46 9AP",272,250,22
W00006922,CF46,"CF46 5AA, CF46 5BJ, CF46 5LG, CF46 5LH, CF46 5LL, CF46 5LN, CF46 5LU, CF46 5PY, CF46 5RA, CF46 5RE, CF46 5RF",319,291,28
W00006921,CF46,"CF46 5HH, CF46 5PT, CF46 5RB, CF46 5RG, CF46 5RH, CF46 5RJ, CF46 5RW",301,258,43
W00006919,CF46,"CF46 5LR, CF46 5LS, CF46 5LT, CF46 5LY, CF46 5RL",302,261,41
W00006918,CF46,"CF46 5HA, CF46 5HG, CF46 5HR, CF46 5HS, CF46 5HX, CF46 5RD",316,277,39
W00010270,CF46,"CF46 6DJ, CF46 6DN, CF46 6DP, CF46 6DW",139,128,11
W00006911,CF46,"CF46 5BH, CF46 5DG, CF46 5DH, CF46 5DL, CF46 5DN, CF46 5DP, CF46 5DR, CF46 5DS, CF46 5DT, CF46 5DU, CF46 5DW, CF46 5EA, CF46 5EB, CF46 5ED, CF46 5EE, CF46 5EF, CF46 5EG, CF46 5EH, CF46 6ST",258,219,39
W00006917,CF46,"CF46 5EX, CF46 5HD, CF46 5HL, CF46 5HY, CF46 5RP, CF46 5RT, CF46 5RX, CF46 5RY, CF46 5RZ, CF46 5WA, CF46 5YD, CF46 6BH",422,362,60
W00006916,CF46,"CF46 5HT, CF46 5HU, CF46 5NS, CF46 5PB, CF46 5PD, CF46 5PE, CF46 5PF, CF46 5PG, CF46 5RN, CF46 6BW, CF46 6TB",368,341,27
W00006915,CF46,"CF46 5HQ, CF46 5LX, CF46 5PJ, CF46 5PL, CF46 5PN",346,296,50
W00006912,CF46,"CF46 5BS, CF46 5BT, CF46 5BU, CF46 5BY, CF46 5BZ, CF46 5DB, CF46 5DD, CF46 5DE, CF46 5DF, CF46 5EN",304,264,40
W00006913,CF46,"CF46 5BA, CF46 5BB, CF46 5BD, CF46 5BE, CF46 5BG, CF46 5BL, CF46 5BP",252,223,29
W00006920,CF46,"CF46 5HN, CF46 5HP, CF46 5HW",280,253,27
W00006926,CF46,"CF46 5AB, CF46 5AH, CF46 5AL, CF46 5AN, CF46 5AR, CF46 5ER, CF46 5ES, CF46 5EU, CF46 5EW, CF46 5RU",260,238,22
W00006928,CF46,"CF46 5AG, CF46 5DA, CF46 5HJ, CF46 5LD, CF46 5LJ, CF46 5LQ",426,362,64
W00007403,CF46,"CF46 6BF, CF46 6EP, CF46 6ER, CF8 8DU, CF8 8DW, CF8 8DX, CF8 8ER, CF8 8FU, CF8 8FY, CF8 8FZ, CF82 8DU, CF82 8DW, CF82 8DX, CF82 8ER, CF82 8FU, CF82 8FY, CF82 8FZ",261,228,33
W00006839,CF46,"CF46 5JD, CF48 4PD, CF48 4PE, CF48 4PF, CF48 4PG, CF48 4PZ, CF48 4SZ",345,316,29
W00006879,CF46,"CF46 6UE, CF48 4LH, CF48 4LJ, CF48 4LL, CF48 4LN, CF48 4LP, CF48 4LR, CF48 4LT, CF48 4LU, CF48 4LW, CF48 4LZ, CF48 4NA, CF48 4NB, CF48 4NL, CF48 4QD",276,251,25
W00007228,CF46,"CF46 6HB, CF46 6HL, CF46 6HP, CF46 6HR, CF46 6HW, CF46 6JN",312,275,37
W00007227,CF46,"CF46 6NA, CF46 6NE, CF46 6NG, CF46 6NJ, CF46 6NL, CF46 6NQ",200,187,13
W00007225,CF46,"CF46 6AZ, CF46 6LR, CF46 6NF, CF46 6NP, CF46 6NW, CF46 6PD",280,238,42
W00007224,CF46,"CF46 6HS, CF46 6HT, CF46 6HU, CF46 6LA, CF46 6LB",301,262,39
W00010276,CF46,"CF46 6EE, CF46 6EF, CF46 6EG, CF46 6EJ, CF46 6EQ, CF46 6ET, CF46 6EZ, CF46 6FA, CF46 6FB, CF46 6TD",450,396,54
W00007223,CF46,"CF46 6LG, CF46 6LH, CF46 6LL, CF46 6LN, CF46 6LP",263,237,26
W00007222,CF46,"CF46 6EB, CF46 6ED, CF46 6EH",225,220,5
W00010279,CF46,"CF46 6DB, CF46 6DD",155,145,10
W00007221,CF46,"CF46 6BQ, CF46 6DY, CF46 6EA, CF46 6ES, CF46 6LW",227,212,15
W00007219,CF46,"CF46 6HE, CF46 6HF, CF46 6HH, CF46 6JA, CF46 6JD, CF46 6JE, CF46 6JJ, CF46 6JL, CF46 6LY, CF46 6PF",258,232,26
W00006766,CF46,"CF46 6DA, CF46 6DE, CF46 6DF, CF46 6DG",254,243,11
W00006765,CF46,"CF46 6AA, CF46 6AJ, CF46 6BL, CF46 6BP, CF46 6BS, CF46 6BT, CF46 6BU, CF46 6DH, CF46 6DL, CF46 6DQ, CF46 6YE",374,330,44
W00006763,CF46,"CF46 6AG, CF46 6AH, CF46 6AL, CF46 6AN, CF46 6AP, CF46 6AR, CF46 6AS, CF46 6AT, CF46 6AU, CF46 6AW, CF46 6AX",276,250,26
W00007226,CF46,"CF46 6EU, CF46 6HA, CF46 6HN, CF46 6ND",238,220,18
W00006761,CF46,"CF46 6RE, CF46 6RF, CF46 6TE, CF46 6TF, CF46 6TG, CF46 6TL, CF46 6TQ, CF46 6TS",251,226,25
W00006762,CF46,"CF46 6AE, CF46 6AY, CF46 6BA, CF46 6BB, CF46 6BD, CF46 6BE, CF46 6BG",329,294,35
W00007213,CF46,"CF46 6HQ, CF46 6JB, CF46 6JF, CF46 6JG, CF46 6JH",347,288,59
W00007215,CF46,"CF46 6NR, CF46 6NU, CF46 6NX, CF46 6NY, CF46 6PA, CF46 6PB",266,224,42
W00007216,CF46,"CF46 6DR, CF46 6DS, CF46 6DT, CF46 6DU, CF46 6EL, CF46 6EN, CF46 6EW, CF46 6EX",369,312,57
W00007217,CF46,"CF46 6HD, CF46 6LE, CF46 6LF, CF46 6LU",210,184,26
W00006929,CF46,"CF46 5EP, CF46 5ND, CF46 5NE, CF46 5NF, CF46 5NH, CF46 5NN, CF46 5NP, CF46 5NW, CF46 5NX, CF46 5PH",271,237,34
W00007214,CF46,"CF46 6EY, CF46 6HG, CF46 6HJ, CF46 6HY, CF46 6HZ, CF46 6LS, CF46 6NB, CF46 6PE, CF46 6PG, CF46 6PJ, CF46 6PQ",419,379,40
W00006756,CF46,"CF46 6AB, CF46 6AD, CF46 6AF, CF46 6AQ, CF46 6BJ",328,289,39
W00006757,CF46,"CF46 6RL, CF46 6RT, CF46 6RW, CF46 6RY, CF46 6SD, CF46 6SG, CF46 6UG",241,222,19
W00006758,CF46,"CF46 6RG, CF46 6TY, CF46 6UA, CF46 6UB, CF46 6UD",253,236,17
W00006759,CF46,"CF46 6RH, CF46 6RN, CF46 6RP, CF46 6RR, CF46 6RS, CF46 6RU, CF46 6SA, CF46 6TT, CF46 6TU",252,225,27
W00007218,CF46,"CF46 6NH, CF46 6NN, CF46 6NS, CF46 6NT, CF46 6PT",228,208,20
W00006760,CF46,"CF46 6RD, CF46 6SB, CF46 6SE, CF46 6SF, CF46 6SH, CF46 6SJ, CF46 6SL, CF46 6SN, CF46 6SW, CF46 6TA, CF46 6TH, CF46 6TJ, CF46 6TN, CF46 6TP, CF46 6TR, CF46 6TW, CF46 6UF, CF46 6UH, CF46 6YD",317,293,24
W00006860,CF47,"CF47 9TS, CF47 9TT, CF47 9TU, CF47 9TW, CF47 9TY, CF47 9UA, CF47 9UB, CF47 9UD",329,321,8
W00006859,CF47,"CF47 9EF, CF47 9JN, CF47 9JW, CF47 9TX, CF47 9UJ, CF47 9YJ, CF47 9YX",377,360,17
W00006891,CF47,"CF47 0AB, CF47 0AL, CF47 0AP, CF47 0AW, CF47 0BA, CF47 0BN, CF47 0BP, CF47 0BS, CF47 0BT, CF47 0BU, CF47 0BW, CF47 0BY, CF47 0DP, CF47 0DR, CF47 0DT, CF47 0DU, CF47 0DY, CF47 0EB, CF47 0ES, CF47 0EW, CF47 0HD",342,308,34
W00006858,CF47,"CF47 9ST, CF47 9SU, CF47 9TB, CF47 9TG, CF47 9TL, CF47 9UH, CF47 9UN",281,262,19
W00006855,CF47,"CF47 9DJ, CF47 9DX, CF47 9LW, CF47 9PX, CF47 9YL, CF47 9YN",285,261,24
W00006856,CF47,"CF47 9JA, CF47 9JB, CF47 9JL, CF47 9SY, CF47 9TA",287,270,17
W00006854,CF47,"CF47 8ST, CF47 8SU, CF47 8SY, CF47 8TA, CF47 8TB, CF47 8TD, CF47 8TE, CF47 8TF, CF47 8TG, CF47 8TH, CF47 8TL, CF47 8TN, CF47 8TU",254,231,23
W00006853,CF47,"CF47 8YU, CF47 8YY, CF47 9AB, CF47 9AD, CF47 9AE, CF47 9AG",270,253,17
W00006861,CF47,"CF47 9JD, CF47 9JE, CF47 9JF, CF47 9JH, CF47 9JJ, CF47 9TD, CF47 9TF",319,306,13
W00006851,CF47,"CF47 8DT, CF47 8FG, CF47 8LG, CF47 8LL, CF47 8LN, CF47 8LP, CF47 8LS, CF47 8LT, CF47 8LU, CF47 8LY, CF47 8NA, CF47 8NB, CF47 8ND, CF47 8NE, CF47 8NF, CF47 8NG, CF47 8NH, CF47 8PS, CF47 8PT, CF47 8XB, CF47 8XG, CF47 8XP, CF47 8XS, CF47 8YF, CF47 8YG, CF47 8YH, CF47 8YN",278,265,13
W00006857,CF47,"CF47 9TH, CF47 9TP, CF47 9TR, CF47 9UE, CF47 9UF, CF47 9UG, CF47 9UL",297,283,14
W00006862,CF47,"CF47 9HH, CF47 9HL, CF47 9HN, CF47 9JS, CF47 9NJ, CF47 9RJ, CF47 9SX, CF47 9TJ",291,273,18
W00006869,CF47,"CF47 0SX, CF47 9AF, CF47 9AN, CF47 9AZ, CF47 9BJ, CF47 9HA, CF47 9LB, CF47 9LJ, CF47 9LN",323,301,22
W00006864,CF47,"CF47 9AJ, CF47 9AP, CF47 9AR, CF47 9AX, CF47 9DZ, CF47 9LA, CF47 9YF, CF47 9YR, CF47 9YS",374,355,19
W00006865,CF47,"CF47 9JT, CF47 9SJ, CF47 9UX, CF47 9YT, CF47 9YU",286,270,16
W00006866,CF47,"CF47 9HE, CF47 9HG, CF47 9HP, CF47 9HR, CF47 9HS, CF47 9HW, CF47 9JP, CF47 9LR, CF47 9LS, CF47 9LX, CF47 9XB, CF47 9YA, CF48 3DT",259,246,13
W00006867,CF47,"CF47 9EJ, CF47 9ES, CF47 9EX, CF47 9HJ, CF47 9HX, CF47 9NX, CF47 9PJ, CF47 9RX, CF47 9WP, CF47 9YP, CF47 9YW",268,235,33
W00006868,CF47,"CF47 9UY, CF47 9UZ, CF47 9YD, CF47 9YE, CF47 9YG, CF47 9YH",281,262,19
W00006870,CF47,"CF47 9HT, CF47 9HU, CF47 9HY, CF47 9HZ, CF47 9LD, CF47 9UT, CF47 9UU, CF47 9YB",281,257,24
W00006871,CF47,"CF47 9AL, CF47 9LE, CF47 9LF, CF47 9LG, CF47 9LH, CF47 9LL, CF47 9LP",236,219,17
W00006890,CF47,"CF47 0AS, CF47 0AT, CF47 0AY, CF47 0BD, CF47 0BE, CF47 0BG, CF47 0BH, CF47 0BL, CF47 0ED, CF47 0EE, CF47 0EH, CF47 0ER, CF47 0HB, CF47 0HE, CF47 0HZ, CF47 0LS, CF47 0SJ, CF47 8AA, CF47 8AF, CF47 8AH, CF47 8AP, CF47 8BF, CF47 8JD, CF47 8JE, CF47 8LA, CF47 8SJ, CF47 8SX, CF47 8TX, CF47 8UB, CF47 8UD, CF47 8UE, CF47 8UF, CF47 8UG, CF47 8UH, CF47 8UJ, CF47 8UL, CF47 8UN, CF47 8UP, CF47 8UR, CF47 8UT, CF47 8UU, CF47 8UX, CF47 8YE",352,312,40
W00006894,CF47,"CF47 0DW, CF47 0ET, CF47 0EU, CF47 0JG, CF47 0JH, CF47 0JJ, CF47 0LT, CF47 0LU, CF47 0LW, CF47 0LY, CF47 0NA, CF47 0NT, CF47 0NW, CF47 0PA",388,331,57
W00006893,CF47,"CF47 0AD, CF47 0AE, CF47 0AG, CF47 0AZ, CF47 0EG, CF47 0SG, CF47 0SL, CF47 0XB, CF47 0YJ, CF47 0YQ, CF47 0YT, CF47 0YX, CF47 7AA, CF47 7AB, CF47 7AD, CF47 7AE, CF47 7AF, CF47 7AG, CF47 7AH, CF47 7AJ, CF47 7AL, CF47 7AN, CF47 7AP, CF47 7AQ, CF47 7AR, CF47 7AS, CF47 7AU, CF47 7AW, CF47 7AX, CF47 7AY, CF47 7AZ, CF47 7BA, CF47 7BB, CF47 7BD, CF47 7BE, CF47 7BF, CF47 7BG, CF47 7BH, CF47 7BJ, CF47 7BL, CF47 7BN, CF47 7BP, CF47 7BQ, CF47 7BR, CF47 7BS, CF47 7BT, CF47 7BU, CF47 7BW, CF47 7BX, CF47 7BY, CF47 7BZ, CF47 7DA, CF47 7DB, CF47 7DD, CF47 7DE, CF47 7DF, CF47 7DG, CF47 7DH, CF47 7DJ, CF47 7ZY, CF47 7ZZ, CF47 8AB, CF47 8AD, CF47 8AE, CF47 8AL, CF47 8AN, CF47 8AR, CF47 8AT, CF47 8AU, CF47 8AW, CF47 8AY, CF47 8BA, CF47 8BB, CF47 8BD, CF47 8BE, CF47 8BG, CF47 8BL, CF47 8BN, CF47 8BP, CF47 8BS, CF47 8BT, CF47 8BU, CF47 8BW, CF47 8BY, CF47 8DA, CF47 8DB, CF47 8DD, CF47 8DE, CF47 8DF, CF47 8DG, CF47 8DH, CF47 8DL, CF47 8DN, CF47 8DP, CF47 8DS, CF47 8DU, CF47 8DW, CF47 8DY, CF47 8EA, CF47 8EB, CF47 8ED, CF47 8EE, CF47 8EF, CF47 8EG, CF47 8EH, CF47 8EL, CF47 8EN, CF47 8EP, CF47 8ER, CF47 8ES, CF47 8ET, CF47 8EU, CF47 8EW, CF47 8HB, CF47 8HE, CF47 8HG, CF47 8HL, CF47 8JA, CF47 8JB, CF47 8JG, CF47 8JH, CF47 8JJ, CF47 8JL, CF47 8QA, CF47 8QB, CF47 8TJ, CF47 8UA, CF47 8XH, CF47 8XJ, CF47 8XN, CF47 8XQ, CF47 8XR, CF47 8XT, CF47 8YA, CF47 8YB, CF47 8YX, CF47 8ZA, CF47 8ZB, CF47 9XA, CF47 9XD, CF47 9XE, CF47 9XG, CF47 9XP, CF47 9XQ, CF48 1XB, CF48 1XE, CF48 1XG, CF48 1YD, CF48 1YJ, CF48 1ZP, CF48 2WZ, CF48 2YD, CF48 2YT, CF48 3YJ, CF48 4YA, CF48 4YF, CF48 4YG, CF48 4YH",277,251,26
W00006850,CF47,"CF47 8LQ, CF47 8LZ, CF47 8NL, CF47 8NW, CF47 8PU, CF47 8PW, CF48 1BN",191,186,5
W00006863,CF47,"CF47 9JG, CF47 9TE, CF47 9TN, CF47 9YY",273,252,21
W00006849,CF47,"CF47 8RL, CF47 8RN, CF47 8RP, CF47 8RR, CF47 8RS, CF47 8RT, CF47 8RU, CF47 8RW, CF47 8SB, CF47 8SD, CF47 8SN",283,260,23
W00006842,CF47,"CF47 0DJ, CF47 0DX, CF47 0EJ, CF47 0EN, CF47 0EX, CF47 0HJ, CF47 0HX, CF47 0RJ, CF47 0RX, CF48 3AJ",301,282,19
W00006847,CF47,"CF47 8RY, CF47 8SE, CF47 8SF, CF47 8SL, CF47 8SP, CF47 8SW",314,300,14
W00006814,CF47,"CF47 9BE, CF47 9BP, CF47 9BU, CF47 9BY, CF47 9SA, CF47 9SG",347,320,27
W00006813,CF47,"CF47 9BG, CF47 9BH, CF47 9BL, CF47 9BN, CF47 9BW",271,257,14
W00006812,CF47,"CF47 8RD, CF48 1EN, CF48 1EW",254,223,31
W00006811,CF47,"CF47 9BX, CF47 9DU, CF47 9DY, CF47 9EA, CF47 9EB, CF47 9ED, CF47 9EE",306,274,32
W00006810,CF47,"CF47 9SB, CF47 9SD, CF47 9SE",254,250,4
W00006799,CF47,"CF47 0AH, CF48 3AB, CF48 3AN, CF48 3AP, CF48 3AW, CF48 3BG, CF48 3BH, CF48 3BT, CF48 3BU, CF48 3BY, CF48 3DA, CF48 3DB, CF48 3DH, CF48 3DL, CF48 3DN, CF48 3DP, CF48 3DW, CF48 3EF, CF48 3EH, CF48 3EU, CF48 3EY, CF48 3HU, CF48 3LS, CF48 3RJ, CF48 3RL, CF48 3SR, CF48 3TB, CF48 3TD, CF48 3TE, CF48 3TF, CF48 3TG, CF48 3TH, CF48 3YA, CF48 3YD",354,341,13
W00006896,CF47,"CF47 0JP, CF47 0RN, CF47 0RP, CF47 0RW, CF47 0SE, CF47 0TU, CF47 0TY, CF47 0YP, CF47 0YS, CF47 0YW",281,269,12
W00006897,CF47,"CF47 0AN, CF47 0NJ, CF47 0PB, CF47 0PF, CF47 0PG, CF47 0PH, CF47 0PL, CF47 0PN, CF47 0SP",339,297,42
W00006895,CF47,"CF47 0JR, CF47 0NB, CF47 0NG, CF47 0NH, CF47 0NL, CF47 0NN, CF47 0NP, CF47 0NR, CF47 0NS, CF47 0NU, CF47 0NY, CF47 0XA, CF47 0ZG",282,241,41
W00006780,CF47,"CF47 8NJ, CF48 1AE, CF48 1AL, CF48 1DH, CF48 1DL, CF48 1UP, CF48 1UR, CF48 1UT, CF48 1UW, CF48 1UZ",209,198,11
W00006899,CF47,"CF47 0ND, CF47 0NE, CF47 0NF, CF47 0PP, CF47 0PR, CF47 0PW, CF47 0RD, CF47 0TH, CF47 0TL, CF47 0TN",278,253,25
W00006901,CF47,"CF47 0DG, CF47 0DN, CF47 0DS, CF47 0RG, CF47 0RR, CF47 0RS, CF47 0RT, CF47 0RU, CF47 0RY, CF47 0SA, CF47 0SB, CF47 0SD, CF47 0SF",268,238,30
W00006902,CF47,"CF47 0PS, CF47 0PT, CF47 0PU, CF47 0PY, CF47 0RA, CF47 0RB, CF47 0RE, CF47 0RF, CF47 0RH, CF47 0RL",269,245,24
W00006903,CF47,"CF47 0TD, CF47 0TE, CF47 0TF, CF47 0TG, CF47 0TQ",277,247,30
W00006904,CF47,"CF47 0ST, CF47 0SU, CF47 0SY, CF47 0TA",246,216,30
W00006905,CF47,"CF47 0AQ, CF47 0TB, CF47 0UA, CF47 0UH, CF47 0UL, CF47 0US, CF47 0YU, CF47 0YY",421,373,48
W00006906,CF47,"CF47 0BB, CF47 0TT, CF47 0UB, CF47 0UD, CF47 0UE, CF47 0UF, CF47 0UG, CF47 0UY, CF47 0XD, CF47 0YE, CF47 0YF, CF47 0YG, CF47 0YH, CF47 0YN, CF47 0YR",330,297,33
W00006907,CF47,"CF47 0TP, CF47 0TS, CF47 0UN, CF47 0UP, CF47 0UR, CF47 0UT, CF47 0UU, CF47 0UW, CF47 0YA, CF47 0YB, CF47 0YD, CF47 0YL, CF48 1YA, CF48 1YB",290,266,24
W00006898,CF47,"CF47 8HA, CF47 8HD, CF47 8HF, CF47 8HH, CF47 8HN, CF47 8HP, CF47 8HR, CF47 8HW",188,173,15
W00006848,CF47,"CF47 8NS, CF47 8PD, CF47 8PE, CF47 8PF, CF47 8PG, CF47 8PH, CF47 8PL, CF48 1BD, CF48 1BH, CF48 1BP, CF48 1BS, CF48 1BT, CF48 1BU, CF48 1DA, CF48 1DF, CF48 1HY, CF48 1NP, CF48 1NT",280,258,22
W00006815,CF47,"CF47 9DA, CF47 9DB, CF47 9DD, CF47 9DE, CF47 9DF, CF47 9DR, CF47 9DS",447,430,17
W00006816,CF47,"CF47 9DG, CF47 9DH, CF47 9DL, CF47 9DN, CF47 9DP, CF47 9DW",404,383,21
W00006846,CF47,"CF47 8HJ, CF47 8PJ, CF47 8PX, CF47 8QE, CF47 8SG, CF47 8SH, CF47 8SR, CF47 8SS",301,266,35
W00006845,CF47,"CF47 0PJ, CF47 8AG, CF47 8AZ, CF47 8EJ, CF47 8EX, CF47 8HX, CF47 8QD, CF47 8RF, CF47 8RG, CF47 8RH, CF47 8RJ, CF47 8UW, CF47 8UY, CF47 8XL, CF47 8YP, CF47 8YQ, CF47 8YR, CF47 8YW",285,267,18
W00006844,CF47,"CF47 8AJ, CF47 8YJ, CF47 8YL, CF47 8YS, CF47 8YT, CF47 8YZ, CF47 9AA, CF47 9AH, CF47 9AQ, CF47 9BZ, CF47 9ET",336,301,35
W00006843,CF47,"CF47 8NR, CF47 8NT, CF47 8NU, CF47 8NY, CF47 8PA, CF47 8PB, CF47 8PN, CF47 8PQ, CF47 8PR, CF47 8RA, CF47 8RB, CF47 8RE, CF48 1EP, CF48 1NR",236,225,11
W00006909,CF47,"CF47 0HG, CF47 0HH, CF47 0HL, CF47 0HN, CF47 0HP, CF47 0HR, CF47 0HW, CF47 0UQ",301,275,26
W00006841,CF47,"CF47 8NN, CF47 8NP, CF47 8PP, CF47 8SA, CF47 8TP, CF47 8TR, CF47 8TS, CF47 8TT, CF47 8TW",227,210,17
W00006840,CF47,"CF47 0AF, CF47 8AQ, CF47 8AS, CF47 8BH, CF47 8DR, CF47 8HU, CF47 8HY, CF47 8LB, CF47 8LD, CF47 8LE, CF47 8LF, CF47 8LH, CF47 8LR, CF47 8LW, CF47 8PY, CF47 8XA, CF47 8XD, CF47 8XE, CF47 8XF, CF48 1AY, CF48 1EB, CF48 1EF, CF48 1EG, CF48 1EL",211,203,8
W00006910,CF47,"CF47 0AJ, CF47 0AU, CF47 0AX, CF47 0BJ, CF47 0BX, CF47 0EL, CF47 0HF, CF47 0LJ, CF47 0LP, CF47 0LQ, CF47 0PX, CF47 8YD",234,221,13
W00010274,CF47,"CF47 8NX, CF48 1AG, CF48 1AH, CF48 1AN",185,166,19
W00006826,CF47,"CF47 8AX, CF47 8BJ, CF47 8BX, CF47 8DJ, CF47 8DX, CF47 8EY, CF47 8LJ, CF47 8LX, CF47 9NH, CF47 9NL, CF47 9NN, CF47 9NP, CF47 9NS, CF47 9RG, CF47 9RP",323,308,15
W00006824,CF47,"CF47 9PG, CF47 9PL, CF47 9PN, CF47 9PW, CF47 9RB, CF47 9RD, CF47 9RE",307,296,11
W00006823,CF47,"CF47 9AW, CF47 9RF, CF47 9RR, CF47 9RS, CF47 9RW",319,295,24
W00006822,CF47,"CF47 9RT, CF47 9RU, CF47 9SW, CF47 9XF, CF47 9XH, CF47 9XJ, CF47 9XL, CF47 9XN, CF47 9YZ",362,336,26
W00006821,CF47,"CF47 9NU, CF47 9PD, CF47 9PE, CF47 9PF, CF47 9PP, CF47 9PU, CF47 9RA",289,277,12
W00006820,CF47,"CF47 9AT, CF47 9AU, CF47 9AY, CF47 9BA, CF47 9PB, CF47 9PR, CF47 9PS, CF47 9PT, CF47 9PY",283,269,14
W00006819,CF47,"CF47 9AS, CF47 9RY, CF47 9SL, CF47 9SN",254,250,4
W00006818,CF47,"CF47 9BS, CF47 9BT, CF47 9SF, CF47 9SH",255,246,9
W00006817,CF47,"CF47 9BB, CF47 9BD, CF47 9BR, CF47 9DQ, CF47 9DT",185,179,6
W00006825,CF47,"CF47 9NR, CF47 9NT, CF47 9NW, CF47 9NY, CF47 9PA, CF47 9PH",267,262,5
W00006900,CF47,"CF47 0AA, CF47 0AR, CF47 0LZ, CF47 0PE, CF47 0SR, CF47 0SS, CF47 0TX, CF47 0UX, CF48 4AF, CF48 4AG, CF48 4AH, CF48 4AJ, CF48 4AQ",470,409,61
W00006892,CF47,"CF47 0DA, CF47 0DB, CF47 0DE, CF47 0DF, CF47 0DH, CF47 0DL, CF47 0DQ, CF47 0EF, CF47 0SH",265,247,18
W00010281,CF47,"CF47 0JF, CF47 0JL",102,93,9
W00010111,CF47,"CF47 0EY, CF47 0GA, CF47 0GE, CF47 0HA, CF47 0HQ, CF47 0HS, CF47 0HT, CF47 0HY",353,323,30
W00010110,CF47,"CF47 0JA, CF47 0JD, CF47 0LA, CF47 0NQ",283,249,34
W00010109,CF47,"CF47 0GB, CF47 0GD, CF47 0GF, CF47 0HU, CF47 0JB, CF47 0TJ",390,344,46
W00010268,CF47,"CF47 0JE, CF47 0LB, CF47 0LD, CF47 0LE, CF47 0LF, CF47 0LG, CF47 0LH, CF47 0LL, CF47 0LN, CF47 0LR, CF47 0LX, CF47 0PD, CF47 0SN, CF47 0UJ, CF48 4AP",452,402,50
W00006790,CF48,"CF48 3BB, CF48 3BD, CF48 3BE, CF48 3BN, CF48 3BP, CF48 3BS, CF48 3BW, CF48 3SA, CF48 3SB, CF48 3SD",278,253,25
W00006791,CF48,"CF48 3ND, CF48 3NE, CF48 3NF, CF48 3NG, CF48 3NP, CF48 3NU, CF48 3TA",304,277,27
W00006792,CF48,"CF48 3RU, CF48 3RY, CF48 3SE, CF48 3SF, CF48 3SG, CF48 3SQ, CF48 3SW",280,251,29
W00006793,CF48,"CF48 3AD, CF48 3AF, CF48 3AT, CF48 3AY, CF48 3LW, CF48 3RN, CF48 3RP, CF48 3RS",254,235,19
W00006789,CF48,"CF48 3NH, CF48 3NJ, CF48 3NL, CF48 3NN, CF48 3NQ, CF48 3NR, CF48 3NS, CF48 3NT, CF48 3NW, CF48 3SP",295,279,16
W00006794,CF48,"CF48 3NB, CF48 3NY, CF48 3PB, CF48 3RD",231,218,13
W00006796,CF48,"CF48 2AJ, CF48 3AG, CF48 3ER, CF48 3HL, CF48 3HN, CF48 3HP, CF48 3HR, CF48 3HS, CF48 3HT, CF48 3HW, CF48 3HY, CF48 3LA, CF48 3LB, CF48 3LE, CF48 3LF, CF48 3LG, CF48 3LH, CF48 3LJ, CF48 3LL, CF48 3LN, CF48 3NA, CF48 3YE",266,244,22
W00006797,CF48,"CF48 3AH, CF48 3AL, CF48 3AR, CF48 3AS, CF48 3BA",241,227,14
W00006798,CF48,"CF48 3AE, CF48 3DR, CF48 3DS, CF48 3DY, CF48 3EE, CF48 3EG, CF48 3EP, CF48 3ES, CF48 3LD, CF48 3LP, CF48 3LR, CF48 3LT, CF48 3LU, CF48 3YB, CF48 3YF, CF48 3YG, CF48 3YH",286,263,23
W00006800,CF48,"CF48 3HA, CF48 3HB, CF48 3HD, CF48 3HE, CF48 3HF, CF48 3HG, CF48 3PE, CF48 3PF, CF48 3PG, CF48 3PL",373,338,35
W00006801,CF48,"CF48 2DF, CF48 2DL, CF48 2DN, CF48 2DP, CF48 2DW, CF48 2DY",262,246,16
W00007473,CF48,"CF48 4AB, CF48 4AD, CF48 4AR, NP2 3AE, NP2 3AF, NP2 5DE, NP2 5DF, NP2 5DH, NP2 5DR, NP2 5QG, NP2 5QH, NP2 5QJ, NP2 5QL, NP2 5QQ, NP2 5QT, NP2 5QU, NP2 5QW, NP2 5QX, NP2 5QY, NP22 3AB, NP22 3AE, NP22 3AF, NP22 3BG, NP22 5QF, NP22 5QG, NP22 5QH, NP22 5QJ, NP22 5QL, NP22 5QR, NP22 5QT, NP22 5QU, NP22 5QX, NP22 5QY",296,246,50
W00006802,CF48,"CF48 2DE, CF48 2EF, CF48 2EJ, CF48 2TA, CF48 2TG, CF48 2TH, CF48 2TQ, CF48 2UY, CF48 2XR, CF48 2YA, CF48 2YG, CF48 3SS",281,261,20
W00006803,CF48,"CF48 2BB, CF48 2BF, CF48 2BG, CF48 2BN, CF48 2BW, CF48 2EE",298,257,41
W00006795,CF48,"CF48 3AA, CF48 3DU, CF48 3GH, CF48 3PN, CF48 3PP, CF48 3PR, CF48 3PS, CF48 3PW, CF48 3RB",290,254,36
W00006788,CF48,"CF48 3AU, CF48 3RR, CF48 3RT, CF48 3RW, CF48 3SH, CF48 3SJ, CF48 3SL, CF48 3SN",244,227,17
W00006787,CF48,"CF48 2YE, CF48 2YJ, CF48 2YL, CF48 2YQ, CF48 2YS, CF48 3PD, CF48 3PH, CF48 3PT, CF48 3PU, CF48 3PY, CF48 3RA",270,246,24
W00006786,CF48,"CF48 1JA, CF48 1JE, CF48 1JF, CF48 1JG, CF48 1NU, CF48 1NZ, CF48 1PA, CF48 1PR, CF48 1PT",303,279,24
W00010302,CF48,"CF48 1JN, CF48 1JP, CF48 1JQ, CF48 1JW, CF48 1JY",210,184,26
W00006931,CF48,"CF48 2HE, CF48 2HF, CF48 2HH, CF48 2HN, CF48 2NP, CF48 2NQ, CF48 2NS, CF48 2NT, CF48 2NU, CF48 2NY, CF48 2PA",276,233,43
W00006767,CF48,"CF48 1DN, CF48 1HN, CF48 1HR, CF48 1HS, CF48 1HW, CF48 1HZ, CF48 1NQ, CF48 1NY, CF48 1PD, CF48 1PE, CF48 1PY",403,364,39
W00006768,CF48,"CF48 1HT, CF48 1QA, CF48 1RS, CF48 1RT, CF48 1RU, CF48 1RY, CF48 1TS, CF48 1TT, CF48 1TU, CF48 1TY, CF48 1UA, CF48 1UB, CF48 1UD, CF48 1UE, CF48 1UF, CF48 1UL",275,255,20
W00006769,CF48,"CF48 1RP, CF48 1SE, CF48 1SL, CF48 1SW",265,228,37
W00006770,CF48,"CF48 1ER, CF48 1ES, CF48 1ET, CF48 1EU, CF48 1LD, CF48 1LE, CF48 1LF",278,262,16
W00006773,CF48,"CF48 1DG, CF48 1JB, CF48 1JH, CF48 1JJ, CF48 1JL, CF48 1PF, CF48 1RB, CF48 1RD",340,299,41
W00006774,CF48,"CF48 1BB, CF48 1BE, CF48 1BF, CF48 1PU, CF48 1SD, CF48 1SF, CF48 1SG, CF48 1SH",427,389,38
W00006775,CF48,"CF48 1TN, CF48 1TP, CF48 1TQ, CF48 1TR, CF48 1TW, CF48 1UG, CF48 1UH, CF48 1UN, CF48 1XD, CF48 1XF",413,372,41
W00006776,CF48,"CF48 1RR, CF48 1SB, CF48 1SN, CF48 1SP, CF48 1SQ, CF48 1SR",389,351,38
W00006777,CF48,"CF48 1AD, CF48 1AF, CF48 1AP, CF48 1AR, CF48 1BA, CF48 1YE",196,188,8
W00006779,CF48,"CF48 1BG, CF48 1BL, CF48 1BQ, CF48 1BY, CF48 1RE, CF48 1RF, CF48 1RG, CF48 1RH, CF48 1RL, CF48 1RN, CF48 1RZ, CF48 1SA, CF48 1SS, CF48 1ST, CF48 1SU, CF48 1SY, CF48 1TA, CF48 1TB, CF48 1TD, CF48 1TE, CF48 1TF, CF48 1TG, CF48 1TH, CF48 1TL",547,498,49
W00006781,CF48,"CF48 1LP, CF48 1LR, CF48 1LS, CF48 1LT, CF48 1LU, CF48 1LW, CF48 1LY, CF48 1NA, CF48 2SW",297,282,15
W00006782,CF48,"CF48 1ND, CF48 1NE, CF48 1NG, CF48 1NH",285,264,21
W00006783,CF48,"CF48 1EY, CF48 1HA, CF48 1HB, CF48 1HD, CF48 1LG, CF48 1LH, CF48 1LN",220,194,26
W00006784,CF48,"CF48 1HE, CF48 1HF, CF48 1HG, CF48 1HH, CF48 1HL, CF48 1HU, CF48 1LA, CF48 1LL, CF48 1NB, CF48 1NF",275,253,22
W00006785,CF48,"CF48 1JD, CF48 1JR, CF48 1JS, CF48 1JT, CF48 1JU, CF48 1JX",259,227,32
W00006804,CF48,"CF48 2AS, CF48 2AW, CF48 2AY, CF48 2BA",321,306,15
W00006805,CF48,"CF48 2BS, CF48 2DB, CF48 2DD, CF48 2DG, CF48 2DH, CF48 2DU, CF48 2EA",183,165,18
W00006932,CF48,"CF48 2LL, CF48 2LN, CF48 2LS, CF48 2LW, CF48 2PG, CF48 2PH, CF48 2RA, CF48 2RN, CF48 2RP, CF48 2RR",287,253,34
W00002645,CF48,"CF48 2HY, LD3 7AJ, LD3 7AQ, LD3 7AX, LD3 7AZ, LD3 7BD, LD3 7BJ, LD3 7BQ, LD3 7BS, LD3 7BX, LD3 7BZ, LD3 7HT, LD3 7LQ, LD3 7SD, LD3 8LH, LD3 8LL, LD3 8LN, LD3 8LP, LD3 8LR, LD3 8LS, LD3 8LT, LD3 8LW",304,266,38
W00006875,CF48,"CF48 4AA, CF48 4AY, CF48 4BE, CF48 4BG, CF48 4BL, CF48 4DJ, CF48 4DL, CF48 4DP, CF48 4DR, CF48 4LA, CF48 4XA",355,344,11
W00006876,CF48,"CF48 4AN, CF48 4HY, CF48 4HZ, CF48 4JA, CF48 4JB, CF48 4JD, CF48 4JE, CF48 4JF, CF48 4JG, CF48 4JL, CF48 4JR, CF48 4JS",278,257,21
W00006877,CF48,"CF48 4HF, CF48 4HG, CF48 4HJ, CF48 4JP, CF48 4NH",282,248,34
W00006878,CF48,"CF48 4DT, CF48 4DU, CF48 4DX, CF48 4DZ, CF48 4EA, CF48 4EF, CF48 4EG, CF48 4JH, CF48 4JJ, CF48 4JN, CF48 4JQ, CF48 4JU, CF48 4JW, CF48 4JX, CF48 4NQ",266,249,17
W00006880,CF48,"CF48 4JT, CF48 4LB, CF48 4LD, CF48 4LE, CF48 4LF, CF48 4LG, CF48 4LQ, CF48 4LS, CF48 4LX, CF48 4LY, CF48 4ND, CF48 4NE, CF48 4NF, CF48 4NG, CF48 4NJ",306,275,31
W00006881,CF48,"CF48 4EH, CF48 4EJ, CF48 4EL, CF48 4EN, CF48 4EQ, CF48 4EW, CF48 4EX, CF48 4EY, CF48 4EZ, CF48 4HA, CF48 4HB, CF48 4HD, CF48 4HE, CF48 4HP, CF48 4HR",289,265,24
W00006882,CF48,"CF48 4EP, CF48 4ER, CF48 4ES, CF48 4ET, CF48 4EU, CF48 4HN",291,264,27
W00006883,CF48,"CF48 1HX, CF48 1PJ, CF48 1RW, CF48 1YZ, CF48 4DS, CF48 4HH, CF48 4HL, CF48 4HQ, CF48 4HS, CF48 4HT, CF48 4HU, CF48 4HW, CF48 4HX, CF48 4TP, CF48 4TR, CF48 4TS, CF48 4TT, CF48 4TW",230,213,17
W00006884,CF48,"CF48 1EH, CF48 1PQ, CF48 1RA, CF48 1TJ, CF48 1UX, CF48 1XA, CF48 1YF, CF48 1YG, CF48 1YH, CF48 1YL, CF48 1YN, CF48 1YP, CF48 1YQ, CF48 1YS, CF48 1YT, CF48 1YU, CF48 1YW, CF48 1YX, CF48 4AL, CF48 4AT, CF48 4AU, CF48 4AX, CF48 4TQ, CF48 4TU, CF48 4UA, CF48 4UD, CF48 4YB",293,261,32
W00006885,CF48,"CF48 1EX, CF48 1HJ, CF48 1NJ, CF48 1NX, CF48 1RJ, CF48 1RQ, CF48 1SJ, CF48 1SZ, CF48 4AZ, CF48 4BD, CF48 4UB",426,387,39
W00006886,CF48,"CF48 4BA, CF48 4BB, CF48 4BH, CF48 4BJ, CF48 4BN, CF48 4BP, CF48 4BQ, CF48 4BS, CF48 4BW",286,265,21
W00006887,CF48,"CF48 4BT, CF48 4BU, CF48 4BX, CF48 4BY, CF48 4BZ, CF48 4DA, CF48 4DB, CF48 4DD, CF48 4DE, CF48 4DF, CF48 4DG, CF48 4DH",258,231,27
W00006888,CF48,"CF48 1EJ, CF48 1PX, CF48 1RX, CF48 1SX",325,304,21
W00010287,CF48,"CF48 1AB, CF48 1AQ, CF48 1AS, CF48 1AT, CF48 1AU, CF48 1AW, CF48 1AZ, CF48 1BZ, CF48 1DU, CF48 1DY, CF48 1EA, CF48 1ED",361,320,41
W00010299,CF48,"CF48 1NL, CF48 1NN",194,171,23
W00006874,CF48,"CF48 4DN, CF48 4DQ, CF48 4DW",255,221,34
W00006873,CF48,"CF48 1AA, CF48 1AJ, CF48 1AX, CF48 1BJ, CF48 1BX, CF48 1DJ, CF48 1DX, CF48 1LJ, CF48 1LX, CF48 1TX, CF48 1UJ, CF48 1YR, CF48 1YY, CF48 1ZR",213,193,20
W00006872,CF48,"CF48 4DY, CF48 4EB, CF48 4ED, CF48 4EE, CF48 4JY, CF48 4JZ",295,277,18
W00009771,CF48,"CF48 2UA, CF48 2UB, CF48 2UE, CF48 2UF, CF48 2UG, CF48 2UH, CF48 2UL, CF48 2UN, CF48 2UP, CF48 2UW, CF48 2YB",218,195,23
W00006808,CF48,"CF48 2AB, CF48 2AD, CF48 2AE, CF48 2AF, CF48 2AG, CF48 2BE, CF48 2BH, CF48 2BJ, CF48 2BL, CF48 2BT, CF48 2BU, CF48 2BY, CF48 2DA",330,297,33
W00006809,CF48,"CF48 2AA, CF48 2AH, CF48 2AP, CF48 2AR, CF48 2EB, CF48 2ED, CF48 2YF, CF48 2YH, CF48 2YN, CF48 2YY",228,218,10
W00006827,CF48,"CF48 4QE, CF48 4QH, CF48 4QP, CF48 4RL",248,216,32
W00006828,CF48,"CF48 4QB, CF48 4QF, CF48 4TF, CF48 4TH",285,247,38
W00006829,CF48,"CF48 4QA, CF48 4QG, CF48 4QT, CF48 4QU, CF48 4QX, CF48 4RZ, CF48 4SL, CF48 4SN, CF48 4TJ, CF48 4TN, CF48 4YD, CF48 4YE",302,262,40
W00006830,CF48,"CF48 4QJ, CF48 4QQ, CF48 4QS, CF48 4QY, CF48 4QZ, CF48 4RA, CF48 4RB, CF48 4RN",255,220,35
W00006831,CF48,"CF48 4PP, CF48 4QL, CF48 4QN, CF48 4QR, CF48 4QW, CF48 4RD",282,230,52
W00006806,CF48,"CF48 2AT, CF48 2AU, CF48 2BD",291,267,24
W00006832,CF48,"CF48 4SD, CF48 4SE, CF48 4SF, CF48 4SG, CF48 4SH, CF48 4SJ, CF48 4SP, CF48 4SQ, CF48 4SW, CF48 4TG",241,224,17
W00006834,CF48,"CF48 4NP, CF48 4NR, CF48 4NS, CF48 4PJ, CF48 4PN, CF48 4PR, CF48 4PW, CF48 4RE, CF48 4RF, CF48 4RG, CF48 4TL, CF48 4TX",538,475,63
W00006835,CF48,"CF48 4NT, CF48 4NX, CF48 4NZ, CF48 4RH, CF48 4RQ, CF48 4RW",93,86,7
W00006836,CF48,"CF48 4PB, CF48 4PT, CF48 4RJ, CF48 4TE",159,145,14
W00006837,CF48,"CF48 4NU, CF48 4NW, CF48 4NY, CF48 4PA, CF48 4PH, CF48 4PL, CF48 4PQ, CF48 4PU, CF48 4PX, CF48 4PY",396,346,50
W00006838,CF48,"CF48 4PS, CF48 4SY, CF48 4TA, CF48 4TB, CF48 4TD",310,281,29
W00006852,CF48,"CF48 1DB, CF48 1DD, CF48 1DE, CF48 1DR, CF48 1DS, CF48 1DW, CF48 1EE",302,266,36
W00009770,CF48,"CF48 2UR, CF48 2UT, LD3 7JB, LD3 7JD, LD3 7JF, LD3 7JG, LD3 7YP, LD3 7YR, LD3 7YS, LD3 7YT, LD3 7YU, LD3 7YW, LD3 7YY",223,194,29
W00006833,CF48,"CF48 4RP, CF48 4RR, CF48 4RS, CF48 4RT, CF48 4RU, CF48 4RX, CF48 4RY, CF48 4SA, CF48 4SB, CF48 4SR, CF48 4SS, CF48 4ST, CF48 4SU, CF48 4SX",195,160,35
W00006807,CF48,"CF48 2DR, CF48 2DS, CF48 2DT, CF48 2SF, CF48 2SR, CF48 2SS, CF48 2ST, CF48 2SU, CF48 2TB, CF48 2TD, CF48 2TE, CF48 2TF",257,248,9
W00006772,CF48,"CF48 1HP, CF48 1PG, CF48 1PH, CF48 1PN, CF48 1PP, CF48 1PW",320,281,39
W00006933,CF48,"CF48 2EG, CF48 2EP, CF48 2NA, CF48 2ND, CF48 2NE, CF48 2NR, CF48 2PE, CF48 2PN, CF48 2PS, CF48 2PW",239,227,12
W00006934,CF48,"CF48 2AL, CF48 2HG, CF48 2HP, CF48 2HW, CF48 2NG, CF48 2NH, CF48 2NJ, CF48 2NL, CF48 2NN, CF48 2NW, CF48 2PP, CF48 2RG, CF48 2SN, CF48 2SP, CF48 2TJ",289,260,29
W00006935,CF48,"CF48 2NB, CF48 2PB, CF48 2PU, CF48 2PY, CF48 2RB, CF48 2RE, CF48 2RF, CF48 2RH",206,188,18
W00006936,CF48,"CF48 2LP, CF48 2LR, CF48 2LT, CF48 2LU, CF48 2LY, CF48 2PL, CF48 2PR, CF48 2PT, CF48 2RD, CF48 2RL, CF48 2RW",289,259,30
W00006937,CF48,"CF48 2RS, CF48 2RT, CF48 2SA, CF48 2SB, CF48 2SD, CF48 2SE",294,280,14
W00006938,CF48,"CF48 2HS, CF48 2HT, CF48 2LB, CF48 2TN, CF48 2TP, CF48 2TR, CF48 2TS, CF48 2TT, CF48 2TU, CF48 2TW, CF48 2TY, CF48 2UD, CF48 2UU, CF48 2YP, CF48 2YR",214,186,28
W00006940,CF48,"CF48 2EN, CF48 2ER, CF48 2ES, CF48 2ET, CF48 2LA, CF48 2LD, CF48 2LE, CF48 2LF",408,372,36
W00006941,CF48,"CF48 2EH, CF48 2EL, CF48 2EW, CF48 2SH",268,256,12
W00007125,CF48,"CF48 4AE, CF8 9JX, CF8 9JZ, CF8 9LD, CF8 9LG, CF8 9LH, CF8 9LJ, CF8 9LS, CF8 9NG, CF8 9NH, CF81 9JX, CF81 9JZ, CF81 9LD, CF81 9LG, CF81 9LH, CF81 9LJ, CF81 9LS, CF81 9NH, NP2 5RL",290,269,21
W00006942,CF48,"CF48 2EU, CF48 2EY, CF48 2HA, CF48 2HB, CF48 2HD, CF48 2SL",319,296,23
W00008890,CF5,"CF5 1AP, CF5 1BW, CF5 1BY, CF5 1BZ, CF5 1FA",289,190,99
W00009066,CF5,"CF5 3RB, CF5 3RE, CF5 3RF, CF5 3RJ, CF5 3RN, CF5 3RT, CF5 3RW",314,281,33
W00009065,CF5,"CF5 3LD, CF5 3LJ, CF5 3LS, CF5 3NA, CF5 3NL, CF5 3NN, CF5 3QB",308,277,31
W00009064,CF5,"CF5 3NE, CF5 3NH, CF5 3NQ, CF5 3NR, CF5 3NS, CF5 3NX",301,275,26
W00008836,CF5,"CF5 5DS, CF5 5EZ, CF5 5FA, CF5 5HB",255,240,15
W00008833,CF5,"CF5 5DR, CF5 5EY, CF5 5NS, CF5 5NW, CF5 5PS, CF5 5TA, CF5 5TB, CF5 5XF",481,432,49
W00008834,CF5,"CF5 5EP, CF5 5EQ, CF5 5ER, CF5 5ES",281,271,10
W00008835,CF5,"CF5 5DT, CF5 5DU, CF5 5DW, CF5 5NY, CF5 5NZ",346,320,26
W00008837,CF5,"CF5 5DX, CF5 5DZ, CF5 5EA, CF5 5EJ, CF5 5EL, CF5 5EN, CF5 5FE, CF5 5HE",371,328,43
W00008832,CF5,"CF5 5BD, CF5 5BE, CF5 5BG, CF5 5BH, CF5 5XN",244,218,26
W00009067,CF5,"CF5 3NB, CF5 3NP, CF5 3NT, CF5 3NU, CF5 3NW",306,260,46
W00009070,CF5,"CF5 3PT, CF5 3PW, CF5 3PX, CF5 3PY, CF5 3SW, CF5 3SX",334,289,45
W00009069,CF5,"CF5 3RA, CF5 3RG, CF5 3RH, CF5 3SL, CF5 3TY",305,271,34
W00008838,CF5,"CF5 5DH, CF5 5EF, CF5 5EG, CF5 5EH, CF5 5PL, CF5 5PR, CF5 5XD",248,222,26
W00009071,CF5,"CF5 3PQ, CF5 3PR, CF5 3PU, CF5 3PZ, CF5 3QN",241,220,21
W00009072,CF5,"CF5 3QU, CF5 3SF, CF5 3SN, CF5 3TX, CF5 3UH, CF5 3WA",274,250,24
W00010642,CF5,"CF5 6FD, CF5 6FE, CF5 6FG",294,248,46
W00009186,CF5,"CF5 2HB, CF5 2HF, CF5 2HL, CF5 2HN, CF5 2LB, CF5 2LF",269,182,87
W00009187,CF5,"CF5 2BA, CF5 2BG, CF5 2BP, CF5 2BQ, CF5 2BT, CF5 2DW, CF5 2JB",263,211,52
W00009188,CF5,"CF5 2AU, CF5 2PE, CF5 2PF, CF5 2SL, CF5 2SP",313,259,54
W00009189,CF5,"CF5 2DH, CF5 2DJ, CF5 2RL",280,257,23
W00009068,CF5,"CF5 2NH, CF5 3QA, CF5 3QD, CF5 3QF, CF5 3QJ, CF5 3QP",259,224,35
W00008839,CF5,"CF5 5JB, CF5 5JD, CF5 5JE, CF5 5JF",202,188,14
W00008844,CF5,"CF5 5HS, CF5 5QG, CF5 5QL, CF5 5QN, CF5 5QQ, CF5 5TE",305,274,31
W00008841,CF5,"CF5 5HU, CF5 5HW, CF5 5HX, CF5 5HY, CF5 5PP, CF5 5PQ, CF5 5YF, CF5 5YH, CF5 5YJ, CF5 5YP, CF5 5YS, CF5 5YT, CF5 5YU, CF5 5YW, CF5 5YX, CF5 5YY",286,265,21
W00008858,CF5,"CF5 1BS, CF5 1BT, CF5 1BU, CF5 1EZ",251,186,65
W00008857,CF5,"CF5 1EJ, CF5 1EP, CF5 1ES, CF5 1GQ, CF5 1HG",260,190,70
W00008856,CF5,"CF5 1EH, CF5 1EQ, CF5 1ER, CF5 1ET, CF5 1FU",263,199,64
W00008854,CF5,"CF5 1AD, CF5 1AE, CF5 1AF, CF5 1AL, CF5 1BN, CF5 1DB",317,233,84
W00008853,CF5,"CF5 1AN, CF5 1AT, CF5 1BG, CF5 1BJ, CF5 1BL, CF5 1BQ, CF5 1BR, CF5 1WA",276,186,90
W00008852,CF5,"CF5 5HN, CF5 5HR, CF5 5JL, CF5 5JQ, CF5 5LH, CF5 5LT, CF5 5PJ, CF5 5YE, CF5 5YG",223,196,27
W00008851,CF5,"CF5 5LJ, CF5 5LR, CF5 5LS, CF5 5LU, CF5 5LY",296,281,15
W00008889,CF5,"CF5 1GE, CF5 1GH, CF5 1GJ, CF5 1GN, CF5 1GT",290,194,96
W00008849,CF5,"CF5 5QP, CF5 5RD, CF5 5SD, CF5 5SE",248,228,20
W00008848,CF5,"CF5 5JT, CF5 5JW, CF5 5JX, CF5 5JY, CF5 5LG, CF5 5LP, CF5 5NH",281,251,30
W00009059,CF5,"CF5 3RL, CF5 3RP, CF5 3RQ, CF5 3RR, CF5 3RS",318,284,34
W00009060,CF5,"CF5 2DB, CF5 2DD, CF5 2FA, CF5 2FB, CF5 2PP, CF5 2SB, CF5 2SD, CF5 2SE, CF5 2SR, CF5 3LW",329,290,39
W00009061,CF5,"CF5 2EX, CF5 2EY, CF5 2PJ, CF5 2PQ, CF5 2PR, CF5 2PS, CF5 2PW",261,228,33
W00008847,CF5,"CF5 5JU, CF5 5NF, CF5 5NG",340,314,26
W00009062,CF5,"CF5 2BF, CF5 2EW, CF5 2NB, CF5 2PA, CF5 2PD, CF5 2PH, CF5 2PL, CF5 3NY",248,214,34
W00008846,CF5,"CF5 5JA, CF5 5JN, CF5 5JP",230,201,29
W00008845,CF5,"CF5 5LF, CF5 5NL, CF5 5PH, CF5 5PN",258,231,27
W00009190,CF5,"CF5 2RF, CF5 2RH, CF5 2RJ, CF5 2RN, CF5 2RP, CF5 2RQ, CF5 2SH",303,278,25
W00008843,CF5,"CF5 5ED, CF5 5HD, CF5 5LE, CF5 5LL, CF5 5LN, CF5 5NE, CF5 5NP, CF5 5PG, CF5 5PZ, CF5 5XL",369,345,24
W00009063,CF5,"CF5 2SA, CF5 3LP, CF5 3LQ, CF5 3LR",229,202,27
W00008842,CF5,"CF5 5JG, CF5 5JH, CF5 5JJ, CF5 5QH, CF5 5QJ, CF5 5SL",412,370,42
W00008840,CF5,"CF5 5LB, CF5 5LD, CF5 5NJ, CF5 5NX, CF5 5PA, CF5 5PE, CF5 5PF, CF5 5XJ",361,327,34
W00009191,CF5,"CF5 2PB, CF5 2QF, CF5 2QG, CF5 2QJ, CF5 2QL, CF5 2RR, CF5 2RS, CF5 2SQ",454,396,58
W00009197,CF5,"CF5 2AW, CF5 2DE, CF5 2DU, CF5 2DX, CF5 2DY, CF5 2DZ, CF5 2EA, CF5 2EB, CF5 2EF, CF5 2JE, CF5 2JG, CF5 2LA, CF5 2XE, CF5 2XQ, CF5 2YE, CF5 2YF, CF5 2YG, CF5 2YJ, CF5 2YT, CF5 2YW",291,224,67
W00009194,CF5,"CF5 2LE, CF5 2ND, CF5 2NG, CF5 2NJ, CF5 2NL, CF5 2NN, CF5 2NP, CF5 2NQ, CF5 2NR, CF5 2NS, CF5 2NT",351,303,48
W00009207,CF5,"CF5 2QH, CF5 2RU, CF5 2TA, CF5 2TE, CF5 2UD",216,194,22
W00009208,CF5,"CF5 2QX, CF5 2QY, CF5 2QZ, CF5 2RD, CF5 2RE, CF5 2RG",316,276,40
W00009209,CF5,"CF5 2QN, CF5 2QW, CF5 2RA, CF5 2RB, CF5 2RT, CF5 2SF, CF5 2SN",247,228,19
W00009210,CF5,"CF5 2RY, CF5 2RZ, CF5 2TB",224,203,21
W00009211,CF5,"CF5 2QP, CF5 2QR, CF5 2QS, CF5 2QU",255,220,35
W00009212,CF5,"CF5 2QQ, CF5 2QT, CF5 2RW, CF5 2RX",238,201,37
W00010187,CF5,"CF5 2PT, CF5 2SJ, CF5 2XJ, CF5 2YQ",392,331,61
W00009213,CF5,"CF5 2PG, CF5 2PZ, CF5 2QA, CF5 2QB, CF5 2QD",285,178,107
W00010221,CF5,"CF5 4PJ, CF5 6DP, CF5 6DQ, CF5 6DU, CF5 6DW, CF5 6DX, CF5 6DY, CF5 6DZ, CF5 6EA, CF5 6EB, CF5 6ED, CF5 6EE, CF5 6EJ, CF5 6EL, CF5 6FL, CF5 6HS, CF5 6HW, CF5 6XB, CF5 6YQ, CF5 6YR, CF5 6YS",284,238,46
W00009206,CF5,"CF5 2DF, CF5 2DG, CF5 2PY, CF5 2TD",287,255,32
W00010228,CF5,"CF5 6HN, CF5 6HP, CF5 6HQ, CF5 6HR, CF5 6HT, CF5 6JB, CF5 6JN, CF5 6PA, CF5 6XG",344,271,73
W00010522,CF5,"CF5 6FT, CF5 6FW, CF5 6HH, CF5 6JD, CF5 6JJ, CF5 6JL, CF5 6PB, CF5 6XF",318,264,54
W00005995,CF5,"CF5 6BR, CF5 6BS, CF5 6BT, CF5 6BU, CF5 6DB",245,218,27
W00005994,CF5,"CF5 6AU, CF5 6AW, CF5 6AX, CF5 6AY, CF5 6BW, CF5 6DA, CF5 6DL, CF5 6PL",270,247,23
W00005991,CF5,"CF5 6AE, CF5 6AQ, CF5 6BX, CF5 6BZ, CF5 6DE, CF5 6DF, CF5 6DG, CF5 6DJ, CF5 6DT, CF5 6EU",281,239,42
W00005990,CF5,"CF5 5TH, CF5 5TT, CF5 6AA, CF5 6AB, CF5 6AG, CF5 6AL, CF5 6AN, CF5 6AR, CF5 6AS, CF5 6AT, CF5 6DD, CF5 6DH, CF5 6EH, CF5 6ES, CF5 6UA, CF5 6UJ, CF5 6XJ, CF5 6XL, CF5 6XR, CF5 6XW, CF5 6XZ",527,460,67
W00005987,CF5,"CF5 6FU, CF5 6FX, CF5 6SJ, CF5 6TB, CF5 6TL, CF5 6TP, CF5 6TT, CF5 6TY, CF5 6TZ, CF5 6WQ, CF5 6WR, CF5 6YD",412,367,45
W00010598,CF5,"CF5 6AD, CF5 6AF, CF5 6AH, CF5 6AJ, CF5 6AP, CF5 6AZ, CF5 6BA, CF5 6BD, CF5 6BE, CF5 6BH, CF5 6BP, CF5 6BQ, CF5 6SU, CF5 6SW, CF5 6XE, CF62 3AA",322,290,32
W00010602,CF5,"CF5 3DR, CF5 3DS, CF5 3FA, CF5 3FB, CF5 6EF, CF5 6EG",283,238,45
W00009854,CF5,"CF5 5FB, CF5 5TJ, CF5 5TL, CF5 5TN, CF5 5TP, CF5 5TQ, CF5 5TR, CF5 5TS, CF5 5TU, CF5 5TW, CF5 5TX, CF5 5TY, CF5 5TZ, CF5 5UA",420,388,32
W00010231,CF5,"CF5 2NZ, CF5 2PN, CF5 2PU, CF5 2PX, CF5 2QE, CF5 2UA, CF5 2UF, CF5 2UH, CF5 2UJ, CF5 2UL, CF5 2UN, CF5 2WB, CF5 2WJ, CF5 2WL, CF5 2WP, CF5 2WS, CF5 2XH, CF5 2XU, CF5 2XW, CF5 2YA, CF5 2YP, CF5 2YR",259,190,69
W00009205,CF5,"CF5 1DP, CF5 1DR, CF5 2BD, CF5 2BW, CF5 2DA, CF5 2JH, CF5 2JJ",316,258,58
W00005760,CF5,"CF5 6BB, CF6 3BB, CF6 3BD, CF6 4DG, CF6 4DL, CF6 4DN, CF6 4DP, CF6 4HA, CF6 4HD, CF63 1BL, CF63 1BN, CF64 4BE, CF64 4DG, CF64 4DL, CF64 4DN, CF64 4DP, CF64 4DT, CF64 4DU, CF64 4HA, CF64 4HD",323,273,50
W00009203,CF5,"CF5 2AN, CF5 2AQ, CF5 2BB, CF5 2BS, CF5 2BU, CF5 2JF",216,168,48
W00009195,CF5,"CF5 2DR, CF5 2DS, CF5 2EN, CF5 2EU, CF5 2LD, CF5 2LL, CF5 2LP, CF5 2LQ, CF5 2LS, CF5 2LT, CF5 2NA, CF5 2XN, CF5 2YN",330,288,42
W00009196,CF5,"CF5 2JP, CF5 2JR, CF5 2JT, CF5 2JW, CF5 2LG, CF5 2LJ",277,221,56
W00008859,CF5,"CF5 1BD, CF5 1EG, CF5 1HT, CF5 1HU, CF5 1JL, CF5 1JN, CF5 1WZ",342,253,89
W00009198,CF5,"CF5 1DQ, CF5 2AF, CF5 2AG, CF5 2AH, CF5 2AJ, CF5 2AL, CF5 2AP, CF5 2BR",420,271,149
W00010526,CF5,"CF5 4PL, CF5 4QR, CF5 4QS, CF5 4QU, CF5 4QX",263,238,25
W00009199,CF5,"CF5 2BJ, CF5 2HE, CF5 2HG, CF5 2HH, CF5 2HJ, CF5 2HP, CF5 2HQ, CF5 2HR, CF5 2HX, CF5 2LN, CF5 2XP, CF5 2XR, CF5 2XX, CF5 2XY",293,217,76
W00008831,CF5,"CF5 5AQ, CF5 5BJ, CF5 5JR, CF5 5NR, CF5 5NT, CF5 5NU, CF5 5WF, CF5 5XE",353,322,31
W00008830,CF5,"CF5 5AF, CF5 5AH, CF5 5AJ, CF5 5AL, CF5 5AX, CF5 5BL, CF5 5BP, CF5 5BQ, CF5 5ZD",311,285,26
W00008828,CF5,"CF5 5PT, CF5 5PU, CF5 5QA, CF5 5QB",317,279,38
W00008827,CF5,"CF5 4RT, CF5 4RU, CF5 5SB, CF5 5TF, CF5 5TG, CF5 5XB",322,303,19
W00008826,CF5,"CF5 5BN, CF5 5DJ, CF5 5DL, CF5 5HF, CF5 5HG, CF5 5HH, CF5 5JS",363,322,41
W00008825,CF5,"CF5 5HJ, CF5 5HL, CF5 5HP, CF5 5HQ, CF5 5HT, CF5 5HZ, CF5 5TD, CF5 5XU, CF5 5YR",281,261,20
W00008824,CF5,"CF5 5DP, CF5 5DY, CF5 5HA, CF5 5PB, CF5 5PD, CF5 5XP, CF5 5XR",421,393,28
W00008823,CF5,"CF5 5EB, CF5 5EE, CF5 5ET, CF5 5EU, CF5 5EW, CF5 5EX",331,294,37
W00008822,CF5,"CF5 5AN, CF5 5AP, CF5 5AT, CF5 5AU, CF5 5AW, CF5 5AY, CF5 5AZ, CF5 5BA, CF5 5BB",329,298,31
W00008821,CF5,"CF5 4NA, CF5 4NB, CF5 4ND, CF5 4NE, CF5 4PN, CF5 4RW, CF5 4RX, CF5 5DN, CF5 5QE, CF5 5XS",483,416,67
W00008820,CF5,"CF5 5LA, CF5 5LZ, CF5 5QD, CF5 5QR, CF5 5QS, CF5 5QT, CF5 5QU, CF5 5RB, CF5 5RE",610,525,85
W00008819,CF5,"CF5 5FF, CF5 5LQ, CF5 5LW, CF5 5LX, CF5 5NA, CF5 5NB, CF5 5ND, CF5 5NN",277,257,20
W00009200,CF5,"CF5 2BH, CF5 2HS, CF5 2HT, CF5 2HU, CF5 2HW, CF5 2JD, CF5 2LH, CF5 2LU, CF5 2XL, CF5 2XS, CF5 2YL",293,234,59
W00009201,CF5,"CF5 2BL, CF5 2BX, CF5 2HA, CF5 2HD, CF5 2JL, CF5 2JU",284,236,48
W00009202,CF5,"CF5 2JN, CF5 2JQ, CF5 2JS",253,202,51
W00009192,CF5,"CF5 2DN, CF5 2DP, CF5 2EE, CF5 2EG, CF5 2EH, CF5 2EJ, CF5 2EL, CF5 2EP, CF5 2EQ, CF5 2ER, CF5 2ES, CF5 2ET, CF5 2EZ, CF5 2FQ",223,191,32
W00008860,CF5,"CF5 1QJ, CF5 1QN, CF5 1QR, CF5 1QT, CF5 1QU, CF5 1RU, CF5 1RY",243,173,70
W00008850,CF5,"CF5 5QF, CF5 5QW, CF5 5QX, CF5 5QY, CF5 5QZ, CF5 5RA",398,360,38
W00009058,CF5,"CF5 3AA, CF5 3AB, CF5 3AD, CF5 3AR, CF5 3AT, CF5 3BD, CF5 3BL, CF5 3DN, CF5 4AA, CF5 4AR, CF5 4XG, CF5 4XJ, CF5 4XN, CF5 4XX",210,181,29
W00008994,CF5,"CF5 4BN, CF5 4BP, CF5 4BT, CF5 5BT",258,242,16
W00008995,CF5,"CF5 4EY, CF5 4FH, CF5 4FL, CF5 4FR, CF5 4FW, CF5 4FX",339,310,29
W00008996,CF5,"CF5 4BD, CF5 4BG, CF5 4BH, CF5 4BQ, CF5 4BU, CF5 4BX",280,250,30
W00008997,CF5,"CF5 4DP, CF5 4DQ, CF5 4DS, CF5 4DT, CF5 4EU, CF5 4FN, CF5 4FS",284,261,23
W00008998,CF5,"CF5 4AD, CF5 4AG, CF5 4AL, CF5 4AN, CF5 5BR, CF5 5BS, CF5 5DQ, CF5 5FD",304,283,21
W00008999,CF5,"CF5 4DW, CF5 4DX, CF5 4EB, CF5 4ED, CF5 4EE",349,324,25
W00009000,CF5,"CF5 4DE, CF5 4DH, CF5 4EW, CF5 4EX, CF5 4EZ",352,313,39
W00009001,CF5,"CF5 4BB, CF5 4BJ, CF5 4BW, CF5 4DD, CF5 4EF, CF5 4XD",331,302,29
W00009002,CF5,"CF5 4FA, CF5 4FB, CF5 4FD, CF5 4FE, CF5 4FF, CF5 4GA, CF5 4HU, CF5 4XA",383,354,29
W00009003,CF5,"CF5 4FG, CF5 4FJ, CF5 4FY, CF5 4FZ, CF5 4HW, CF5 4LF",410,368,42
W00009004,CF5,"CF5 4BA, CF5 4BL, CF5 4BR, CF5 4BS, CF5 4DG",310,296,14
W00009005,CF5,"CF5 4FP, CF5 4JF, CF5 4JG, CF5 4JH, CF5 4JJ",370,345,25
W00009006,CF5,"CF5 4PR, CF5 4PS, CF5 4PW, CF5 4PX",289,263,26
W00009007,CF5,"CF5 4GJ, CF5 4GL, CF5 4GN, CF5 4GU, CF5 4LE, CF5 5BU",222,197,25
W00009008,CF5,"CF5 4HY, CF5 4HZ, CF5 4JB, CF5 4JD, CF5 4JE",330,294,36
W00008862,CF5,"CF5 1EL, CF5 1EN, CF5 1HQ",235,184,51
W00009010,CF5,"CF5 4JL, CF5 4JN, CF5 4PQ, CF5 4PY, CF5 4PZ, CF5 4XH, CF5 4XP, CF5 4XQ, CF5 4XR, CF5 4XT, CF5 4XU, CF5 4XY, CF5 4XZ, CF5 4YD, CF5 4YH, CF5 4YN, CF5 4YR, CF5 4YS, CF5 4YW, CF5 4YX, CF5 4YZ",320,300,20
W00009011,CF5,"CF5 4HX, CF5 4JA, CF5 4JS, CF5 4JT, CF5 4JU",303,281,22
W00009012,CF5,"CF5 4GP, CF5 4GQ, CF5 4GR, CF5 4GS, CF5 4GT",232,209,23
W00009013,CF5,"CF5 4GX, CF5 4GY, CF5 4HB, CF5 5BW, CF5 5BX",308,276,32
W00009014,CF5,"CF5 4LG, CF5 4LH, CF5 4LQ, CF5 4LR, CF5 4LS",345,316,29
W00009015,CF5,"CF5 4QT, CF5 4SF, CF5 4TZ, CF5 4UF, CF5 4US",410,364,46
W00009016,CF5,"CF5 4PP, CF5 4PT, CF5 4PU, CF5 4QA",232,215,17
W00008993,CF5,"CF5 4AE, CF5 4AF, CF5 4AH, CF5 4AJ, CF5 4AP, CF5 4BE",303,280,23
W00009017,CF5,"CF5 4QJ, CF5 4RE, CF5 4SQ, CF5 4SS, CF5 4ST, CF5 4SU",241,222,19
W00008992,CF5,"CF5 4DF, CF5 4DJ, CF5 4DL, CF5 4DN",352,321,31
W00008990,CF5,"CF5 4TJ, CF5 4TT, CF5 4TU, CF5 4TW, CF5 4UJ, CF5 4UQ",275,255,20
W00008891,CF5,"CF5 1FX, CF5 1FY, CF5 1FZ, CF5 1GB",220,175,45
W00008892,CF5,"CF5 1DN, CF5 1DS, CF5 1DT, CF5 1DU, CF5 1DW, CF5 1DY, CF5 1EX, CF5 1EY",313,166,147
W00008894,CF5,"CF5 1AG, CF5 1AH, CF5 1AQ, CF5 1BX",311,217,94
W00008895,CF5,"CF5 1FB, CF5 1FL, CF5 1FP, CF5 1FQ, CF5 1FS, CF5 1QP",266,183,83
W00008896,CF5,"CF5 1BF, CF5 1FN, CF5 1GL, CF5 1GR, CF5 1HH",234,168,66
W00008897,CF5,"CF5 1EF, CF5 1FT, CF5 1FW, CF5 1GD, CF5 1GP, CF5 1SA, CF5 1SB, CF5 1SG, CF5 1UB, CF5 1UN",188,154,34
W00008943,CF5,"CF5 4QP, CF5 4QQ, CF5 4RZ, CF5 4SB, CF5 4SD, CF5 4SE, CF5 4SH, CF5 4SJ, CF5 6XD",391,356,35
W00005883,CF5,"CF5 6TS, CF7 7SS, CF7 7ST, CF7 7SU, CF7 7SW, CF7 7SX, CF7 7TG, CF7 7TH, CF7 7TJ, CF7 7TL, CF7 7TS, CF7 7UA, CF71 7SS, CF71 7ST, CF71 7SU, CF71 7SW, CF71 7SX, CF71 7TE, CF71 7TG, CF71 7TH, CF71 7TJ, CF71 7TL, CF71 7TS, CF71 7UA, CF71 7UR, CF71 7UX",517,448,69
W00005882,CF5,"CF5 6BY, CF5 6EP, CF5 6EQ, CF5 6ER, CF5 6ET, CF5 6EW, CF5 6EX, CF5 6EY, CF5 6EZ, CF5 6HA, CF5 6HB, CF5 6HD, CF5 6HE, CF5 6SA, CF5 6SB, CF5 6SD, CF5 6SE, CF5 6SF, CF5 6WD, CF5 6WG, CF5 6WH, CF5 6WL, CF5 6XH, CF5 6XQ, CF5 6YA, CF5 6YB, CF5 6YE, CF5 6YG, CF5 6YJ, CF5 6YN, CF5 6YT, CF5 6YX, CF5 6YY, CF5 6YZ, CF5 6ZR",375,323,52
W00005881,CF5,"CF5 6LL, CF5 6LN, CF5 6LP, CF5 6LW, CF5 6ND, CF5 6XA, CF5 6XX, CF5 6XY",172,154,18
W00005880,CF5,"CF5 6LR, CF5 6LS, CF5 6LZ, CF5 6NF, CF5 6NG",231,187,44
W00005879,CF5,"CF5 6LE, CF5 6LF, CF5 6LG, CF5 6LH, CF5 6LJ, CF5 6LQ, CF5 6LT, CF5 6LU, CF5 6LX, CF5 6LY, CF5 6NA, CF5 6NB, CF5 6NE",465,408,57
W00008887,CF5,"CF5 1AS, CF5 1DH, CF5 1DJ, CF5 1GA, CF5 1GF, CF5 1GG",312,192,120
W00008945,CF5,"CF5 4QW, CF5 4QZ, CF5 4RY",277,238,39
W00008981,CF5,"CF5 4GZ, CF5 4HA, CF5 4HG, CF5 4HJ, CF5 4HL, CF5 4HN",308,298,10
W00008982,CF5,"CF5 4LN, CF5 5BY, CF5 5DD, CF5 5DE, CF5 5DF",249,240,9
W00008983,CF5,"CF5 4SG, CF5 4SZ, CF5 4TB, CF5 4TD, CF5 4TF, CF5 4TG, CF5 4UB",263,239,24
W00008984,CF5,"CF5 4UA, CF5 4UN, CF5 4UP, CF5 4UR, CF5 4WB",338,298,40
W00008985,CF5,"CF5 4DR, CF5 4DU, CF5 4DY, CF5 4DZ, CF5 4EA",394,379,15
W00008986,CF5,"CF5 4FQ, CF5 4FT, CF5 4FU, CF5 4JP, CF5 4JQ, CF5 4JR",332,319,13
W00008987,CF5,"CF5 4PB, CF5 4PD, CF5 4PE, CF5 5DA, CF5 5DB",307,281,26
W00008988,CF5,"CF5 4PF, CF5 4PH, CF5 4RG, CF5 4RR, CF5 4RS, CF5 4UH, CF5 5XT",292,275,17
W00008989,CF5,"CF5 4SX, CF5 4TL, CF5 4TP, CF5 4TQ, CF5 4TR",309,280,29
W00008991,CF5,"CF5 4SA, CF5 4SW, CF5 4TH, CF5 4TN, CF5 4TS, CF5 4UG",311,293,18
W00009018,CF5,"CF5 4LT, CF5 4LU, CF5 4LW, CF5 4LX, CF5 4LY, CF5 5DG",285,273,12
W00009009,CF5,"CF5 4GW, CF5 4HD, CF5 4HE, CF5 4HF, CF5 4HH",316,273,43
W00009020,CF5,"CF5 4LL, CF5 4LP, CF5 4QF, CF5 4QG, CF5 4RA",261,243,18
W00009044,CF5,"CF5 3EZ, CF5 3HA, CF5 3HB, CF5 3HD, CF5 3HE, CF5 3HF",224,214,10
W00009045,CF5,"CF5 3EW, CF5 3HG, CF5 3HH, CF5 3HJ, CF5 3HL, CF5 3HN, CF5 3XN, CF5 3YP",311,274,37
W00009046,CF5,"CF5 3HR, CF5 3JB, CF5 3JD, CF5 3JE, CF5 3JN, CF5 3JP, CF5 3JQ, CF5 3JT, CF5 3JU, CF5 3LT, CF5 3XH",233,206,27
W00009019,CF5,"CF5 4QB, CF5 4QD, CF5 4QE, CF5 4QL",289,269,20
W00009047,CF5,"CF5 3EG, CF5 3EH, CF5 3EL",269,241,28
W00009048,CF5,"CF5 3AH, CF5 3BA, CF5 3BT, CF5 3DB, CF5 3DD, CF5 3DE, CF5 3DF, CF5 3DG, CF5 3DU, CF5 3DY",304,265,39
W00009049,CF5,"CF5 3EN, CF5 3EP, CF5 3EQ, CF5 3ER, CF5 3ES, CF5 3UE, CF5 3XE, CF5 3XP, CF5 3XR, CF5 3XS",322,295,27
W00009050,CF5,"CF5 3DT, CF5 3DX, CF5 3EJ, CF5 3ET, CF5 3EY, CF5 3XF",300,266,34
W00009051,CF5,"CF5 3DH, CF5 3DJ, CF5 3EB, CF5 3ED",309,279,30
W00009052,CF5,"CF5 3AE, CF5 3AF, CF5 3AS, CF5 3AU, CF5 3AZ, CF5 3BG, CF5 3BH, CF5 3BJ, CF5 3BP, CF5 3XB",197,186,11
W00009054,CF5,"CF5 3AY, CF5 3BQ, CF5 3BR, CF5 3BS, CF5 3BU, CF5 3BW, CF5 3XQ",322,285,37
W00009043,CF5,"CF5 3RU, CF5 3TF, CF5 3TH, CF5 3TR, CF5 3UB, CF5 3UD",406,361,45
W00008874,CF5,"CF5 1LF, CF5 1LG, CF5 1LL, CF5 1LW, CF5 1NA, CF5 1ND, CF5 1NJ, CF5 1PW",353,265,88
W00009055,CF5,"CF5 2BE, CF5 2BN, CF5 3AJ, CF5 3AL, CF5 3AN, CF5 3AP, CF5 3AQ, CF5 3BB, CF5 3BF, CF5 3HS, CF5 3HW",352,301,51
W00008872,CF5,"CF5 1JQ, CF5 1JT, CF5 1JX, CF5 1JY",272,222,50
W00005901,CF5,"CF5 6TQ, CF6 9AN, CF6 9AP, CF6 9AQ, CF6 9AR, CF6 9QS, CF62 3AN, CF62 3AP, CF62 3AQ, CF62 3AR, CF62 3AX, CF62 4QS, CF7 7UB, CF7 7UD, CF7 7UE, CF7 7UF, CF71 7FS, CF71 7UB, CF71 7UD, CF71 7UE",370,324,46
W00009056,CF5,"CF5 3BY, CF5 3DA, CF5 3EE, CF5 3EF",302,267,35
W00008869,CF5,"CF5 1AU, CF5 1DA, CF5 1GZ, CF5 1HA, CF5 1HX, CF5 1JF, CF5 1QA, CF5 1QX, CF5 1QY, CF5 1RD, CF5 1RH, CF5 1RT, CF5 1WU, CF5 1XG",415,350,65
W00008868,CF5,"CF5 1BA, CF5 1HD, CF5 1HE, CF5 1HF, CF5 1HY, CF5 1HZ, CF5 1JA, CF5 1JH, CF5 1JP, CF5 1NH",301,222,79
W00008867,CF5,"CF5 1BB, CF5 1HP, CF5 1HR, CF5 1HS, CF5 1JJ, CF5 1XU, CF5 1YY, CF5 1YZ, CF5 1ZZ",288,207,81
W00008866,CF5,"CF5 1FR, CF5 1HJ, CF5 1QQ, CF5 1RF, CF5 1RG, CF5 1UE, CF5 1UJ",240,161,79
W00008865,CF5,"CF5 1HL, CF5 1HN, CF5 1HW, CF5 1UU, CF5 1WJ, CF5 1WN, CF5 1WQ, CF5 1WS, CF5 1XL, CF5 1XY, CF5 1YA, CF5 1YB, CF5 1YF, CF5 1YJ, CF5 1YN, CF5 1YP, CF5 1YT, CF5 1YX",251,201,50
W00008863,CF5,"CF5 1AW, CF5 1QZ, CF5 1RA, CF5 1RB, CF5 1RE",229,184,45
W00009057,CF5,"CF5 3BN, CF5 3BX, CF5 3BZ, CF5 4AB, CF5 4AQ, CF5 4XE, CF5 4XF",299,256,43
W00008873,CF5,"CF5 1HB, CF5 1JG, CF5 1LN, CF5 1NB, CF5 1NE, CF5 1NF, CF5 1NG, CF5 1NL, CF5 1XJ",302,225,77
W00009042,CF5,"CF5 2LR, CF5 3DP, CF5 3HZ, CF5 3JR, CF5 3QE",281,249,32
W00009037,CF5,"CF5 3JW, CF5 3LA, CF5 3LB, CF5 3PL, CF5 3PN",263,243,20
W00009040,CF5,"CF5 3SG, CF5 3SP, CF5 3TN, CF5 3TP, CF5 3TZ, CF5 3UA, CF5 3UG",296,271,25
W00010550,CF5,"CF5 6BF, CF5 6FF, CF5 6FJ, CF5 6SR, CF5 6SS",298,242,56
W00009033,CF5,"CF5 3TG, CF5 3TJ, CF5 3TU, CF5 3TW",293,262,31
W00009032,CF5,"CF5 3SH, CF5 3SZ, CF5 3TA, CF5 3TB, CF5 3TD, CF5 3TE",296,273,23
W00009031,CF5,"CF5 3JX, CF5 3JY, CF5 3JZ, CF5 3LE, CF5 3LF, CF5 3LG, CF5 3LH",305,278,27
W00010535,CF5,"CF5 4QY, CF5 4SL, CF5 6EN, CF5 6FA, CF5 6FB, CF5 6FH",345,299,46
W00008879,CF5,"CF5 1LT, CF5 1LU, CF5 1NT, CF5 1NU",284,182,102
W00010531,CF5,"CF5 6BG, CF5 6BJ, CF5 6BL, CF5 6BN, CF5 6DN, CF5 6FN, CF5 6XN, CF5 6XP",312,277,35
W00009030,CF5,"CF5 3ND, CF5 3NG, CF5 3QG, CF5 3QH, CF5 3QL",301,275,26
W00009041,CF5,"CF5 3PF, CF5 3PG, CF5 3PJ, CF5 3PP, CF5 3PS, CF5 3YG, CF5 3YH, CF5 3YN, CF5 3YW",233,214,19
W00009029,CF5,"CF5 3LL, CF5 3LN, CF5 3LU, CF5 3NF, CF5 3NJ",289,272,17
W00009027,CF5,"CF5 4NG, CF5 4NJ, CF5 4NL, CF5 4NP, CF5 4NR",303,278,25
W00009026,CF5,"CF5 4SN, CF5 4SP, CF5 4SR, CF5 4SY, CF5 4TA, CF5 4TE",261,227,34
W00009025,CF5,"CF5 4NQ, CF5 4NS, CF5 4NT, CF5 4NU, CF5 4RB, CF5 4RF",323,292,31
W00008886,CF5,"CF5 1DL, CF5 1DX, CF5 1DZ, CF5 1EU, CF5 1EW",365,216,149
W00009024,CF5,"CF5 4RH, CF5 4RJ, CF5 4RL, CF5 4RN, CF5 4RQ",306,279,27
W00009023,CF5,"CF5 4NW, CF5 4NY, CF5 4NZ, CF5 4PA, CF5 4QH, CF5 4QN, CF5 4RD",263,238,25
W00009022,CF5,"CF5 4TX, CF5 4TY, CF5 4UD, CF5 4UE, CF5 4UL",235,211,24
W00009021,CF5,"CF5 4LJ, CF5 4NF, CF5 4NH, CF5 4NN, CF5 5BZ",397,353,44
W00009028,CF5,"CF5 4NX, CF5 4PG, CF5 4RP",190,183,7
W00009035,CF5,"CF5 3DL, CF5 3DW, CF5 3DZ, CF5 3EA, CF5 3EX, CF5 3HP, CF5 3XG, CF5 3YZ",330,268,62
W00009034,CF5,"CF5 3AG, CF5 3EU, CF5 3HT, CF5 3HU, CF5 3HX, CF5 3HY, CF5 3JA, CF5 3JS, CF5 3XL",292,256,36
W00009039,CF5,"CF5 3QQ, CF5 3QR, CF5 3QS, CF5 3QT, CF5 3QW, CF5 3RD",277,243,34
W00009038,CF5,"CF5 3SJ, CF5 3SQ, CF5 3ST, CF5 3SU, CF5 3SY, CF5 3TL, CF5 3TQ, CF5 3UF",224,209,15
W00008875,CF5,"CF5 1LH, CF5 1LP, CF5 1LS, CF5 1LX",364,232,132
W00009036,CF5,"CF5 3HQ, CF5 3PD, CF5 3PE, CF5 3SR, CF5 3SS, CF5 3TS, CF5 3TT",358,321,37
W00009849,CF6,"CF6 9ZQ, CF61 2ZQ, CF62 3LQ, CF62 3LS, CF62 3LT, CF62 3LU, CF62 3LW, CF62 3LX, CF62 3XX",307,274,33
W00009824,CF6,"CF6 6QL, CF6 6UT, CF62 5XG, CF63 4BG, CF63 4QR, CF63 4QU, CF63 4QZ, CF63 4XG",185,165,20
W00009826,CF6,"CF6 9HJ, CF6 9WE, CF6 9WF, CF6 9YY, CF6 9YZ, CF6 9ZA, CF6 9ZE, CF6 9ZF, CF6 9ZH, CF61 1HJ, CF61 1WF, CF61 1YY, CF61 1YZ, CF61 1ZA, CF61 1ZE, CF61 1ZF, CF61 1ZG, CF61 1ZH, CF61 2WF",421,392,29
W00009827,CF6,"CF6 6HE, CF6 6HH, CF6 6HJ, CF6 6LB, CF6 6LD, CF6 6RX, CF6 6RY, CF6 6SZ, CF6 6TA, CF6 6TE, CF6 6TJ, CF6 6TL, CF6 6TN, CF6 6TP, CF6 6TQ, CF6 6TS, CF6 6TT, CF6 6TW, CF6 6TZ, CF6 6UB, CF6 6UL, CF6 6XL, CF62 8RY, CF63 3UL, CF63 4HE, CF63 4HH, CF63 4HJ, CF63 4JL, CF63 4JZ, CF63 4LB, CF63 4LD, CF63 4LF, CF63 4LJ, CF63 4TE, CF63 4TJ, CF63 4TL, CF63 4TN, CF63 4TP, CF63 4TZ, CF63 4UD, CF63 4UL, CF63 4UZ, CF63 4XL",300,262,38
W00009828,CF6,"CF6 6JG, CF6 6JS, CF6 6JX, CF6 6QT, CF6 6US, CF63 4JG, CF63 4JU, CF63 4QQ, CF63 4QT, CF63 4RT, CF63 4US",221,199,22
W00010627,CF6,"CF6 1NH, CF6 1NJ, CF6 1NL, CF64 1NG, CF64 1NH, CF64 1NJ, CF64 1NL, CF64 1NQ, CF64 1SG, CF64 1TG",188,163,25
W00009830,CF6,"CF6 6QS, CF6 8TS, CF6 8TT, CF6 8TU, CF6 8UE, CF62 5QS, CF62 5TS, CF62 5TT, CF62 5TU, CF62 5UB, CF62 5UE",273,240,33
W00009831,CF6,"CF6 6JU, CF6 6JW, CF63 4AP, CF63 4AR, CF63 4AW, CF63 4AY, CF63 4QS",135,124,11
W00009832,CF6,"CF6 6HD, CF6 6JJ, CF6 6JL, CF6 6JN, CF6 6JT, CF6 6JY, CF6 6RU, CF6 6SQ, CF6 6SS, CF6 6SX, CF6 6TH, CF6 6UD, CF6 6XT, CF63 4AT, CF63 4BA, CF63 4DF, CF63 4DG, CF63 4HD, CF63 4JJ, CF63 4LG, CF63 4LH, CF63 4RU, CF63 4SQ, CF63 4SS, CF63 4SX, CF63 4TH, CF63 4XT, CF63 4ZA, CF63 9AG, CF63 9YX, CF63 9ZY, CF63 9ZZ",280,246,34
W00009836,CF6,"CF6 2YA, CF64 5AA, CF64 5QE, CF64 5QF, CF64 5QG, CF64 5QH, CF64 5XX, CF64 5YA",343,323,20
W00009837,CF6,"CF6 2QE, CF6 2QW, CF6 2RA, CF6 2RB, CF6 2RD, CF64 3QE, CF64 3QW, CF64 3RA, CF64 3RB, CF64 3RD, CF64 3RG",226,215,11
W00009838,CF6,"CF6 2XU, CF6 6JF, CF6 6JP, CF6 6JQ, CF6 6LQ, CF6 6QU, CF6 6UN, CF6 6UX, CF6 6XH, CF6 6XP, CF6 6XR, CF63 3RA, CF63 3RG, CF63 3US, CF63 3UX, CF63 4AE, CF63 4JF, CF63 4JP, CF63 4LE, CF63 4UX, CF64 5AB, CF64 5XU",162,146,16
W00009852,CF6,"CF6 2JY, CF6 2SE, CF6 2SG, CF6 2SJ, CF6 2TG, CF64 5GB, CF64 5JY, CF64 5TG",190,182,8
W00009839,CF6,"CF6 1SF, CF6 1XZ, CF64 1SB, CF64 1SF, CF64 1SH, CF64 1SR, CF64 1SW, CF64 1SX",200,185,15
W00009840,CF6,"CF6 9HQ, CF6 9JY, CF6 9JZ, CF6 9LW, CF6 9LX, CF6 9QR, CF6 9ZX, CF6 9ZY, CF6 9ZZ, CF62 3JY, CF62 4HD, CF62 4HF, CF62 4HH, CF62 4HL, CF62 4HN, CF62 4HP, CF62 4HQ, CF62 4JB, CF62 4JY, CF62 4LW, CF62 4LX, CF62 4NU, CF62 4NW, CF62 4WB, CF62 4ZX, CF62 4ZZ",329,295,34
W00009844,CF6,"CF6 7QF, CF63 1EG, CF63 1FN, CF63 1FT, CF63 1QF",250,215,35
W00009845,CF6,"CF6 9ZB, CF6 9ZD, CF6 9ZG, CF61 1AG, CF61 1ZB, CF61 1ZD, CF7 7QQ, CF7 7QS, CF71 7QQ",133,118,15
W00010618,CF6,"CF6 7SX, CF6 7TT, CF6 7UY, CF6 7UZ, CF62 7UY, CF62 7UZ, CF62 9ST, CF62 9SX, CF62 9TT, CF62 9TX, CF62 9TY, CF62 9UY, CF62 9UZ",160,136,24
W00009851,CF6,"CF6 2TJ, CF6 2TP, CF64 5TJ, CF64 5TP",127,115,12
W00009829,CF6,"CF6 6XS, CF6 8RY, CF6 8TP, CF6 8TQ, CF6 8TR, CF6 8UD, CF6 8ZA, CF6 8ZB, CF6 8ZD, CF6 8ZE, CF6 8ZF, CF6 8ZG, CF62 5AL, CF62 5DA, CF62 5TA, CF62 5TD, CF62 5TG, CF62 5TP, CF62 5TQ, CF62 5ZD, CF62 7ZD",253,235,18
W00005829,CF6,"CF6 1PE, CF6 1PJ, CF6 1PN, CF6 1PP, CF6 1PQ, CF6 1PS, CF6 1QD, CF64 2PD, CF64 2PE, CF64 2PJ, CF64 2PN, CF64 2PQ, CF64 2PS, CF64 2PT, CF64 2QD, CF64 2QJ",328,303,25
W00010610,CF6,"CF6 1HU, CF6 1HY, CF64 1HU, CF64 1HY, CF64 1HZ, CF64 1TA, CF64 1TH, CF64 1TJ",251,218,33
W00005715,CF6,"CF6 7QZ, CF6 7RH, CF6 7RJ, CF6 7RL, CF6 7RN, CF6 7RP, CF6 7RQ, CF6 7RS, CF63 1QD, CF63 1QZ, CF63 1RH, CF63 1RJ, CF63 1RL, CF63 1RN, CF63 1RP, CF63 1RQ, CF63 1RS, CF63 1SJ",350,304,46
W00005714,CF6,"CF6 6HT, CF6 6PQ, CF6 6PT, CF6 6PU, CF63 4HT, CF63 4PQ, CF63 4PT, CF63 4PU",277,247,30
W00005713,CF6,"CF6 6PW, CF6 6PX, CF6 6PY, CF6 7YB, CF63 3PY, CF63 4PW, CF63 4PX",293,250,43
W00005712,CF6,"CF6 6PN, CF6 6PP, CF6 6QH, CF6 6QJ, CF6 6TD, CF6 7EG, CF6 7ET, CF62 9XR, CF63 1ET, CF63 1QG, CF63 1TD, CF63 1XR, CF63 1XX, CF63 1XY, CF63 1XZ, CF63 4EE, CF63 4PN, CF63 4PP",316,281,35
W00005711,CF6,"CF6 7BD, CF6 7BE, CF6 7BW, CF6 7DD, CF6 7DG, CF6 7DH, CF6 7XX, CF62 9BE, CF63 1BD, CF63 1BW, CF63 1DG, CF63 1DH",304,282,22
W00005710,CF6,"CF6 6HX, CF6 6PZ, CF6 6QA, CF6 7EZ, CF63 1EZ, CF63 1NL, CF63 3PZ, CF63 3QA, CF63 4HX",270,235,35
W00005709,CF6,"CF6 7BB, CF6 7BX, CF6 7BZ, CF6 7DA, CF63 1BB, CF63 1BX, CF63 1BZ, CF63 1DA",269,243,26
W00005708,CF6,"CF6 7BT, CF6 7BU, CF6 7DB, CF6 7EE, CF6 7EF, CF6 7EU, CF6 7EX, CF6 7EY, CF63 1AB, CF63 1BU, CF63 1DB, CF63 1EE, CF63 1EF, CF63 1EU, CF63 1EX, CF63 1EY, CF63 2BU",329,289,40
W00005707,CF6,"CF6 7DP, CF6 7DQ, CF6 7DR, CF6 7DS, CF6 7DZ, CF62 9BX, CF62 9DZ, CF63 1DP, CF63 1DQ, CF63 1DR",279,257,22
W00005706,CF6,"CF6 7RF, CF6 7RG, CF6 7RR, CF6 7RT, CF6 7RU, CF6 7RW, CF6 7RX, CF6 7RY, CF6 7RZ, CF63 1RF, CF63 1RG, CF63 1RR, CF63 1RT, CF63 1RU, CF63 1RW, CF63 1RX, CF63 1RY, CF63 1RZ",333,297,36
W00005705,CF6,"CF6 7AX, CF6 7EB, CF6 7ED, CF6 7QW, CF6 7QX, CF6 7SF, CF6 7XU, CF63 1AH, CF63 1AX, CF63 1EB, CF63 1ED, CF63 1QW, CF63 1QX, CF63 1SF",299,272,27
W00005704,CF6,"CF6 6YU, CF6 7BS, CF6 7HS, CF6 7QE, CF6 7QT, CF6 7QU, CF6 7RA, CF6 7RB, CF6 7RD, CF6 7RE, CF63 1BS, CF63 1QB, CF63 1QE, CF63 1QT, CF63 1QU, CF63 1RA, CF63 1RB, CF63 1RD, CF63 1RE, CF63 1YE, CF63 1YF, CF63 1YH, CF63 1YL, CF63 1YN, CF63 1YR, CF63 1YS, CF63 1YT, CF63 1YW, CF63 2HS",299,275,24
W00005703,CF6,"CF6 1RL, CF6 1RN, CF6 1RU, CF6 1SS, CF6 1ST, CF64 2RL, CF64 2RN, CF64 2RU, CF64 2SS, CF64 2ST",330,280,50
W00005702,CF6,"CF6 1RR, CF6 1RS, CF6 1RT, CF6 1RY, CF6 1SH, CF6 1SJ, CF6 1SL, CF6 1SN, CF64 2RR, CF64 2RS, CF64 2RT, CF64 2RY, CF64 2SH, CF64 2SL, CF64 2SN",280,254,26
W00005701,CF6,"CF6 1RZ, CF6 1SA, CF6 1SD, CF6 1SE, CF64 2RZ, CF64 2SA, CF64 2SD, CF64 2SE",322,281,41
W00005700,CF6,"CF6 1QH, CF6 1QN, CF6 1QS, CF6 1QU, CF6 1QY, CF6 1RB, CF6 1RJ, CF64 1QH, CF64 2QH, CF64 2QN, CF64 2QS, CF64 2QU, CF64 2RB, CF64 2RJ",224,192,32
W00005699,CF6,"CF6 1JW, CF6 1JX, CF6 1JY, CF6 1LJ, CF6 1SB, CF64 2JW, CF64 2JX, CF64 2JY, CF64 2LJ, CF64 2SB, CF64 2SG",252,232,20
W00005716,CF6,"CF6 7AU, CF6 7AY, CF6 7DT, CF6 7DU, CF6 7DW, CF6 7DX, CF6 7DY, CF6 7FT, CF62 9BU, CF62 9DX, CF62 9DY, CF62 9FT, CF63 1AU, CF63 1AY, CF63 1DT, CF63 1DU",411,359,52
W00005698,CF6,"CF6 1JN, CF6 1LD, CF6 1LE, CF6 1LF, CF6 1LG, CF6 1LH, CF64 1JN, CF64 2LD, CF64 2LE, CF64 2LF, CF64 2LG, CF64 2LH",257,238,19
W00005717,CF6,"CF6 7PJ, CF6 7QY, CF6 7SA, CF6 7SB, CF6 7SE, CF6 7XT, CF6 7YS, CF63 1PJ, CF63 1QY, CF63 1SA, CF63 1SB, CF63 1SE",282,248,34
W00005856,CF6,"CF6 9QT, CF6 9QW, CF6 9QY, CF6 9SZ, CF6 9TA, CF61 1QT, CF61 1QW, CF61 1QY, CF61 1SZ, CF61 1TA",288,245,43
W00005740,CF6,"CF6 4TS, CF6 4TU, CF6 4TW, CF6 4TX, CF6 4UL, CF64 4TS, CF64 4TU, CF64 4TW, CF64 4TX, CF64 4UL",268,242,26
W00005831,CF6,"CF6 1LU, CF6 1LX, CF6 1QG, CF6 1XW, CF6 1XX, CF6 2XT, CF64 2HR, CF64 2LR, CF64 2LU, CF64 2LX, CF64 2QG, CF64 2XG, CF64 2XW, CF64 2XX",341,313,28
W00005832,CF6,"CF6 1NY, CF6 1NZ, CF6 1PA, CF6 1PB, CF6 1PD, CF6 1PL, CF6 1PZ, CF6 1QB, CF6 1QX, CF6 1XH, CF64 2NY, CF64 2NZ, CF64 2PA, CF64 2PB, CF64 2PL, CF64 2PZ, CF64 2QB, CF64 2QX",293,262,31
W00010525,CF6,"CF6 6TX, CF6 6XG, CF6 6XX, CF62 5DN, CF62 5DP, CF62 5DQ, CF62 5DR, CF62 5DS, CF62 5DU, CF63 4BH",248,223,25
W00005843,CF6,"CF6 9QN, CF6 9QP, CF6 9WJ, CF6 9XQ, CF6 9XR, CF61 2WJ, CF61 2XQ, CF61 2XR, CF61 2XY, CF61 2XZ, CF61 2ZB, CF62 4AJ, CF62 4QN, CF62 4QP, CF62 4QR",404,366,38
W00005844,CF6,"CF6 9LU, CF6 9XG, CF6 9XH, CF6 9XJ, CF6 9XT, CF61 2LU, CF61 2XG, CF61 2XH, CF61 2XJ, CF61 2XT",239,223,16
W00005845,CF6,"CF6 9GN, CF6 9GT, CF6 9UB, CF6 9UG, CF6 9UL, CF6 9YF, CF61 1UL, CF61 1YF, CF61 2GN, CF61 2GT, CF61 2UG",290,266,24
W00005846,CF6,"CF6 9GB, CF6 9GE, CF6 9LH, CF6 9LN, CF6 9UE, CF61 1LH, CF61 2GB, CF61 2GE, CF61 2LH, CF61 2LN, CF61 2UE",235,224,11
W00005847,CF6,"CF6 9AT, CF6 9HT, CF6 9NR, CF6 9TZ, CF6 9UA, CF6 9UH, CF6 9UZ, CF6 9YN, CF61 1UA, CF61 1UB, CF61 1UH, CF61 1UZ, CF61 1YN, CF61 2AT, CF61 2AU, CF61 2AW, CF62 4AB, CF62 4HT, CF62 4NR",527,471,56
W00005848,CF6,"CF6 9WL, CF6 9WR, CF6 9WS, CF6 9WT, CF6 9WW, CF6 9WZ, CF6 9YA, CF6 9YB, CF6 9YE, CF61 1AF, CF61 1WN, CF61 1WW, CF61 1WZ, CF61 1YA, CF61 1YB, CF61 1YE, CF61 1YJ, CF62 3WT",328,292,36
W00005849,CF6,"CF6 9GW, CF6 9GX, CF6 9GY, CF6 9GZ, CF6 9UD, CF6 9UF, CF61 1GW, CF61 1GX, CF61 1GY, CF61 1GZ, CF61 1UD, CF61 1UE, CF61 1UF",274,255,19
W00005850,CF6,"CF6 9TE, CF6 9TF, CF6 9TJ, CF6 9WD, CF6 9WQ, CF61 1TE, CF61 1TF, CF61 1TG, CF61 1TJ, CF61 1XD, CF61 1YL",313,279,34
W00005851,CF6,"CF6 9AW, CF6 9RS, CF6 9RX, CF6 9TQ, CF6 9TR, CF6 9TS, CF6 9TT, CF6 9TU, CF6 9TW, CF61 1AW, CF61 1RS, CF61 1RX, CF61 1TQ, CF61 1TR, CF61 1TS, CF61 1TT, CF61 1TU, CF61 1TW",272,244,28
W00005852,CF6,"CF6 9QE, CF6 9QX, CF6 9QZ, CF6 9RF, CF6 9RG, CF6 9RL, CF6 9RU, CF6 9RW, CF61 1QE, CF61 1QX, CF61 1QZ, CF61 1RF, CF61 1RG, CF61 1RL, CF61 1RU, CF61 1RW",250,224,26
W00005853,CF6,"CF6 9UT, CF6 9UU, CF6 9UW, CF6 9UX, CF61 1UT, CF61 1UU, CF61 1UW, CF61 1UX",218,196,22
W00005854,CF6,"CF6 9RR, CF6 9TG, CF6 9TL, CF6 9TN, CF6 9TP, CF61 1RR, CF61 1TL, CF61 1TN, CF61 1TP, CF61 1TZ, CF61 1XE, CF61 1XH",284,254,30
W00005855,CF6,"CF6 9QU, CF6 9RN, CF6 9RP, CF6 9RQ, CF6 9RT, CF6 9TB, CF61 1PZ, CF61 1QU, CF61 1RN, CF61 1RP, CF61 1RQ, CF61 1RT, CF61 1TB",290,258,32
W00005718,CF6,"CF6 7AW, CF6 7DJ, CF6 7DL, CF6 7DN, CF6 7EA, CF63 1AW, CF63 1DJ, CF63 1DL, CF63 1DN, CF63 1EA",329,289,40
W00005741,CF6,"CF6 4UE, CF6 4UH, CF6 4UJ, CF6 4UN, CF64 4BG, CF64 4UE, CF64 4UH, CF64 4UJ, CF64 4UN",300,276,24
W00005697,CF6,"CF6 1JR, CF6 1JZ, CF6 1LA, CF64 2JB, CF64 2JZ, CF64 2LA",269,249,20
W00005695,CF6,"CF6 1QQ, CF6 1QW, CF6 1QZ, CF6 1RA, CF6 1RD, CF6 1RE, CF64 2QQ, CF64 2QW, CF64 2QZ, CF64 2RA, CF64 2RD, CF64 2RE",274,249,25
W00005670,CF6,"CF6 7HT, CF6 7JB, CF6 7JD, CF6 7JE, CF6 7JF, CF63 2HA, CF63 2HT, CF63 2JB, CF63 2JD, CF63 2JE, CF63 2JF",269,246,23
W00005669,CF6,"CF6 6QW, CF6 6RD, CF6 7NS, CF6 7NU, CF6 7NW, CF6 7NX, CF6 7NY, CF6 7PE, CF6 7XQ, CF6 7XW, CF6 7YH, CF6 7YJ, CF6 7YL, CF63 2NS, CF63 2NU, CF63 2NW, CF63 2NX, CF63 2NY, CF63 2PE, CF63 2RD, CF63 2WA, CF63 2XQ, CF63 2YL, CF63 2YN",253,245,8
W00005668,CF6,"CF6 7EW, CF6 7HA, CF6 7HD, CF6 7HE, CF6 7HF, CF6 7HG, CF6 7JG, CF63 1BT, CF63 1EW, CF63 1HA, CF63 1JG, CF63 2HD, CF63 2HE, CF63 2HF, CF63 2HG, CF63 2JG",272,247,25
W00005667,CF6,"CF6 6QP, CF6 6QX, CF6 6QY, CF6 7NZ, CF6 7PA, CF6 7PB, CF63 2NZ, CF63 2PA, CF63 2PB, CF63 2PQ, CF63 2QP, CF63 2QW, CF63 2QX, CF63 2QY",327,281,46
W00005666,CF6,"CF6 6QQ, CF6 7HW, CF6 7HX, CF6 7JJ, CF6 7JL, CF6 7LN, CF6 7YE, CF63 1EN, CF63 2AY, CF63 2EN, CF63 2HW, CF63 2HX, CF63 2JJ, CF63 2JL, CF63 2JX, CF63 2LN, CF63 2QQ, CF63 2YD, CF63 2YE",251,239,12
W00005665,CF6,"CF6 6RA, CF6 6RB, CF6 7NR, CF6 7NT, CF63 2NR, CF63 2NT, CF63 2RA, CF63 2RB, CF63 2RE, CF63 2YY, CF63 2YZ",350,311,39
W00005664,CF6,"CF6 3AS, CF6 3YB, CF6 3YD, CF6 6QN, CF6 6QZ, CF6 7JN, CF6 7JP, CF63 2AS, CF63 2JN, CF63 2JP, CF63 2QN, CF63 2QZ",254,239,15
W00010617,CF6,"CF6 8FQ, CF6 8RF, CF6 8RL, CF6 8SB, CF6 8SD, CF6 8SE, CF6 8SH, CF6 8XD, CF62 5HA, CF62 5SB, CF62 6QS, CF62 6SD, CF62 6SE, CF62 6SH, CF62 7RF, CF62 7RL",307,258,49
W00005662,CF6,"CF6 7FU, CF6 7HN, CF6 7JW, CF6 7JX, CF6 7JZ, CF6 7LA, CF6 7YG, CF63 1FU, CF63 1JX, CF63 1JZ, CF63 1LA, CF63 2FU, CF63 2HN, CF63 2JW",281,265,16
W00005661,CF6,"CF6 3AL, CF6 3AP, CF6 3AQ, CF6 3AR, CF6 7YT, CF63 2AL, CF63 2AP, CF63 2AQ, CF63 2AR, CF63 2YA, CF63 2YB, CF63 2YH, CF63 2YT",331,292,39
W00005660,CF6,"CF6 7HQ, CF6 7JR, CF6 7LB, CF6 7LD, CF6 7LE, CF6 7LH, CF6 7LJ, CF6 7LL, CF6 7PH, CF6 7QS, CF63 1JR, CF63 1LB, CF63 1LD, CF63 1LE, CF63 1LH, CF63 1LJ, CF63 1LL, CF63 1PH, CF63 1QS, CF63 2HQ, CF63 2PH",252,233,19
W00005659,CF6,"CF6 3BE, CF6 3BG, CF63 2AW, CF63 2BE, CF63 2BG, CF63 2PJ, CF63 2PL, CF63 2PN, CF63 2XL",340,312,28
W00005658,CF6,"CF6 7LT, CF6 7NF, CF6 7PD, CF63 1LT, CF63 1NF, CF63 2PD",196,189,7
W00005657,CF6,"CF6 3AT, CF6 7NL, CF6 7NN, CF6 7PF, CF6 7PG, CF6 7YZ, CF63 2AT, CF63 2NL, CF63 2NN, CF63 2PF, CF63 2PG, CF63 2XA",359,330,29
W00005656,CF6,"CF6 7LS, CF6 7LU, CF6 7LW, CF6 7LX, CF6 7LY, CF6 7LZ, CF6 7NA, CF6 7NB, CF63 1LS, CF63 1LU, CF63 1LW, CF63 1LX, CF63 1LY, CF63 1LZ, CF63 1NA, CF63 1NB",299,273,26
W00005655,CF6,"CF6 3AG, CF6 3AJ, CF6 7NG, CF6 7NQ, CF63 1NG, CF63 2AG, CF63 2AJ",259,234,25
W00005654,CF6,"CF6 3AE, CF6 3YA, CF6 7FE, CF6 7NH, CF6 7NJ, CF6 7NP, CF63 2AE, CF63 2FE, CF63 2FH, CF63 2FJ, CF63 2FL, CF63 2FW, CF63 2NG, CF63 2NH, CF63 2NJ, CF63 2NP",325,301,24
W00005671,CF6,"CF6 6QB, CF6 6QD, CF6 6QE, CF6 6QF, CF6 6QG, CF63 3QB, CF63 3QD, CF63 3QE, CF63 3QF, CF63 3QG, CF63 4JD",245,224,21
W00005696,CF6,"CF6 1JG, CF6 1JS, CF6 1JT, CF6 1JU, CF64 1JG, CF64 1JS, CF64 2JR, CF64 2JS, CF64 2JT, CF64 2JU, CF64 2SF",283,255,28
W00005672,CF6,"CF6 7FP, CF6 7FQ, CF6 7FR, CF6 7FS, CF63 1FP, CF63 1FQ, CF63 1FR, CF63 1FS",240,213,27
W00005674,CF6,"CF6 6JH, CF6 6JZ, CF6 6UF, CF63 4JH, CF63 4JN, CF63 4JT, CF63 4JY, CF63 4UF",262,233,29
W00005694,CF6,"CF6 1NU, CF6 1NW, CF6 1NX, CF6 1QE, CF6 1QF, CF64 2NU, CF64 2NW, CF64 2QE, CF64 2QF, CF64 2QY",286,260,26
W00005693,CF6,"CF6 1BS, CF6 1NE, CF6 1NS, CF6 1NT, CF6 1WY, CF64 1BS, CF64 2AR, CF64 2NR, CF64 2NS, CF64 2NT, CF64 2NX",280,239,41
W00005692,CF6,"CF6 1SR, CF6 1SX, CF6 1SZ, CF6 1TA, CF6 1UY, CF6 1WF, CF6 1WU, CF64 2AQ, CF64 2SR, CF64 2SX, CF64 2SZ, CF64 2TA, CF64 2UY, CF64 2WF",313,270,43
W00005691,CF6,"CF6 1SG, CF6 1SP, CF6 1SQ, CF6 1SU, CF6 1TZ, CF6 1UA, CF6 1UX, CF64 2SP, CF64 2SQ, CF64 2SU, CF64 2TZ, CF64 2UA, CF64 2UX",285,238,47
W00005690,CF6,"CF6 1QR, CF6 1QT, CF6 1TW, CF6 1WG, CF6 1WP, CF6 1WR, CF6 1WT, CF6 1XP, CF6 2TU, CF64 2QR, CF64 2QT, CF64 2TP, CF64 2TU, CF64 2UE, CF64 2WG, CF64 2WP, CF64 2WR, CF64 2WS, CF64 2WT, CF64 2XP",277,243,34
W00005689,CF6,"CF6 1SW, CF6 1SY, CF6 1TB, CF6 1TD, CF6 1TE, CF6 1TF, CF6 1TG, CF64 2SW, CF64 2SY, CF64 2TB, CF64 2TD, CF64 2TE, CF64 2TF, CF64 2TG",323,272,51
W00005688,CF6,"CF6 1TS, CF6 1TY, CF6 1UB, CF6 1UW, CF6 2LB, CF6 2LH, CF64 2NH, CF64 2TY, CF64 2UB, CF64 2UW",248,214,34
W00005687,CF6,"CF6 1QP, CF6 1RP, CF6 1RQ, CF6 1RW, CF6 1TH, CF6 1TJ, CF6 1TL, CF64 2QP, CF64 2RP, CF64 2RQ, CF64 2RW, CF64 2TH, CF64 2TJ, CF64 2TL",297,261,36
W00005686,CF6,"CF6 1QJ, CF6 1QL, CF6 1RF, CF6 1RG, CF6 1RH, CF6 1RX, CF6 1XY, CF6 1YB, CF64 2BH, CF64 2QL, CF64 2RF, CF64 2RG, CF64 2RH, CF64 2RX, CF64 2XF, CF64 2XN, CF64 2YD, CF64 2YF, CF64 2YL, CF64 2YP, CF64 2YW, CF64 2YZ",323,302,21
W00005684,CF6,"CF6 6LN, CF6 6LU, CF6 6LW, CF6 6LY, CF63 4LN, CF63 4LU, CF63 4LW, CF63 4LY, CF63 4LZ",304,278,26
W00005683,CF6,"CF6 6HL, CF6 6HN, CF6 6HQ, CF6 6HS, CF6 6LA, CF6 6LR, CF6 6LX, CF6 6TG, CF6 6TR, CF6 6TY, CF6 6UA, CF6 6XU, CF6 6YA, CF6 6YB, CF6 6YD, CF6 6YG, CF6 6YH, CF62 5XZ, CF63 1YJ, CF63 4HL, CF63 4HN, CF63 4HQ, CF63 4HS, CF63 4JS, CF63 4LA, CF63 4LR, CF63 4LX, CF63 4TR, CF63 4TX, CF63 4TY, CF63 4UA, CF63 4YG",267,243,24
W00005681,CF6,"CF6 6JD, CF6 6NJ, CF6 6NN, CF6 6NP, CF6 6PH, CF63 4NJ, CF63 4NN, CF63 4NP, CF63 4PH",287,250,37
W00005680,CF6,"CF6 6HU, CF6 6NQ, CF6 6NU, CF6 6PJ, CF6 6PS, CF63 3NQ, CF63 3NU, CF63 4HU, CF63 4PJ, CF63 4PS",324,303,21
W00005679,CF6,"CF6 6NR, CF6 6NS, CF6 6NT, CF63 3NR, CF63 3NS, CF63 3NT, CF63 3QQ, CF63 3YD",247,216,31
W00005678,CF6,"CF6 6HW, CF6 6NW, CF6 6NX, CF6 6NY, CF63 3NW, CF63 3NX, CF63 3NY, CF63 4HW",244,219,25
W00005677,CF6,"CF6 6HY, CF6 6HZ, CF6 6JA, CF6 6JB, CF6 6NZ, CF6 7YD, CF63 3HX, CF63 3HZ, CF63 3JA, CF63 3JB, CF63 3JD, CF63 3NZ, CF63 4HY",201,181,20
W00005676,CF6,"CF6 6JR, CF6 6UJ, CF6 6XJ, CF6 6XN, CF63 4JQ, CF63 4JR, CF63 4JW, CF63 4JX",316,264,52
W00005673,CF6,"CF6 6JE, CF6 6LL, CF6 6LP, CF6 6LS, CF6 6LT, CF6 6NL, CF6 6PA, CF63 4AB, CF63 4JB, CF63 4JE, CF63 4LL, CF63 4LP, CF63 4LQ, CF63 4LS, CF63 4LT, CF63 4NL",524,477,47
W00005742,CF6,"CF6 4LD, CF6 4LE, CF6 4LP, CF6 4LQ, CF6 4PJ, CF64 4LD, CF64 4LE, CF64 4LP, CF64 4LQ, CF64 4PJ",256,226,30
W00005743,CF6,"CF6 2HR, CF6 2TW, CF6 2TX, CF6 2UA, CF6 4NH, CF6 4NX, CF6 4PS, CF6 4PT, CF6 4RE, CF6 4RG, CF64 2TQ, CF64 4NH, CF64 4NX, CF64 4PS, CF64 4PT, CF64 4RE, CF64 4RG, CF64 4RH, CF64 4RJ, CF64 4RN",545,472,73
W00005744,CF6,"CF6 4TN, CF6 4TT, CF6 4UD, CF6 4UF, CF6 4UG, CF6 4UQ, CF64 4TN, CF64 4TT, CF64 4UD, CF64 4UF, CF64 4UG, CF64 4UQ",222,207,15
W00005807,CF6,"CF6 8JJ, CF6 8JL, CF62 7FJ, CF62 7JJ, CF62 7JL",213,205,8
W00005806,CF6,"CF6 8FP, CF6 8LT, CF6 8LW, CF6 8LX, CF6 8LY, CF6 9AZ, CF6 9BA, CF6 9BY, CF62 3AZ, CF62 3BA, CF62 6FP, CF62 7LT, CF62 7LW, CF62 7LX, CF62 7LY, CF62 8FP",210,180,30
W00005805,CF6,"CF6 8FA, CF6 8LS, CF6 8NA, CF6 8NB, CF6 8ND, CF6 8NE, CF6 8NF, CF6 8NJ, CF62 7LS, CF62 7NA, CF62 7NB, CF62 7ND, CF62 7NE, CF62 7NF, CF62 7NJ",256,230,26
W00005804,CF6,"CF6 8FD, CF6 8HA, CF6 8LG, CF6 8NG, CF6 8NH, CF6 8TE, CF62 7HA, CF62 7LG, CF62 7NG, CF62 7NH, CF62 7TE",275,252,23
W00005803,CF6,"CF6 8PW, CF6 8PX, CF6 8PY, CF6 8PZ, CF6 8XJ, CF62 7FA, CF62 7PW, CF62 7PX, CF62 7PY, CF62 7PZ, CF62 8FA",270,241,29
W00005802,CF6,"CF6 8FN, CF6 8JF, CF6 8JH, CF62 7FL, CF62 7FN, CF62 7JF, CF62 7JH, CF62 8FL",256,227,29
W00005801,CF6,"CF6 8LU, CF6 8LZ, CF62 6LJ, CF62 6LR, CF62 6LS, CF62 6LT, CF62 6LZ, CF62 7LU",313,265,48
W00005800,CF6,"CF6 3HA, CF6 7AZ, CF6 7SL, CF62 9BT, CF62 9HA, CF62 9HB, CF63 1SL",263,229,34
W00005799,CF6,"CF6 3DD, CF6 3DE, CF6 7TH, CF62 9DD, CF62 9DE, CF62 9TH",284,261,23
W00005798,CF6,"CF6 7SG, CF6 7SH, CF6 7SQ, CF6 7TX, CF6 7TY, CF62 9AZ, CF63 1AZ, CF63 1SG, CF63 1SH, CF63 1SQ, CF63 1TX, CF63 1TY",231,208,23
W00005797,CF6,"CF6 3HD, CF6 3HE, CF6 3HF, CF6 3HG, CF6 3HH, CF6 3HJ, CF62 9HD, CF62 9HE, CF62 9HF, CF62 9HG, CF62 9HH, CF62 9HJ",423,377,46
W00005796,CF6,"CF6 7FN, CF6 7FW, CF6 7PX, CF6 7PZ, CF6 7TE, CF6 7TF, CF6 7TG, CF6 7XR, CF6 7XS, CF6 7XY, CF6 7YQ, CF62 9FN, CF62 9PX, CF62 9PZ, CF62 9TE, CF62 9TF, CF62 9TG, CF62 9UA, CF62 9XS, CF62 9YQ, CF62 9ZB, CF62 9ZY",319,283,36
W00005795,CF6,"CF6 3DA, CF6 3DB, CF6 3DJ, CF6 3HL, CF62 9AX, CF62 9BZ, CF62 9DA, CF62 9DB, CF62 9DJ, CF62 9HL",288,252,36
W00005794,CF6,"CF6 7AA, CF6 7AB, CF6 7AD, CF6 7AE, CF6 7BG, CF6 7BL, CF6 7BR, CF62 8HE, CF62 9AA, CF62 9AB, CF62 9AD, CF62 9BG, CF62 9BR",250,220,30
W00005793,CF6,"CF6 7AF, CF6 7AH, CF6 7AP, CF6 7AS, CF6 7AT, CF62 9AF, CF62 9AH, CF62 9AP, CF62 9AS, CF62 9AT, CF62 9AU, CF63 1AE",239,220,19
W00005792,CF6,"CF6 7AG, CF6 7BH, CF6 7DE, CF6 7DF, CF62 9AE, CF62 9AG, CF62 9BH, CF62 9BY",210,192,18
W00005791,CF6,"CF6 3EJ, CF6 7AJ, CF6 7AL, CF6 7AN, CF6 7AQ, CF6 7AR, CF62 9AJ, CF62 9AL, CF62 9AN, CF62 9AQ, CF62 9AR, CF62 9EJ",321,288,33
W00005808,CF6,"CF6 8LQ, CF62 6LG, CF62 6LH, CF62 6LN, CF62 7LQ",281,257,24
W00005790,CF6,"CF6 3DN, CF6 3DP, CF6 3DQ, CF6 3DR, CF6 3DS, CF6 3DT, CF6 3DU, CF6 3DW, CF6 3EH, CF62 9DN, CF62 9DP, CF62 9DQ, CF62 9DR, CF62 9DS, CF62 9DT, CF62 9DU, CF62 9DW, CF62 9EH",300,257,43
W00005809,CF6,"CF6 8HL, CF6 8HQ, CF6 8JG, CF6 8NL, CF6 8YB, CF6 8YN, CF62 7HL, CF62 7HQ, CF62 7JG, CF62 7NL, CF62 7XB, CF62 7YL, CF62 7YU, CF62 7YW, CF62 7YX, CF62 7YY, CF62 7YZ, CF62 7ZA",236,200,36
W00005811,CF6,"CF6 8HR, CF6 8HS, CF6 8HZ, CF6 8LN, CF6 8LR, CF6 8NN, CF6 8NP, CF62 6PU, CF62 7HR, CF62 7HS, CF62 7HZ, CF62 7LN, CF62 7LR, CF62 7NN, CF62 7NP",288,258,30
W00005828,CF6,"CF6 8HB, CF6 8LH, CF6 8TF, CF6 8TL, CF62 5TL, CF62 7HB, CF62 7LH, CF62 7TF, CF62 7TL, CF62 8FD",281,247,34
W00005827,CF6,"CF6 8QS, CF6 8QT, CF6 8QU, CF62 7FG, CF62 7JN, CF62 7QS, CF62 7QT, CF62 7QU, CF62 8FG",190,165,25
W00005826,CF6,"CF6 8BH, CF6 8BJ, CF6 8BL, CF6 8TG, CF62 7BH, CF62 7BJ, CF62 7BL, CF62 7TG, CF62 7XA",243,215,28
W00005825,CF6,"CF6 8BN, CF6 8DR, CF6 8EZ, CF6 8XL, CF62 7BN, CF62 7DR, CF62 7EZ, CF62 7XL",276,265,11
W00005824,CF6,"CF6 8DN, CF6 8YJ, CF62 7JP, CF62 7JR, CF62 8JA, CF62 8YJ, CF62 8YP",298,261,37
W00005823,CF6,"CF6 8DL, CF6 8LJ, CF6 8YL, CF6 9NS, CF6 9NT, CF6 9ZJ, CF62 3ZJ, CF62 7JQ, CF62 7LJ, CF62 8HZ, CF62 8NS, CF62 8NT, CF62 8YU, CF62 8ZJ, CF62 8ZR",268,246,22
W00005822,CF6,"CF6 5AB, CF6 9AX, CF6 9NU, CF62 8AB, CF62 8AS, CF62 8GP, CF62 8JE, CF62 8JJ, CF62 8JL, CF62 8NU, CF62 8NX",308,274,34
W00005821,CF6,"CF6 8HD, CF6 8JN, CF6 8JP, CF6 8JQ, CF62 6HD, CF62 6JN, CF62 6JP, CF62 6JQ",330,284,46
W00005820,CF6,"CF6 8PB, CF6 8PD, CF6 8PE, CF6 8PF, CF6 8PH, CF6 8PU, CF62 6PB, CF62 6PD, CF62 6PE, CF62 6PF, CF62 6PG, CF62 6PH",287,255,32
W00005819,CF6,"CF6 8JR, CF6 8JS, CF6 8JT, CF6 8JU, CF62 6JR, CF62 6JS, CF62 6JT, CF62 6JU",222,192,30
W00005818,CF6,"CF6 8DU, CF6 8EF, CF6 8EG, CF6 8EL, CF6 8YP, CF62 7DU, CF62 7EF, CF62 7EG, CF62 7EL, CF62 7YN, CF62 7YP",334,298,36
W00005817,CF6,"CF6 8AY, CF6 8EE, CF6 8EP, CF6 8HE, CF6 8LF, CF6 8XY, CF6 8YQ, CF62 6HE, CF62 6LF, CF62 7AY, CF62 7BA, CF62 7EE, CF62 7EP, CF62 7XY, CF62 7YQ",340,290,50
W00005816,CF6,"CF6 8JW, CF6 8JX, CF6 8JY, CF6 8JZ, CF62 6JW, CF62 6JX, CF62 6JY, CF62 6JZ",288,245,43
W00005815,CF6,"CF6 8AA, CF6 8AB, CF6 8AD, CF6 8AR, CF6 8DS, CF6 8DT, CF6 8DW, CF6 8DX, CF6 8DY, CF6 8DZ, CF6 8EA, CF6 8EB, CF6 8XP, CF6 8XT, CF6 8XU, CF6 8YR, CF6 8YS, CF6 8YT, CF62 7AA, CF62 7AB, CF62 7AD, CF62 7AR, CF62 7DS, CF62 7DT, CF62 7DW, CF62 7DX, CF62 7DY, CF62 7DZ, CF62 7EA, CF62 7EB, CF62 7XP, CF62 7XX, CF62 7YR, CF62 7YS",245,221,24
W00005814,CF6,"CF6 8EJ, CF6 8EN, CF6 8EQ, CF6 8ER, CF6 8EY, CF62 7EJ, CF62 7EN, CF62 7EQ, CF62 7ER, CF62 7EY",303,266,37
W00005813,CF6,"CF6 8ES, CF6 8ET, CF6 8HY, CF62 7ES, CF62 7ET, CF62 7HY",301,261,40
W00005812,CF6,"CF6 8LE, CF62 6LE, CF62 6LP, CF62 6LU, CF62 6LW, CF62 6LX, CF62 6LY",387,329,58
W00005810,CF6,"CF6 8LA, CF6 8LB, CF6 8LD, CF6 8LL, CF6 8LP, CF62 6LA, CF62 6LB, CF62 6LD, CF62 6LL, CF62 7LP",216,200,16
W00005789,CF6,"CF6 3DF, CF6 3DG, CF6 3DH, CF6 3DL, CF6 3ED, CF6 3EE, CF6 3EF, CF6 3EN, CF62 9DF, CF62 9DG, CF62 9DH, CF62 9DL, CF62 9ED, CF62 9EE, CF62 9EF, CF62 9EN, CF62 9YA, CF62 9YB, CF62 9YD, CF62 9YE, CF62 9YF",250,219,31
W00005788,CF6,"CF6 7QJ, CF6 7QL, CF6 7QN, CF6 7QQ, CF6 7UB, CF6 7UD, CF62 5XY, CF62 9BS, CF63 1QH, CF63 1QJ, CF63 1QL, CF63 1QN, CF63 1QQ, CF63 1UB, CF63 1UD",201,187,14
W00005787,CF6,"CF6 7SJ, CF6 7SN, CF6 7SP, CF6 7SR, CF6 7SS, CF6 7ST, CF6 7TZ, CF6 7UA, CF6 7UE, CF6 7UF, CF62 9BW, CF63 1SN, CF63 1SP, CF63 1SR, CF63 1SS, CF63 1ST, CF63 1TZ, CF63 1UA, CF63 1UE, CF63 1UF",278,251,27
W00005762,CF6,"CF6 1UU, CF6 2TY, CF6 2UB, CF6 2XD, CF6 2XX, CF6 3BA, CF6 4QP, CF6 4SA, CF6 4TH, CF6 4TL, CF6 4TP, CF6 4TQ, CF6 4TR, CF6 4YB, CF63 2BA, CF64 2TR, CF64 2UU, CF64 3UU, CF64 4BN, CF64 4BP, CF64 4QP, CF64 4RL, CF64 4RP, CF64 4SA, CF64 4TH, CF64 4TL, CF64 4TP, CF64 4TQ, CF64 4TR, CF64 4YB, CF64 5RP, CF64 5YX",508,451,57
W00005761,CF6,"CF6 4AW, CF6 4AX, CF6 4RB, CF6 4RF, CF64 4AW, CF64 4AX, CF64 4RB, CF64 4RF",283,247,36
W00005759,CF6,"CF6 4AQ, CF6 4AR, CF6 4AS, CF6 4AT, CF6 4AY, CF6 4BA, CF6 4HB, CF6 4HS, CF64 4AQ, CF64 4AR, CF64 4AS, CF64 4AT, CF64 4AY, CF64 4BA, CF64 4BH, CF64 4BL, CF64 4HB, CF64 4HS",300,270,30
W00005758,CF6,"CF6 4NG, CF6 4NJ, CF6 4QL, CF6 4QR, CF6 4QT, CF6 4QY, CF6 4QZ, CF64 4NG, CF64 4NJ, CF64 4QL, CF64 4QR, CF64 4QT, CF64 4QY, CF64 4QZ",232,213,19
W00005757,CF6,"CF6 4AB, CF6 4DH, CF6 4QN, CF6 4TD, CF6 4TF, CF6 4TY, CF6 4TZ, CF6 4UP, CF6 4XA, CF6 4XB, CF64 4AB, CF64 4BD, CF64 4DH, CF64 4QN, CF64 4TD, CF64 4TF, CF64 4TY, CF64 4TZ, CF64 4UP, CF64 4XH",317,274,43
W00005756,CF6,"CF6 4AF, CF6 4AG, CF6 4AJ, CF6 4AN, CF6 4AP, CF6 4AZ, CF64 4AF, CF64 4AG, CF64 4AJ, CF64 4AN, CF64 4AP, CF64 4AZ",268,225,43
W00005755,CF6,"CF6 4AA, CF6 4AH, CF6 4AL, CF6 4AU, CF6 4BR, CF6 4BS, CF6 4BT, CF6 4DE, CF6 4DF, CF6 4DQ, CF6 4DS, CF6 4YA, CF64 4AA, CF64 4AH, CF64 4AL, CF64 4AU, CF64 4BB, CF64 4BR, CF64 4BS, CF64 4BT, CF64 4DE, CF64 4DF, CF64 4DQ, CF64 4DS, CF64 4DW",281,243,38
W00005754,CF6,"CF6 4NN, CF6 4NP, CF6 4NQ, CF6 4NU, CF6 4PE, CF6 4RD, CF64 4NN, CF64 4NP, CF64 4NQ, CF64 4NU, CF64 4PE, CF64 4RD",286,247,39
W00005753,CF6,"CF6 4DJ, CF6 4JL, CF6 4NL, CF6 4NR, CF6 4NS, CF6 4NT, CF6 4PA, CF6 4QJ, CF6 4YD, CF6 4YE, CF6 4YF, CF6 4YG, CF6 4YH, CF6 4YJ, CF6 4YL, CF6 4YN, CF6 4YP, CF6 4YQ, CF6 4YS, CF64 4DJ, CF64 4JL, CF64 4NL, CF64 4NR, CF64 4NS, CF64 4NT, CF64 4PA, CF64 4QJ, CF64 4XD, CF64 4XE, CF64 4XL, CF64 4YD, CF64 4YX",274,251,23
W00005752,CF6,"CF6 4DA, CF6 4DD, CF6 4JT, CF6 4JX, CF6 4JZ, CF64 4BF, CF64 4DA, CF64 4DD, CF64 4JT, CF64 4JX, CF64 4JZ",287,240,47
W00005751,CF6,"CF6 4AD, CF6 4AE, CF6 4BU, CF6 4BW, CF6 4BX, CF6 4BY, CF6 4HH, CF6 4JS, CF64 4AD, CF64 4AE, CF64 4BU, CF64 4BW, CF64 4BX, CF64 4BY, CF64 4HH, CF64 4JS, CF64 4YE",297,248,49
W00005750,CF6,"CF6 4JU, CF6 4LA, CF6 4NY, CF6 4NZ, CF6 4PB, CF6 4PD, CF6 4PH, CF64 4JU, CF64 4LA, CF64 4NY, CF64 4NZ, CF64 4PB, CF64 4PD, CF64 4PH",310,276,34
W00005749,CF6,"CF6 4BZ, CF6 4DB, CF6 4DR, CF6 4JH, CF6 4JJ, CF6 4JN, CF6 4JR, CF64 4BJ, CF64 4BZ, CF64 4DB, CF64 4DR, CF64 4JJ, CF64 4JN, CF64 4JR",317,284,33
W00005748,CF6,"CF6 4NW, CF6 4PF, CF6 4PG, CF6 4PL, CF6 4PN, CF6 4PP, CF6 4PQ, CF6 4PR, CF6 4PX, CF64 4NW, CF64 4PF, CF64 4PG, CF64 4PL, CF64 4PN, CF64 4PP, CF64 4PQ, CF64 4PR, CF64 4PX",276,252,24
W00005747,CF6,"CF6 4HG, CF6 4JW, CF6 4LF, CF6 4LG, CF6 4LH, CF6 4LJ, CF6 4LL, CF6 4LR, CF64 4HG, CF64 4JW, CF64 4LF, CF64 4LG, CF64 4LH, CF64 4LJ, CF64 4LL, CF64 4LR",271,244,27
W00005746,CF6,"CF6 4JP, CF6 4JQ, CF6 4LB, CF6 4LN, CF64 4JP, CF64 4JQ, CF64 4LB, CF64 4LN",248,215,33
W00005745,CF6,"CF6 4PU, CF6 4PW, CF6 4PY, CF6 4PZ, CF64 4JY, CF64 4PU, CF64 4PW, CF64 4PY, CF64 4PZ, CF64 4QA",466,434,32
W00005763,CF6,"CF6 4TB, CF6 4TE, CF6 4TG, CF6 4TJ, CF6 4UA, CF6 4UB, CF64 4TB, CF64 4TE, CF64 4TG, CF64 4TJ, CF64 4UA, CF64 4UB",255,228,27
W00005764,CF6,"CF6 4QQ, CF6 4QS, CF6 4QU, CF6 4QW, CF6 4QX, CF6 4RA, CF6 4TA, CF64 4QQ, CF64 4QS, CF64 4QU, CF64 4QW, CF64 4QX, CF64 4RA, CF64 4TA",272,257,15
W00005766,CF6,"CF6 5AH, CF6 5AL, CF6 5AN, CF6 5AP, CF6 5AY, CF62 8AH, CF62 8AL, CF62 8AN, CF62 8AP, CF62 8AY",310,286,24
W00005767,CF6,"CF6 7PY, CF6 7UR, CF6 7US, CF62 7UT, CF62 9PY, CF62 9UR, CF62 9US, CF62 9UT",306,279,27
W00005786,CF6,"CF6 7SZ, CF6 7TB, CF6 7TD, CF6 7TP, CF6 7TQ, CF6 7TS, CF62 9SZ, CF62 9TB, CF62 9TD, CF62 9TP, CF62 9TQ, CF62 9TS",343,314,29
W00005785,CF6,"CF6 7SY, CF6 7TA, CF6 7TJ, CF6 7TN, CF6 7TR, CF6 7XA, CF6 7XE, CF6 7XP, CF62 9SY, CF62 9TA, CF62 9TJ, CF62 9TN, CF62 9TR, CF62 9TZ, CF62 9XA, CF62 9XE, CF62 9XP",406,375,31
W00005784,CF6,"CF6 7PW, CF6 7QD, CF6 7XB, CF6 7XD, CF6 7XF, CF6 7XG, CF6 7XH, CF6 7YP, CF62 8QB, CF62 9AW, CF62 9PW, CF62 9QD, CF62 9XB, CF62 9XD, CF62 9XF, CF62 9XG, CF62 9XH",402,374,28
W00005783,CF6,"CF6 3EA, CF6 3EB, CF6 3EG, CF6 3EL, CF6 7TL, CF62 9EA, CF62 9EB, CF62 9EG, CF62 9EL, CF62 9TL",257,228,29
W00005782,CF6,"CF6 5AG, CF6 5AQ, CF6 9AA, CF62 8AG, CF62 8AQ",250,220,30
W00005781,CF6,"CF6 7SU, CF6 7SW, CF6 7TU, CF6 7UJ, CF62 7UX, CF62 8UJ, CF62 9SU, CF62 9SW, CF62 9TU, CF62 9UX, CF62 9WA",302,268,34
W00005780,CF6,"CF6 7UU, CF6 7UW, CF6 7XJ, CF6 7XL, CF6 7XN, CF62 9UU, CF62 9UW, CF62 9XJ, CF62 9XL, CF62 9XN",236,210,26
W00005779,CF6,"CF6 5AJ, CF6 5AR, CF6 5AS, CF6 5AU, CF6 5BA, CF6 5YN, CF6 5YP, CF62 8AJ, CF62 8AR, CF62 8AU, CF62 8BD, CF62 8BH",239,205,34
W00005653,CF6,"CF6 7FA, CF6 7FB, CF6 7FD, CF6 7FF, CF6 7FG, CF63 2FA, CF63 2FB, CF63 2FD, CF63 2FF, CF63 2FG",172,167,5
W00005778,CF6,"CF6 7PL, CF6 7PN, CF6 7PP, CF6 7PQ, CF6 7PS, CF6 7PT, CF6 7PU, CF6 7QA, CF6 7QB, CF6 7UL, CF6 7UN, CF6 7UP, CF6 7UQ, CF6 7UT, CF6 7UX, CF6 7XZ, CF6 7YN, CF62 7UP, CF62 8PL, CF62 8PN, CF62 8PP, CF62 8PQ, CF62 8PS, CF62 8UL, CF62 8UN, CF62 8UP, CF62 8UQ, CF62 8WH, CF62 8WS, CF62 8XZ, CF62 9PT, CF62 9PU, CF62 9QA, CF62 9XY, CF62 9YN",325,298,27
W00005776,CF6,"CF6 6BP, CF6 6BY, CF6 6BZ, CF6 6DB, CF6 6DF, CF6 6DG, CF62 8BY, CF62 8BZ, CF62 8DB, CF62 8DF, CF62 8DG, CF62 8YQ",280,255,25
W00005775,CF6,"CF6 6AE, CF6 6AJ, CF6 6AP, CF6 7BN, CF6 7BP, CF6 7BQ, CF62 8EH, CF62 8EP, CF62 8ES, CF62 8HF, CF62 8HG, CF62 8HH",266,239,27
W00005774,CF6,"CF6 6BB, CF6 6BD, CF6 6BG, CF6 6BQ, CF6 7BJ, CF62 8BB, CF62 8BG, CF62 8BJ, CF62 8BP, CF62 8BQ, CF63 1BG",342,315,27
W00005773,CF6,"CF6 6BW, CF6 6DE, CF6 8DQ, CF6 8FJ, CF6 8FL, CF6 9DQ, CF62 8BW, CF62 8DE, CF62 8JD, CF62 8JF",217,184,33
W00005771,CF6,"CF6 6BR, CF6 6BS, CF6 6BT, CF6 6BU, CF6 6BX, CF6 6DA, CF62 8BR, CF62 8BS, CF62 8BT, CF62 8BU, CF62 8BX, CF62 8DA",293,263,30
W00005770,CF6,"CF6 5AD, CF6 5AE, CF6 5AF, CF62 8AD, CF62 8AE, CF62 8AF",208,184,24
W00005769,CF6,"CF6 7UH, CF6 8BQ, CF6 8BS, CF6 8DP, CF6 8YH, CF62 8FJ, CF62 8HL, CF62 8HP, CF62 8JB, CF62 8UH, CF62 8YH",323,286,37
W00005768,CF6,"CF6 5AA, CF6 5AT, CF6 5AW, CF6 5AX, CF6 7PR, CF62 8AA, CF62 8AT, CF62 8AW, CF62 8AX, CF62 8PR",255,227,28
W00005777,CF6,"CF6 8BP, CF6 8BR, CF6 8UG, CF6 8YE, CF6 8YF, CF6 8YG, CF62 7UG, CF62 7WR, CF62 8HJ, CF62 8HN, CF62 8JG, CF62 8LF, CF62 8YE, CF62 8YF, CF62 8YG",322,278,44
W00005652,CF6,"CF6 7FH, CF6 7FJ, CF6 7FL, CF6 7LF, CF6 7LG, CF6 7ND, CF6 7NE, CF6 7SD, CF63 1FH, CF63 1FJ, CF63 1FL, CF63 1LF, CF63 1LG, CF63 1ND, CF63 1NE, CF63 1SD",300,275,25
W00005663,CF6,"CF6 7BY, CF6 7HP, CF6 7HR, CF6 7JY, CF6 7QP, CF6 7QR, CF63 1BY, CF63 1JY, CF63 1QP, CF63 1QR, CF63 2HP, CF63 2HR",280,259,21
W00005650,CF6,"CF6 3EP, CF6 3EQ, CF6 7EJ, CF6 7EL, CF62 9ES, CF63 1EJ, CF63 1EL, CF63 1EP, CF63 1EQ, CF63 1ES",288,257,31
W00005617,CF6,"CF6 8NX, CF6 8NZ, CF6 8PA, CF6 8PG, CF6 8PJ, CF62 6NX, CF62 6NZ, CF62 6PA, CF62 6PJ, CF62 6YB, CF62 6YD, CF62 6YF, CF62 6YH, CF62 6YJ, CF62 6YN, CF62 6YR, CF62 6ZG, CF62 7ZG",303,265,38
W00005616,CF6,"CF6 8QW, CF6 8RG, CF6 8RH, CF6 8RJ, CF6 8RZ, CF6 8SA, CF6 8XG, CF62 5RZ, CF62 5SA, CF62 6QW, CF62 7RG, CF62 7RH, CF62 7RJ",333,270,63
W00005615,CF6,"CF6 8AE, CF6 8AF, CF6 8AS, CF6 8AT, CF6 8AU, CF6 8AW, CF6 8AX, CF6 8AZ, CF6 8BA, CF6 8BB, CF6 8BD, CF6 8BG, CF6 8ED, CF6 8FG, CF6 8FH, CF6 8XN, CF6 8XR, CF6 8XS, CF6 8XZ, CF6 8YA, CF62 6AZ, CF62 6BA, CF62 6FG, CF62 6FH, CF62 7AF, CF62 7AN, CF62 7AP, CF62 7AS, CF62 7AT, CF62 7AU, CF62 7AW, CF62 7AX, CF62 7BB, CF62 7BD, CF62 7BE, CF62 7BG, CF62 7ED, CF62 7XN, CF62 7XR, CF62 7XS, CF62 8FH",398,344,54
W00005614,CF6,"CF6 8FB, CF6 8SG, CF6 8SQ, CF6 8SR, CF6 8ST, CF6 8TB, CF6 8TD, CF6 8YZ, CF62 6FB, CF62 6SG, CF62 6SQ, CF62 6SR, CF62 6ST, CF62 6TB, CF62 6TD, CF62 6YP",207,181,26
W00005613,CF6,"CF6 8RX, CF6 8SF, CF6 8SJ, CF6 8SL, CF6 8SN, CF6 8SP, CF6 8SS, CF6 8SU, CF6 8SW, CF6 8SX, CF6 8XF, CF62 5SP, CF62 6SF, CF62 6SJ, CF62 6SL, CF62 6SN, CF62 6SP, CF62 6SS, CF62 6SU, CF62 6SW, CF62 6SX",253,217,36
W00005611,CF6,"CF6 6XB, CF6 6XD, CF6 8TW, CF6 8TX, CF6 8TY, CF6 8UA, CF6 8UF, CF6 8UL, CF6 8UW, CF6 8XB, CF62 5TW, CF62 5TX, CF62 5TY, CF62 5UF, CF62 5UL, CF62 5UW, CF62 5XB, CF63 4XB",299,279,20
W00005610,CF6,"CF6 8UN, CF6 8UQ, CF6 8UR, CF6 8US, CF6 8UU, CF62 5UN, CF62 5UQ, CF62 5UR, CF62 5US, CF62 5UU, CF62 5YE, CF62 5YH, CF62 5YJ",250,232,18
W00005618,CF6,"CF6 8PS, CF6 8PT, CF6 8QE, CF6 8QF, CF6 8QL, CF6 8RU, CF6 8RW, CF62 6PS, CF62 6PT, CF62 6QE, CF62 6QF, CF62 6QL, CF62 6RU, CF62 6RW",303,259,44
W00005609,CF6,"CF6 8QX, CF6 8QY, CF6 8QZ, CF6 8RD, CF6 8RE, CF6 8RS, CF6 8RT, CF62 6QX, CF62 6QY, CF62 6QZ, CF62 6RD, CF62 6RE, CF62 6RS, CF62 6RT",222,186,36
W00005944,CF6,"CF6 1JH, CF6 1LB, CF6 1TT, CF6 1TU, CF6 1XG, CF6 1YD, CF6 1YE, CF6 1YF, CF6 1YG, CF6 1YJ, CF6 1YL, CF6 1YT, CF6 2AB, CF6 2AG, CF6 2AL, CF6 2EX, CF6 2LF, CF64 1JH, CF64 1TU, CF64 1XG, CF64 1XH, CF64 1XQ, CF64 1YA, CF64 1YD, CF64 1YE, CF64 1YF, CF64 1YG, CF64 1YJ, CF64 1YL, CF64 1YT, CF64 1YW, CF64 2AB, CF64 2AG, CF64 2AL, CF64 2AN, CF64 2EA, CF64 2EX, CF64 2JA, CF64 2LB, CF64 2NL, CF64 2TT, CF64 2YQ",226,188,38
W00005945,CF6,"CF6 1NR, CF6 1WW, CF6 1XD, CF6 1XJ, CF6 2AQ, CF6 2AR, CF6 2LA, CF64 1FN, CF64 1JX, CF64 1NR, CF64 1UA, CF64 1XJ, CF64 3AR, CF64 3AY, CF64 3LA, CF64 3NS",232,200,32
W00005946,CF6,"CF6 1AB, CF6 2AA, CF6 2AD, CF6 2AE, CF6 2AF, CF6 2AH, CF6 2AJ, CF6 2AN, CF6 2AX, CF6 2EA, CF6 2EZ, CF6 2XH, CF6 2XZ, CF6 2YG, CF6 2YH, CF6 2YJ, CF6 2YN, CF6 2YT, CF6 2YW, CF6 2YX, CF64 1AB, CF64 2AA, CF64 2AD, CF64 2AE, CF64 2AF, CF64 2AH, CF64 2AJ, CF64 2AP, CF64 2EW, CF64 2EZ, CF64 2XZ, CF64 2YG, CF64 2YT, CF64 2YX, CF64 2ZA, CF64 3AN, CF64 3AX, CF64 3EA, CF64 3YN, CF64 3YP",319,281,38
W00005947,CF6,"CF6 1BW, CF6 1LR, CF6 1TN, CF64 1BW, CF64 1LR, CF64 1SD, CF64 1SU, CF64 1TN",307,271,36
W00005948,CF6,"CF6 1BT, CF6 1DR, CF6 1DW, CF6 1TP, CF6 1TQ, CF6 1TR, CF64 1BT, CF64 1DR, CF64 1DW, CF64 1TP, CF64 1TQ, CF64 1TR, CF64 1TT",225,196,29
W00005949,CF6,"CF6 1DS, CF6 1DU, CF6 1YA, CF6 1YH, CF64 1DS, CF64 1DU, CF64 1SE, CF64 1SQ, CF64 1TS, CF64 1YH",235,196,39
W00005950,CF6,"CF6 1DQ, CF6 1DX, CF6 1DY, CF6 1DZ, CF6 1LQ, CF6 1YY, CF64 1DQ, CF64 1DX, CF64 1DY, CF64 1DZ, CF64 1FP, CF64 1LQ, CF64 1QJ, CF64 1YY, CF64 2LQ",223,195,28
W00005608,CF6,"CF6 8NS, CF6 8NW, CF6 8RN, CF6 8RP, CF6 8RQ, CF6 8RR, CF62 6NS, CF62 6NW, CF62 6RN, CF62 6RP, CF62 6RQ, CF62 6RR",361,314,47
W00005959,CF6,"CF6 1YU, CF6 2ED, CF6 2EG, CF6 2EH, CF6 2EJ, CF6 2EN, CF6 2EY, CF6 2LQ, CF6 2XJ, CF6 2XY, CF64 2EY, CF64 2XY, CF64 2YJ, CF64 3ED, CF64 3EG, CF64 3EH, CF64 3EJ, CF64 3EN, CF64 3EU, CF64 3LQ, CF64 3YU, CF64 3ZU",302,273,29
W00005619,CF6,"CF6 8NY, CF6 8PL, CF6 8PN, CF6 8PP, CF6 8PQ, CF62 6NY, CF62 6PL, CF62 6PN, CF62 6PP, CF62 6PQ",272,223,49
W00005621,CF6,"CF6 8PR, CF6 8QA, CF6 8QB, CF6 8QD, CF6 8QQ, CF6 8QR, CF6 8YW, CF62 6PR, CF62 6QA, CF62 6QB, CF62 6QD, CF62 6QQ, CF62 6QR, CF62 6YW",293,244,49
W00005927,CF6,"CF6 9LD, CF6 9LG, CF6 9LY, CF6 9NY, CF6 9PD, CF6 9PG, CF6 9PH, CF6 9PJ, CF6 9PL, CF6 9QQ, CF62 4LD, CF62 4LG, CF62 4LU, CF62 4LY, CF62 4NY, CF62 4PD, CF62 4PG, CF62 4PH, CF62 4PJ, CF62 4PL, CF62 4QD, CF62 4QQ, CF62 4YA, CF62 4YL, CF62 4ZY",273,247,26
W00005928,CF6,"CF6 9HN, CF6 9HU, CF6 9HW, CF6 9HX, CF6 9HY, CF6 9HZ, CF6 9JA, CF6 9PS, CF6 9PU, CF6 9PX, CF6 9ZU, CF6 9ZW, CF62 3ZW, CF62 4AA, CF62 4AE, CF62 4HU, CF62 4HW, CF62 4HX, CF62 4HY, CF62 4HZ, CF62 4JA, CF62 4NS, CF62 4PS, CF62 4PU, CF62 4PX, CF62 4QT, CF62 4ZW",437,404,33
W00005929,CF6,"CF6 1AW, CF6 1AX, CF6 1AZ, CF6 1BA, CF6 1BG, CF6 1BH, CF6 1BL, CF6 1BQ, CF6 1YZ, CF64 1AW, CF64 1AX, CF64 1AZ, CF64 1BA, CF64 1BG, CF64 1BH, CF64 1BL, CF64 1BU",267,230,37
W00005930,CF6,"CF6 1TX, CF6 2LD, CF6 2LE, CF6 2LG, CF6 2LT, CF6 2LU, CF64 2ET, CF64 2EU, CF64 2ND, CF64 2NG, CF64 2NJ, CF64 2TN, CF64 2TS, CF64 2TW, CF64 2TX",208,198,10
W00005931,CF6,"CF6 1AF, CF6 1AH, CF6 1AJ, CF6 1AL, CF6 1AT, CF6 1BB, CF6 1BD, CF6 1BE, CF6 1BP, CF6 1BR, CF64 1AF, CF64 1AH, CF64 1AJ, CF64 1AL, CF64 1AT, CF64 1BB, CF64 1BD, CF64 1BE, CF64 1BP, CF64 1BR",243,208,35
W00005933,CF6,"CF6 1EH, CF6 1EJ, CF6 1EQ, CF6 1HA, CF6 1HB, CF6 1HD, CF6 1HE, CF6 1JQ, CF64 1EH, CF64 1EJ, CF64 1EQ, CF64 1HA, CF64 1HB, CF64 1HD, CF64 1HE, CF64 1JQ, CF64 1JR",317,282,35
W00005934,CF6,"CF6 1BN, CF6 1DL, CF6 1DN, CF6 1DP, CF6 1DT, CF64 1BN, CF64 1DL, CF64 1DN, CF64 1DP, CF64 1DT",243,217,26
W00005620,CF6,"CF6 8NT, CF6 8NU, CF6 8RA, CF6 8RB, CF6 8YD, CF6 8YX, CF62 6NP, CF62 6NT, CF62 6NU, CF62 6PW, CF62 6RA, CF62 6RB, CF62 6UA",268,220,48
W00005935,CF6,"CF6 1EL, CF6 1EW, CF6 1EY, CF6 1JF, CF6 1JL, CF64 1EL, CF64 1EW, CF64 1EY, CF64 1JF, CF64 1JL",315,271,44
W00005938,CF6,"CF6 1DD, CF6 1DG, CF6 1HN, CF6 1HP, CF6 1HS, CF6 1XF, CF6 1XN, CF6 1YS, CF64 1DD, CF64 1DG, CF64 1HN, CF64 1HP, CF64 1XY, CF64 1YB, CF64 1YS, CF64 1YU",242,219,23
W00005939,CF6,"CF6 1BJ, CF6 1BU, CF6 1BX, CF6 1DA, CF6 1DB, CF6 1DE, CF6 1DF, CF6 1HR, CF6 1XU, CF64 1BJ, CF64 1BX, CF64 1DA, CF64 1DB, CF64 1DE, CF64 1DF, CF64 1FB, CF64 1GW, CF64 1HR, CF64 2BU",286,227,59
W00005651,CF6,"CF6 3AB, CF6 3AD, CF6 3ER, CF6 3ES, CF62 9ER, CF63 1DS, CF63 1DW, CF63 1DX, CF63 1DY, CF63 1ER, CF63 1FG, CF63 1NN, CF63 2AB, CF63 2AD",406,362,44
W00005941,CF6,"CF6 1EA, CF6 1EB, CF6 1ED, CF6 1EN, CF6 1ES, CF6 1ET, CF6 1EX, CF6 1JA, CF6 1JB, CF6 1JD, CF6 1JE, CF6 1JJ, CF6 1JP, CF6 1XB, CF6 1XR, CF6 1YN, CF6 1YP, CF6 1YR, CF64 1EA, CF64 1EB, CF64 1ED, CF64 1EN, CF64 1ES, CF64 1ET, CF64 1EX, CF64 1JA, CF64 1JB, CF64 1JD, CF64 1JE, CF64 1JJ, CF64 1JP, CF64 1JW, CF64 1XB, CF64 1XD, CF64 1XE, CF64 1XR, CF64 1YN, CF64 1YR",370,332,38
W00005942,CF6,"CF6 1AE, CF6 1AG, CF6 1AN, CF6 1AP, CF6 1AQ, CF6 1AR, CF6 1AS, CF6 1AU, CF6 1AY, CF6 1YX, CF6 2AP, CF64 1AE, CF64 1AG, CF64 1AN, CF64 1AP, CF64 1AQ, CF64 1AR, CF64 1AS, CF64 1AU, CF64 1AY, CF64 1JU, CF64 1LA, CF64 1WJ, CF64 1WW",240,205,35
W00005943,CF6,"CF6 1AA, CF6 1AD, CF6 1BY, CF6 1BZ, CF6 1EP, CF6 1HH, CF6 1XL, CF6 1YQ, CF64 1AA, CF64 1AD, CF64 1BY, CF64 1BZ, CF64 1EP, CF64 1HH, CF64 1WA, CF64 1WB, CF64 1WE, CF64 1WF, CF64 1WG, CF64 1WH, CF64 1WL, CF64 1WN, CF64 1WP, CF64 1WQ, CF64 1WR, CF64 1WS, CF64 1WU, CF64 1WY, CF64 1WZ, CF64 1XF, CF64 1XL, CF64 1XS, CF64 1XT, CF64 1XU, CF64 1XW, CF64 1XX, CF64 1XZ, CF64 1YP, CF64 1YQ, CF64 1YX, CF64 1ZF, CF64 1ZH, CF64 1ZS, CF64 2WY, CF64 2WZ, CF64 2XB, CF64 2XD, CF64 2XE, CF64 2XH, CF64 2XJ, CF64 2XU, CF64 2YA, CF64 2YB, CF64 2YE, CF64 2YH, CF64 2YN, CF64 2YR, CF64 2YS, CF64 2YU, CF64 2YY, CF64 2ZD, CF64 3WG, CF64 3WY, CF64 3WZ, CF64 3XA, CF64 3XB, CF64 3XF, CF64 3XG, CF64 3XH, CF64 3XN, CF64 3XP, CF64 3XQ, CF64 3XR, CF64 3XS, CF64 3XU, CF64 3YA, CF64 3YE, CF64 3YG, CF64 3YH, CF64 3YJ, CF64 3YQ, CF64 3YS, CF64 3YT, CF64 3YX, CF64 3ZA, CF64 3ZB, CF64 3ZD, CF64 4WW, CF64 4WX, CF64 4WY, CF64 4WZ, CF64 4XA, CF64 4XB, CF64 4XF, CF64 4XG, CF64 4XJ, CF64 4XN, CF64 4XP, CF64 4XQ, CF64 4YA, CF64 4YF, CF64 4YG, CF64 4YH, CF64 4YJ, CF64 4YL, CF64 4YN, CF64 4YP, CF64 4YQ, CF64 4YR, CF64 4YS, CF64 4YT, CF64 4YU, CF64 4YW, CF64 4YY, CF64 4YZ, CF64 4ZB, CF64 4ZG, CF64 4ZH, CF64 4ZQ, CF64 4ZR, CF64 4ZX, CF64 5WG, CF64 5WU, CF64 5XB, CF64 5XD, CF64 5XE, CF64 5XF, CF64 5XH, CF64 5XN, CF64 5XP, CF64 5XW, CF64 5XY, CF64 5XZ, CF64 5YD, CF64 5YG, CF64 5YH, CF64 5YL, CF64 5YN, CF64 5YQ, CF64 5YR, CF64 5YS, CF64 5YZ, CF64 5ZB, CF64 5ZD, CF64 5ZG, CF64 5ZQ, CF64 5ZR, CF64 5ZU, CF64 9AA, CF64 9AB, CF64 9AD, CF64 9AE, CF64 9AF, CF64 9AG, CF64 9AH, CF64 9AJ, CF64 9AL, CF64 9AN, CF64 9AP, CF64 9AQ, CF64 9AR, CF64 9AS, CF64 9AT, CF64 9AU, CF64 9AW, CF64 9AX, CF64 9AY, CF64 9AZ, CF64 9BA, CF64 9BB, CF64 9BD, CF64 9BE, CF64 9BF, CF64 9BG, CF64 9BH, CF64 9BJ, CF64 9BL, CF64 9BN, CF64 9BP, CF64 9BQ, CF64 9BR, CF64 9BS, CF64 9BT, CF64 9BU, CF64 9BW, CF64 9BX, CF64 9BY, CF64 9BZ, CF64 9DA, CF64 9DB, CF64 9DD, CF64 9DE, CF64 9DF, CF64 9DG, CF64 9DH, CF64 9DJ, CF64 9DL, CF64 9DN, CF64 9DP, CF64 9DQ, CF64 9DR, CF64 9DS, CF64 9DT, CF64 9DU, CF64 9DW, CF64 9DX, CF64 9DY, CF64 9DZ, CF64 9EA, CF64 9EB, CF64 9ED, CF64 9EE, CF64 9EF, CF64 9EG, CF64 9EH, CF64 9EJ, CF64 9EL, CF64 9EN, CF64 9EP, CF64 9EQ, CF64 9ER, CF64 9ES, CF64 9ET, CF64 9EU, CF64 9EW, CF64 9EX, CF64 9EZ, CF64 9FA, CF64 9FB, CF64 9FD, CF64 9FE, CF64 9FF, CF64 9FG, CF64 9FH, CF64 9FJ, CF64 9FL, CF64 9FN, CF64 9FP, CF64 9FQ, CF64 9FR, CF64 9FS, CF64 9FT, CF64 9FU, CF64 9FW, CF64 9FX, CF64 9FY, CF64 9FZ, CF64 9GA, CF64 9GB, CF64 9GD, CF64 9GE, CF64 9GF, CF64 9GG, CF64 9GH, CF64 9GJ, CF64 9GL, CF64 9GN, CF64 9GP, CF64 9GQ, CF64 9GR, CF64 9GS, CF64 9GT, CF64 9GU",254,233,21
W00005622,CF6,"CF6 8FF, CF6 8QG, CF6 8QH, CF6 8QN, CF6 8SY, CF6 8SZ, CF6 8TA, CF6 8UH, CF6 8YY, CF62 6FF, CF62 6QG, CF62 6QH, CF62 6QN, CF62 6SY, CF62 6SZ, CF62 6TA, CF62 6UD, CF62 6UH, CF62 6WA, CF62 6YU, CF62 6YY, CF62 6YZ, CF62 8FF",259,242,17
W00005936,CF6,"CF6 1DH, CF6 1DJ, CF6 1EG, CF6 1HL, CF6 1HQ, CF64 1BQ, CF64 1DH, CF64 1DJ, CF64 1EG, CF64 1HL, CF64 1HQ, CF64 1WD, CF64 1XN, CF64 1YZ",275,234,41
W00005926,CF6,"CF6 9PF, CF6 9PP, CF6 9PQ, CF6 9PZ, CF62 4FZ, CF62 4LT, CF62 4PF, CF62 4PP, CF62 4PQ, CF62 4PZ",244,215,29
W00005960,CF6,"CF6 1UN, CF6 1UR, CF6 1WD, CF6 1WH, CF6 1XT, CF6 2LN, CF6 2NW, CF6 2PB, CF6 2PY, CF64 2WD, CF64 2WH, CF64 3LN, CF64 3NW, CF64 3NX, CF64 3PB, CF64 3PY, CF64 3UN, CF64 3UR, CF64 3UT, CF64 3XT",290,258,32
W00005962,CF6,"CF6 2NH, CF6 2NN, CF6 2NQ, CF6 2NT, CF64 2XR, CF64 3HR, CF64 3HS, CF64 3HT, CF64 3JW, CF64 3JY, CF64 3NH, CF64 3NN, CF64 3NQ, CF64 3NT, CF64 3PZ, CF64 5XR",597,524,73
W00005984,CF6,"CF6 2HS, CF6 2JW, CF6 2JX, CF6 2PZ, CF6 2RE, CF6 2UZ, CF6 2XA, CF64 5HS, CF64 5JW, CF64 5JX, CF64 5PZ, CF64 5RE, CF64 5TU, CF64 5UZ, CF64 5XA",264,243,21
W00005985,CF6,"CF6 2ET, CF6 2EU, CF6 2EW, CF6 2TT, CF6 2US, CF6 2UX, CF6 2WA, CF6 2WB, CF6 2WF, CF64 5ET, CF64 5EU, CF64 5EW, CF64 5TT, CF64 5US, CF64 5UX",299,267,32
W00005986,CF6,"CF6 2HT, CF6 2HU, CF6 2QA, CF6 2QB, CF64 5HT, CF64 5HU, CF64 5QA, CF64 5QB",239,216,23
W00010513,CF6,"CF6 8TH, CF6 8TJ, CF6 8UZ, CF62 5BH, CF62 5BJ, CF62 5BW, CF62 5TH, CF62 5TJ, CF62 5UA, CF62 5UZ, CF62 5WA",235,212,23
W00010505,CF6,"CF6 9ES, CF6 9ET, CF6 9EU, CF6 9EW, CF6 9HA, CF6 9HB, CF62 3AU, CF62 3ES, CF62 3ET, CF62 3EU, CF62 3EW, CF62 3HA, CF62 3HB",232,208,24
W00010503,CF6,"CF6 1ER, CF6 1EZ, CF6 1HF, CF6 1HJ, CF6 1HT, CF6 1NN, CF6 1NP, CF6 1NQ, CF64 1ER, CF64 1EZ, CF64 1FA, CF64 1HF, CF64 1HJ, CF64 1HS, CF64 1HT, CF64 1JY, CF64 1NN, CF64 1NP",299,267,32
W00010501,CF6,"CF6 8BE, CF62 5AN, CF62 5AP, CF62 5AQ, CF62 5AR, CF62 5AS, CF62 5BE, CF62 5QN",253,210,43
W00005983,CF6,"CF6 2AY, CF6 2GB, CF6 2SH, CF6 2SY, CF6 2TD, CF6 2TE, CF6 2TF, CF6 2XB, CF6 2YB, CF6 2YU, CF6 2YY, CF64 5AX, CF64 5AY, CF64 5SG, CF64 5SH, CF64 5SY, CF64 5TD, CF64 5TE, CF64 5TF, CF64 5TW, CF64 5TX, CF64 5TY, CF64 5WA, CF64 5YB, CF64 5YJ, CF64 5YU, CF64 5ZE",373,322,51
W00010495,CF6,"CF6 9JL, CF6 9LA, CF6 9LB, CF6 9WA, CF6 9WB, CF62 3JL, CF62 4AD, CF62 4AH, CF62 4HA, CF62 4HB, CF62 4HE, CF62 4HG, CF62 4HJ, CF62 4JL, CF62 4LA, CF62 4LB, CF62 4WA",747,695,52
W00010543,CF6,"CF6 8TN, CF6 8TZ, CF6 8UJ, CF62 5AF, CF62 5AG, CF62 5AH, CF62 5AJ, CF62 5TN, CF62 5TR, CF62 5TZ, CF62 5UD, CF62 5UJ, CF62 5XS",266,240,26
W00010554,CF6,"CF6 7EH, CF6 7TW, CF6 7UG, CF62 9ET, CF62 9TW, CF62 9UG",197,180,17
W00010564,CF6,"CF6 9HD, CF6 9HL, CF62 3FD, CF62 3HD, CF62 3HL",317,282,35
W00010570,CF6,"CF6 1HW, CF6 1HX, CF6 1HZ, CF6 1XA, CF64 1HW, CF64 1HX, CF64 1SA, CF64 1TB, CF64 1TD, CF64 1TE, CF64 1TF, CF64 1XA, CF64 1XP",224,203,21
W00010576,CF6,"CF6 6XA, CF6 6XE, CF6 6XY, CF6 8XA, CF62 5BN, CF62 5DT, CF62 5DX, CF62 5XA",242,208,34
W00010577,CF6,"CF6 9SR, CF6 9YR, CF6 9YS, CF6 9YT, CF6 9YU, CF6 9YW, CF6 9YX, CF61 1AP, CF61 1SR, CF61 1UN, CF61 1YS, CF61 1YT, CF61 1YU, CF61 1YW, CF61 1YX, CF61 2UA, CF61 2UB, CF61 2UD, CF61 2UF, CF61 2YR, CF61 2YS, CF61 2YT, CF61 2YW",494,435,59
W00005830,CF6,"CF6 1LS, CF6 1PF, CF6 1PG, CF6 1PH, CF6 1QA, CF64 2LS, CF64 2PF, CF64 2PG, CF64 2PH, CF64 2QA",254,226,28
W00010530,CF6,"CF6 8AN, CF62 5AW, CF62 5AY, CF62 5BD, CF62 5QR, CF62 7AE",292,247,45
W00005961,CF6,"CF6 1WJ, CF6 1WL, CF6 1WS, CF6 2NE, CF6 2NF, CF6 2NL, CF6 2NP, CF64 2WJ, CF64 2WL, CF64 3NE, CF64 3NF, CF64 3NL, CF64 3NP, CF64 3WD, CF64 3WS",327,288,39
W00005982,CF6,"CF6 2FB, CF6 2FD, CF6 2FE, CF6 2FG, CF6 2FH, CF6 2FX, CF6 2UP, CF6 2UQ, CF6 2UY, CF64 5FB, CF64 5FD, CF64 5FE, CF64 5FG, CF64 5FH, CF64 5FX, CF64 5UB, CF64 5UP, CF64 5UQ, CF64 5UY",230,212,18
W00005980,CF6,"CF6 2FF, CF6 2FJ, CF6 2FN, CF6 2FW, CF6 2GA, CF64 5FF, CF64 5FJ, CF64 5FN, CF64 5FW, CF64 5GA",264,235,29
W00005963,CF6,"CF6 2NG, CF6 2NJ, CF6 2NU, CF6 2NX, CF6 2PW, CF6 2PX, CF64 3NG, CF64 3NJ, CF64 3NU, CF64 3PW, CF64 3PX",300,270,30
W00005964,CF6,"CF6 2GD, CF6 2HY, CF6 2JA, CF6 2JN, CF6 2JP, CF6 2JQ, CF6 2JR, CF6 2JS, CF6 2JT, CF6 2JZ, CF64 3GD, CF64 3HY, CF64 3JA, CF64 3JN, CF64 3JP, CF64 3JQ, CF64 3JR, CF64 3JS, CF64 3JT, CF64 3JZ, CF64 3XD, CF64 3XJ, CF64 3XY, CF64 3YB, CF64 3YL, CF64 3YW, CF64 3YY",216,192,24
W00005965,CF6,"CF6 2PH, CF6 2PJ, CF6 2PP, CF6 2PQ, CF6 2PR, CF6 2PU, CF64 3PH, CF64 3PJ, CF64 3PP, CF64 3PQ, CF64 3PR, CF64 3PU",291,261,30
W00005966,CF6,"CF6 2FY, CF6 2FZ, CF6 2PS, CF6 2PT, CF64 3FY, CF64 3FZ, CF64 3PS, CF64 3PT",256,238,18
W00005967,CF6,"CF6 1WN, CF6 1WQ, CF6 2LX, CF6 2LY, CF6 2ND, CF64 2WN, CF64 2WQ, CF64 2WW, CF64 3LB, CF64 3LU, CF64 3LX, CF64 3LY, CF64 3ND",381,331,50
W00005968,CF6,"CF6 1UE, CF6 1UF, CF6 1UG, CF6 1UH, CF6 1US, CF6 1UT, CF6 1UZ, CF6 1WA, CF6 1XQ, CF6 1XS, CF64 2UQ, CF64 2UZ, CF64 2WA, CF64 2XQ, CF64 2XS, CF64 2XT, CF64 3UA, CF64 3UE, CF64 3UF, CF64 3UG, CF64 3UH, CF64 3UQ, CF64 3US",305,250,55
W00005969,CF6,"CF6 2LZ, CF6 2NA, CF6 2NB, CF64 1JT, CF64 2UD, CF64 2UF, CF64 3JX, CF64 3LZ, CF64 3NA, CF64 3NB",590,532,58
W00005981,CF6,"CF6 2FA, CF6 2FS, CF6 2FT, CF6 2FU, CF64 5FA, CF64 5FS, CF64 5FT, CF64 5FU, CF64 5RY",368,324,44
W00005970,CF6,"CF6 1UP, CF6 2EL, CF6 2ER, CF6 2HW, CF6 2LJ, CF6 2LL, CF6 2LP, CF6 2LR, CF6 2LS, CF6 2XL, CF6 2YQ, CF64 2UP, CF64 2XL, CF64 3EL, CF64 3HW, CF64 3LJ, CF64 3LL, CF64 3LP, CF64 3LR, CF64 3LS, CF64 3UP, CF64 3XE",311,284,27
W00005972,CF6,"CF6 2SA, CF6 2SB, CF6 2SD, CF6 2SP, CF6 2SX, CF6 2SZ, CF6 2TA, CF6 2TB, CF64 5SA, CF64 5SB, CF64 5SD, CF64 5SP, CF64 5SX, CF64 5SZ, CF64 5TA, CF64 5TB",287,254,33
W00005973,CF6,"CF6 2TZ, CF6 2UT, CF6 2UU, CF6 2UW, CF64 5TZ, CF64 5UT, CF64 5UU, CF64 5UW",240,215,25
W00005975,CF6,"CF6 2SL, CF6 2SS, CF6 2SU, CF6 2TH, CF6 2TL, CF6 2TN, CF64 5AJ, CF64 5SJ, CF64 5SU, CF64 5TH, CF64 5TL, CF64 5TN",245,220,25
W00005976,CF6,"CF6 2LW, CF6 2SN, CF6 2SR, CF6 2ST, CF6 2SW, CF64 3LW, CF64 5LW, CF64 5SL, CF64 5SN, CF64 5SS, CF64 5ST, CF64 5SW",357,320,37
W00005977,CF6,"CF6 2TQ, CF6 2TS, CF6 2UD, CF6 2UE, CF6 2UF, CF6 2XF, CF64 3WB, CF64 5TQ, CF64 5TS, CF64 5UD, CF64 5UE, CF64 5UF, CF64 5WB, CF64 5WD, CF64 5WE, CF64 5WH, CF64 5WJ, CF64 5WL, CF64 5WN, CF64 5WP, CF64 5XJ, CF64 5XL, CF64 5XT, CF64 5YE, CF64 5YF, CF64 5YP, CF64 5YT, CF64 5YW, CF64 5ZA, CF64 5ZY",271,241,30
W00005978,CF6,"CF6 2SQ, CF6 2TR, CF64 5RA, CF64 5RB, CF64 5SQ, CF64 5SR, CF64 5TR",257,235,22
W00005979,CF6,"CF6 2UG, CF6 2UH, CF6 2UJ, CF6 2UL, CF6 2UN, CF6 2UR, CF6 2XP, CF6 2XQ, CF6 2XR, CF6 2XS, CF64 5UG, CF64 5UH, CF64 5UJ, CF64 5UL, CF64 5UN, CF64 5UR, CF64 5XG, CF64 5XQ, CF64 5XS",222,199,23
W00005971,CF6,"CF6 1UD, CF6 1UJ, CF6 1UL, CF6 1UQ, CF6 1WB, CF6 1WE, CF6 1WX, CF6 2XE, CF64 2WB, CF64 2WE, CF64 3UD, CF64 3UJ, CF64 3UL, CF64 3UW, CF64 3WX",324,270,54
W00005925,CF6,"CF6 9LE, CF6 9LF, CF6 9NZ, CF6 9PA, CF6 9PB, CF6 9PE, CF6 9QA, CF6 9QB, CF62 4LE, CF62 4LF, CF62 4LH, CF62 4LQ, CF62 4NT, CF62 4NZ, CF62 4PA, CF62 4PB, CF62 4PE, CF62 4QA, CF62 4QB",401,370,31
W00005940,CF6,"CF6 1EE, CF6 1EF, CF6 1EU, CF6 1HG, CF64 1BF, CF64 1EE, CF64 1EF, CF64 1EU, CF64 1HG",271,235,36
W00005867,CF6,"CF6 9LJ, CF6 9LR, CF6 9XB, CF61 2LJ, CF61 2LR, CF61 2XB",278,244,34
W00005627,CF6,"CF6 6BA, CF6 6BE, CF6 6BH, CF6 6BJ, CF6 6NF, CF62 8BA, CF63 1BE, CF63 1BH, CF63 1BJ, CF63 1NJ",308,256,52
W00005625,CF6,"CF6 8DB, CF6 8DD, CF6 8EH, CF6 8EU, CF6 8EW, CF62 7DB, CF62 7EH, CF62 7EU, CF62 7EW, CF62 8HT",259,232,27
W00005624,CF6,"CF6 8UP, CF6 8UT, CF6 8UX, CF6 8UY, CF62 5UH, CF62 5UP, CF62 5UT, CF62 5UX, CF62 5UY, CF62 5YD, CF62 5YF",325,299,26
W00005623,CF6,"CF6 8NQ, CF6 8NR, CF6 8QJ, CF6 8QP, CF6 8UB, CF62 3BY, CF62 6NQ, CF62 6NR, CF62 6QJ, CF62 6QP, CF62 6RX, CF62 6UB",260,223,37
W00005860,CF6,"CF6 9XS, CF61 2SD, CF61 2SE, CF61 2SG, CF61 2XA, CF61 2XS",254,224,30
W00005863,CF6,"CF6 9SU, CF6 9XD, CF6 9XE, CF6 9XF, CF6 9XW, CF61 2SU, CF61 2XD, CF61 2XE, CF61 2XF, CF61 2XW, CF61 2YA, CF61 2YE, CF61 2YF, CF61 2YG, CF61 2YH, CF61 2YJ, CF61 2YL",227,216,11
W00005864,CF6,"CF6 9ND, CF6 9NE, CF6 9NF, CF6 9NG, CF6 9NH, CF6 9YL, CF62 4AF, CF62 4AL, CF62 4AN, CF62 4ND, CF62 4NE, CF62 4NF, CF62 4NG, CF62 4NH, CF62 4NX, CF62 4YR",273,240,33
W00005865,CF6,"CF6 9GA, CF6 9GD, CF6 9XN, CF6 9XP, CF6 9XU, CF6 9XX, CF61 2GA, CF61 2GD, CF61 2XN, CF61 2XP, CF61 2XU, CF61 2XX",282,257,25
W00005866,CF6,"CF6 9GF, CF6 9GG, CF6 9GH, CF6 9GJ, CF6 9GL, CF6 9GU, CF61 2GF, CF61 2GG, CF61 2GH, CF61 2GJ, CF61 2GL, CF61 2GU, CF61 2UZ",296,255,41
W00005922,CF6,"CF6 9DN, CF6 9JN, CF6 9JQ, CF6 9JR, CF62 3JJ, CF62 3JN, CF62 3JQ, CF62 3JR, CF62 4DN, CF62 4JN, CF62 4JQ, CF62 4JR, CF62 4JZ",260,234,26
W00005868,CF6,"CF6 9FA, CF6 9RA, CF6 9SS, CF6 9SW, CF6 9SX, CF61 1AA, CF61 1FA, CF61 1RA, CF61 1SS, CF61 1SU, CF61 1SX, CF61 1UP, CF61 1WD, CF61 1XJ, CF61 2SH, CF61 2SW, CF61 2YN, CF61 2YP, CF61 2YQ, CF61 2YU",252,228,24
W00005869,CF6,"CF6 9GP, CF6 9GQ, CF6 9GR, CF6 9GS, CF61 2GP, CF61 2GQ, CF61 2GR, CF61 2GS",252,223,29
W00005870,CF6,"CF6 9LL, CF6 9LP, CF6 9LQ, CF6 9LS, CF6 9UR, CF6 9US, CF61 2LL, CF61 2LP, CF61 2LQ, CF61 2LS, CF61 2UR, CF61 2US",297,273,24
W00005871,CF6,"CF6 9DL, CF6 9RB, CF6 9ST, CF6 9TD, CF6 9TH, CF6 9WG, CF6 9XL, CF6 9XZ, CF61 1AD, CF61 1DL, CF61 1PP, CF61 1RB, CF61 1ST, CF61 1TD, CF61 1TH, CF61 1WG, CF61 1XX, CF61 1XZ, CF61 1YP, CF61 2XL",268,242,26
W00005872,CF6,"CF6 9UN, CF6 9UP, CF6 9UQ, CF6 9YD, CF61 1YD, CF61 2UN, CF61 2UP, CF61 2UQ",223,208,15
W00005873,CF6,"CF6 9HR, CF6 9HS, CF6 9LZ, CF6 9NA, CF6 9NB, CF6 9NJ, CF6 9NL, CF6 9NN, CF6 9NP, CF6 9NQ, CF6 9NW, CF61 2NW, CF62 4AG, CF62 4HR, CF62 4HS, CF62 4LZ, CF62 4NA, CF62 4NB, CF62 4NJ, CF62 4NL, CF62 4NN, CF62 4NP, CF62 4NQ",333,301,32
W00005874,CF6,"CF6 9FB, CF6 9RZ, CF6 9SA, CF6 9SB, CF6 9SD, CF6 9SE, CF6 9SG, CF6 9SJ, CF6 9SL, CF6 9SN, CF6 9SP, CF6 9SQ, CF6 9SY, CF6 9YP, CF61 1AE, CF61 1RZ, CF61 1SA, CF61 1SB, CF61 1SD, CF61 1SE, CF61 1SG, CF61 1SJ, CF61 1SL, CF61 1SN, CF61 1SP, CF61 1SQ, CF61 1SW, CF61 1SY",236,202,34
W00005628,CF6,"CF6 6AG, CF6 6AH, CF6 6AL, CF6 6AN, CF6 6AQ, CF6 6BN, CF62 8BN, CF62 8EL, CF62 8EN, CF62 8EQ, CF62 8ER, CF62 8ET",266,235,31
W00005875,CF6,"CF6 9TX, CF6 9TY, CF6 9UJ, CF6 9WX, CF6 9WY, CF6 9YG, CF6 9YH, CF61 1TX, CF61 1TY, CF61 1UJ, CF61 1WT, CF61 1WX, CF61 1WY, CF61 1YG, CF61 1YH",271,244,27
W00005629,CF6,"CF6 6EF, CF6 6PF, CF6 7EQ, CF6 7ES, CF6 7YA, CF63 4EF, CF63 4EU, CF63 4EW, CF63 4EX, CF63 4PF, CF63 4YB, CF63 4YD, CF63 4YE",371,333,38
W00005631,CF6,"CF6 6EG, CF6 6EH, CF6 6EJ, CF6 6NH, CF6 6SH, CF63 1NH, CF63 4EG, CF63 4EH, CF63 4EJ, CF63 4YF",344,296,48
W00005648,CF6,"CF6 7EN, CF6 7HU, CF6 7HY, CF6 7HZ, CF6 7JA, CF6 7JH, CF6 7YF, CF63 2HU, CF63 2HY, CF63 2HZ, CF63 2JA, CF63 2JH, CF63 2JR, CF63 2JY, CF63 2YF",228,201,27
W00005647,CF6,"CF6 7BA, CF6 7HB, CF6 7HH, CF6 7HJ, CF6 7HL, CF63 1BA, CF63 2HB, CF63 2HH, CF63 2HJ, CF63 2HL",389,344,45
W00005646,CF6,"CF6 6UW, CF6 7JQ, CF6 7JS, CF6 7JT, CF6 7JU, CF6 7LP, CF6 7LQ, CF6 7LR, CF63 2JQ, CF63 2JS, CF63 2JT, CF63 2JU, CF63 2LP, CF63 2LQ, CF63 2LR",252,227,25
W00005645,CF6,"CF6 3AA, CF6 3AF, CF6 3AH, CF6 3AN, CF6 3AU, CF63 2AA, CF63 2AF, CF63 2AH, CF63 2AN, CF63 2AU, CF63 2NQ",259,241,18
W00005644,CF6,"CF6 8AG, CF6 8AH, CF6 8AJ, CF6 8AQ, CF6 8XH, CF6 8XQ, CF6 8XX, CF62 5QL, CF62 7AG, CF62 7AH, CF62 7AJ, CF62 7AQ",175,139,36
W00005643,CF6,"CF6 8BY, CF6 8BZ, CF6 8EX, CF6 8HJ, CF6 8HP, CF6 8HX, CF6 8JA, CF62 7BY, CF62 7BZ, CF62 7EX, CF62 7HJ, CF62 7HP, CF62 7HX, CF62 7JA",284,256,28
W00005642,CF6,"CF6 6RS, CF6 8BT, CF6 8BU, CF6 8BX, CF6 8DA, CF6 8DF, CF6 8DG, CF6 8DH, CF62 7BX, CF62 7DA, CF62 7DH, CF62 8HQ, CF62 8HR, CF62 8HW, CF62 8HX, CF62 8JH, CF62 8RS",304,248,56
W00005641,CF6,"CF6 6AA, CF6 6DD, CF6 6DJ, CF6 6DL, CF6 6RN, CF6 6UE, CF6 6UG, CF6 6UH, CF6 6UQ, CF6 6XW, CF6 8AL, CF6 8AP, CF6 8DE, CF62 3WB, CF62 3WR, CF62 3WZ, CF62 3YA, CF62 3YB, CF62 3YD, CF62 3YE, CF62 3YG, CF62 3YH, CF62 3YL, CF62 3YN, CF62 3YP, CF62 3YQ, CF62 3YS, CF62 3YT, CF62 3YU, CF62 3ZA, CF62 3ZB, CF62 3ZH, CF62 3ZY, CF62 4WD, CF62 4WE, CF62 4YB, CF62 4YD, CF62 4YE, CF62 4YF, CF62 4YQ, CF62 4YU, CF62 4ZF, CF62 5WZ, CF62 5YA, CF62 5YB, CF62 5YG, CF62 5YL, CF62 5YN, CF62 5YR, CF62 6WE, CF62 6WW, CF62 6YA, CF62 6YE, CF62 6YG, CF62 6YL, CF62 6YQ, CF62 6YS, CF62 6YT, CF62 6ZD, CF62 6ZP, CF62 7AL, CF62 7AZ, CF62 7TZ, CF62 7WA, CF62 7XD, CF62 7YA, CF62 7YB, CF62 7YD, CF62 7YE, CF62 7YF, CF62 7YG, CF62 7YH, CF62 7YJ, CF62 7YT, CF62 8BE, CF62 8BF, CF62 8DD, CF62 8DJ, CF62 8DL, CF62 8FE, CF62 8HU, CF62 8NA, CF62 8UF, CF62 8UG, CF62 8WP, CF62 8WZ, CF62 8YA, CF62 8YB, CF62 8YD, CF62 8YL, CF62 8YN, CF62 8YR, CF62 8YS, CF62 8YT, CF62 8YW, CF62 8ZY, CF62 9YG, CF62 9YH, CF63 1WZ, CF63 1YA, CF63 1YB, CF63 1YD, CF63 1YG, CF63 1YP, CF63 1YQ, CF63 1YU, CF63 1YX, CF63 1YY, CF63 1ZB, CF63 2WZ, CF63 2XJ, CF63 2YG, CF63 2ZA, CF63 3YA, CF63 3YB, CF63 3YG, CF63 4AA, CF63 4AZ, CF63 4RN, CF63 4UE, CF63 4XJ, CF63 4XR, CF63 4XS, CF63 4XU, CF63 4YA, CF63 4YH, CF63 4YJ, CF63 4YL, CF63 4YN, CF63 4YP, CF63 4YQ, CF63 4YR, CF63 4YS, CF63 4YT, CF63 4ZR, CF63 4ZS, CF63 4ZW, CF63 4ZZ, CF63 9AA, CF63 9AB, CF63 9AD, CF63 9AE, CF63 9AF, CF63 9AH, CF63 9AJ, CF63 9AL, CF63 9AN, CF63 9AP, CF63 9AQ, CF63 9AR, CF63 9AS, CF63 9AT, CF63 9AU, CF63 9AW, CF63 9AX, CF63 9AY, CF63 9AZ, CF63 9BA, CF63 9BB, CF63 9BD, CF63 9BE, CF63 9BF, CF63 9BG, CF63 9BH, CF63 9BJ, CF63 9BL, CF63 9BN, CF63 9BP, CF63 9BQ, CF63 9BR, CF63 9BS, CF63 9BT, CF63 9BU, CF63 9BW, CF63 9BX, CF63 9BY, CF63 9BZ, CF63 9DA, CF63 9DB, CF63 9DD, CF63 9DE, CF63 9DF, CF63 9DG, CF63 9DH, CF63 9DJ, CF63 9DL, CF63 9DN, CF63 9DP, CF63 9DQ, CF63 9DR, CF63 9DS, CF63 9DT, CF63 9DU, CF63 9DW, CF63 9DX, CF63 9DY, CF63 9DZ, CF63 9EA, CF63 9EB, CF63 9ED, CF63 9EE, CF63 9EF, CF63 9EG, CF63 9EH, CF63 9EJ, CF63 9EL, CF63 9EN, CF63 9EP, CF63 9EQ, CF63 9ER, CF63 9ES, CF63 9ET, CF63 9EU, CF63 9EW, CF63 9EX, CF63 9EY, CF63 9EZ, CF63 9FA, CF63 9FB, CF63 9FD, CF63 9FE, CF63 9FF, CF63 9FG, CF63 9FH, CF63 9FJ, CF63 9FL, CF63 9FN, CF63 9FP, CF63 9FQ, CF63 9FR, CF63 9FS, CF63 9FT, CF63 9FU, CF63 9FW, CF63 9FX",318,295,23
W00005640,CF6,"CF6 6DS, CF6 6DT, CF6 6DU, CF6 6DW, CF6 6HA, CF6 6HB, CF6 6HF, CF6 6SN, CF6 6SP, CF6 6SR, CF6 6ST, CF6 6SU, CF6 6SY, CF62 8DS, CF62 8DT, CF62 8DU, CF62 8DW, CF63 4HA, CF63 4HB, CF63 4HF, CF63 4SN, CF63 4SR, CF63 4SU, CF63 4SY",292,269,23
W00005639,CF6,"CF6 6DH, CF6 6DN, CF6 6DP, CF6 6DQ, CF6 6DR, CF6 6ED, CF6 6NA, CF6 6SF, CF6 6SG, CF62 8DN, CF62 8DP, CF62 8DQ, CF62 8DR, CF62 8ED, CF62 8SF",263,243,20
W00005638,CF6,"CF6 8HG, CF6 8HH, CF6 8HT, CF6 8HU, CF6 8HW, CF6 8JB, CF6 8JD, CF6 8JE, CF62 7HG, CF62 7HH, CF62 7HT, CF62 7HU, CF62 7HW, CF62 7JB, CF62 7JD, CF62 7JE",292,263,29
W00005637,CF6,"CF6 6EP, CF6 6EQ, CF6 6HR, CF6 6PG, CF6 6PL, CF6 6PR, CF6 6TF, CF6 6UP, CF63 4AF, CF63 4EP, CF63 4EQ, CF63 4ER, CF63 4ES, CF63 4HR, CF63 4PG, CF63 4PL, CF63 4PR, CF63 4TF",336,294,42
W00005636,CF6,"CF6 6AB, CF6 6LE, CF6 6SA, CF6 6SB, CF6 6SD, CF6 6SE, CF6 8BW, CF6 8DJ, CF6 8HN, CF62 7HN, CF62 8EF, CF62 8HD, CF62 8HS, CF62 8HY, CF62 8LE",345,320,25
W00005635,CF6,"CF6 6EB, CF6 6EE, CF6 6ND, CF6 6NE, CF6 6NG, CF62 8DH, CF62 8EB, CF62 8EE, CF62 8ND, CF62 8NE, CF62 8NG",325,286,39
W00005634,CF6,"CF6 6AY, CF6 6AZ, CF6 6DX, CF6 6DY, CF6 6DZ, CF6 6EA, CF6 6RZ, CF62 8AZ, CF62 8DX, CF62 8DY, CF62 8DZ, CF62 8EA, CF62 8HB, CF62 8RZ, CF62 8SZ, CF63 4EA",319,291,28
W00005633,CF6,"CF6 6EL, CF6 6EN, CF6 6ET, CF6 6HG, CF6 6HP, CF6 6RW, CF6 6SL, CF6 6SW, CF6 6TB, CF6 7EP, CF6 7ER, CF63 4EL, CF63 4EN, CF63 4ET, CF63 4HG, CF63 4HP, CF63 4RW, CF63 4SL, CF63 4SW, CF63 4TB, CF63 4TD, CF63 4TS",226,195,31
W00005632,CF6,"CF6 6AD, CF6 6AF, CF6 6AR, CF6 6AS, CF6 6AT, CF6 6AX, CF62 8EG, CF62 8EJ, CF62 8EU, CF62 8EW, CF62 8EX, CF62 8HA",186,171,15
W00005630,CF6,"CF6 6AU, CF6 6AW, CF6 6BL, CF6 6NB, CF62 8BL, CF62 8EY, CF62 8EZ, CF62 8NB",277,238,39
W00005876,CF6,"CF6 9HP, CF6 9RD, CF6 9RE, CF6 9RH, CF6 9RJ, CF6 9RY, CF6 9SF, CF6 9SH, CF6 9UY, CF6 9XA, CF6 9XY, CF61 1AB, CF61 1AJ, CF61 1FB, CF61 1HP, CF61 1RD, CF61 1RE, CF61 1RH, CF61 1RJ, CF61 1RY, CF61 1SF, CF61 1SH, CF61 1UG, CF61 1UY, CF61 1XA, CF61 1XS, CF61 1XY",222,203,19
W00005675,CF6,"CF6 2SF, CF6 6RE, CF6 6RF, CF63 3AA, CF63 3DH, CF63 3RB, CF63 3RE, CF63 3RF, CF63 3XA, CF64 5AD, CF64 5AE, CF64 5RZ, CF64 5SE, CF64 5SF",166,151,15
W00005902,CF6,"CF6 9BD, CF6 9BS, CF6 9BX, CF6 9EP, CF6 9EQ, CF6 9FR, CF62 3BD, CF62 3BS, CF62 3BX, CF62 3DN, CF62 3DQ, CF62 3EP, CF62 3EQ, CF62 3ER, CF62 3FR",303,256,47
W00005907,CF6,"CF6 9BW, CF6 9DP, CF6 9DR, CF6 9DW, CF6 9ER, CF62 3BW, CF62 3DR, CF62 3DW, CF62 3HJ, CF62 3HP, CF62 3HQ, CF62 3HR, CF62 3HW",269,261,8
W00005900,CF6,"CF6 9AB, CF6 9AD, CF6 9AE, CF6 9AF, CF6 9AG, CF6 9AH, CF6 9AJ, CF6 9AL, CF6 9AS, CF62 3AB, CF62 3AD, CF62 3AE, CF62 3AF, CF62 3AG, CF62 3AH, CF62 3AJ, CF62 3AL, CF62 3AS, CF62 3AT, CF62 3AW",357,311,46
W00005899,CF6,"CF6 2BX, CF6 2BY, CF6 2BZ, CF6 2QD, CF6 2RQ, CF6 2RT, CF6 2RW, CF6 2RZ, CF64 5BX, CF64 5BY, CF64 5BZ, CF64 5QD, CF64 5RN, CF64 5RQ, CF64 5RT, CF64 5RW",268,232,36
W00005898,CF6,"CF6 2BW, CF6 2DP, CF6 2RF, CF6 2RG, CF6 2RR, CF6 2RU, CF6 2RX, CF6 2RY, CF64 5BW, CF64 5DP, CF64 5RF, CF64 5RG, CF64 5RR, CF64 5RU, CF64 5RX",311,275,36
W00005897,CF6,"CF6 2BS, CF6 2BT, CF6 2BU, CF6 2QY, CF6 2RN, CF6 2RP, CF6 2RS, CF64 3QY, CF64 3RN, CF64 3RP, CF64 5BS, CF64 5BT, CF64 5BU, CF64 5RS",317,278,39
W00005896,CF6,"CF6 2NZ, CF6 2PF, CF6 2QN, CF6 2QP, CF6 2QQ, CF6 2QR, CF64 3NZ, CF64 3PF, CF64 3QN, CF64 3QP, CF64 3QQ, CF64 3QR",274,245,29
W00005908,CF6,"CF6 9FQ, CF6 9HE, CF6 9HF, CF6 9HG, CF6 9ZS, CF62 3FQ, CF62 3HE, CF62 3HF, CF62 3HG",241,220,21
W00005895,CF6,"CF6 2HD, CF6 2JG, CF6 2JH, CF6 2QH, CF6 2RH, CF6 2RJ, CF6 2RL, CF64 2JG, CF64 3HD, CF64 3JG, CF64 3JH, CF64 3QH, CF64 5RH, CF64 5RJ, CF64 5RL",326,278,48
W00005909,CF6,"CF6 9EE, CF6 9FT, CF6 9FX, CF6 9FY, CF62 3EE, CF62 3FT, CF62 3FX, CF62 3FY",282,259,23
W00005894,CF6,"CF6 2BP, CF6 2BQ, CF6 2BR, CF6 2DF, CF6 2DG, CF6 2DQ, CF6 2HH, CF64 3HH, CF64 5BL, CF64 5BN, CF64 5BP, CF64 5BQ, CF64 5BR, CF64 5DF, CF64 5DG, CF64 5DQ, CF64 5YY",323,259,64
W00005910,CF6,"CF6 9DS, CF6 9DX, CF6 9DY, CF62 3AY, CF62 3DS, CF62 3DX, CF62 3DY, CF62 3HS, CF62 3HY",228,203,25
W00005911,CF6,"CF6 9DT, CF6 9EH, CF6 9EN, CF6 9ZT, CF62 3DL, CF62 3DT, CF62 3EH, CF62 3EN, CF62 3FA, CF62 3ZT",260,237,23
W00005913,CF6,"CF6 9DU, CF6 9EG, CF6 9EJ, CF6 9FS, CF6 9FU, CF62 3DU, CF62 3EG, CF62 3EJ, CF62 3FN, CF62 3FS, CF62 3FU",305,276,29
W00005906,CF6,"CF6 9BB, CF6 9BL, CF6 9BN, CF6 9BP, CF6 9BQ, CF6 9BR, CF6 9BT, CF6 9BZ, CF6 9NX, CF6 9ZL, CF6 9ZN, CF6 9ZP, CF62 3BB, CF62 3BL, CF62 3BN, CF62 3BP, CF62 3BQ, CF62 3BR, CF62 3BT, CF62 3BZ, CF62 3DP, CF62 3FP, CF62 3LB, CF62 3NA, CF62 3ZL, CF62 3ZN, CF62 3ZP",338,298,40
W00005891,CF6,"CF6 2BA, CF6 2BE, CF6 2BG, CF6 2BJ, CF6 2BL, CF6 2BN, CF6 2DD, CF6 2DJ, CF6 2DL, CF6 2DN, CF6 2DY, CF6 2DZ, CF6 2YP, CF64 3BA, CF64 3BE, CF64 3BG, CF64 3BL, CF64 3BN, CF64 3DD, CF64 3DJ, CF64 3DY, CF64 3DZ, CF64 5BJ, CF64 5DL, CF64 5DN",423,362,61
W00005892,CF6,"CF6 2HZ, CF6 2JL, CF6 2NY, CF6 2PA, CF6 2PD, CF6 2PE, CF6 2PG, CF6 2PL, CF6 2PN, CF64 3HZ, CF64 3JL, CF64 3NY, CF64 3PA, CF64 3PD, CF64 3PE, CF64 3PG, CF64 3PL, CF64 3PN",325,280,45
W00005915,CF6,"CF6 9BE, CF6 9DZ, CF62 3BE, CF62 3BG, CF62 3DZ, CF62 3LZ",268,238,30
W00005921,CF6,"CF6 9JP, CF6 9JS, CF6 9JT, CF6 9JU, CF6 9JW, CF6 9JX, CF62 3JP, CF62 3JS, CF62 3JT, CF62 3JU, CF62 3JW, CF62 3JX, CF62 4JP, CF62 4JS, CF62 4JT, CF62 4JU, CF62 4JW, CF62 4JX",319,278,41
W00005920,CF6,"CF6 9JD, CF6 9JE, CF6 9JF, CF6 9QG, CF6 9QH, CF6 9QJ, CF6 9QL, CF62 4JD, CF62 4JE, CF62 4JF, CF62 4LJ, CF62 4QG, CF62 4QH, CF62 4QJ, CF62 4QL",410,362,48
W00005919,CF6,"CF6 9JG, CF6 9JH, CF6 9JJ, CF62 4JG, CF62 4JH, CF62 4JJ",307,280,27
W00005918,CF6,"CF6 9FZ, CF6 9PN, CF6 9PR, CF6 9PT, CF6 9PW, CF6 9PY, CF62 4PN, CF62 4PR, CF62 4PT, CF62 4PW, CF62 4PY",302,279,23
W00005914,CF6,"CF6 9BH, CF6 9BJ, CF6 9DA, CF6 9DB, CF6 9DD, CF6 9DE, CF6 9DF, CF6 9DG, CF6 9DH, CF6 9DJ, CF6 9JB, CF6 9ZR, CF61 2ZR, CF62 3BH, CF62 3BJ, CF62 3DA, CF62 3DB, CF62 3DD, CF62 3DE, CF62 3DF, CF62 3DG, CF62 3DH, CF62 3DJ, CF62 3FZ, CF62 3HX, CF62 3HZ, CF62 3JB, CF62 3JZ, CF62 3WA, CF62 3YF, CF62 3YJ, CF62 3YR, CF62 3ZR",365,320,45
W00005885,CF6,"CF6 2EF, CF6 2HA, CF6 2HE, CF6 2HF, CF6 2HL, CF6 2HN, CF6 2HP, CF6 2HX, CF6 2XG, CF6 2YE, CF64 3EF, CF64 3ET, CF64 3HA, CF64 3HE, CF64 3HF, CF64 3HL, CF64 3HN, CF64 3HP, CF64 3HX, CF64 3YD",327,280,47
W00005884,CF6,"CF6 2QF, CF6 2QG, CF6 2QJ, CF6 2QL, CF6 2QS, CF64 3QF, CF64 3QG, CF64 3QJ, CF64 3QL, CF64 3QS",304,268,36
W00005916,CF6,"CF6 9BU, CF6 9EB, CF6 9ED, CF6 9FW, CF62 3BU, CF62 3EB, CF62 3ED, CF62 3FW",255,238,17
W00005886,CF6,"CF6 1XE, CF6 2AS, CF6 2AT, CF6 2AU, CF6 2AW, CF6 2AZ, CF6 2BB, CF6 2BD, CF6 2DX, CF6 2NR, CF6 2YL, CF6 2YR, CF64 3AS, CF64 3AT, CF64 3AU, CF64 3AW, CF64 3AZ, CF64 3BB, CF64 3BD, CF64 3DX, CF64 3NR, CF64 3YR",229,199,30
W00005887,CF6,"CF6 2BH, CF6 2DA, CF6 2DB, CF6 2DH, CF6 2DT, CF6 2DW, CF6 2EB, CF6 2EE, CF6 2YF, CF64 3BH, CF64 3BJ, CF64 3DA, CF64 3DB, CF64 3DH, CF64 3DQ, CF64 3DT, CF64 3DW, CF64 3EB, CF64 3EE, CF64 3TP, CF64 3YF, CF64 3YZ",302,257,45
W00005888,CF6,"CF6 2HB, CF6 2HJ, CF6 2HQ, CF6 2JB, CF6 2JD, CF6 2JE, CF6 2JF, CF6 2JJ, CF6 2JU, CF64 3HB, CF64 3HJ, CF64 3HQ, CF64 3JB, CF64 3JD, CF64 3JE, CF64 3JF, CF64 3JJ, CF64 3JU",301,252,49
W00005889,CF6,"CF6 2DE, CF6 2DR, CF6 2DS, CF6 2DU, CF6 2EP, CF6 2EQ, CF6 2HG, CF6 2YZ, CF6 2ZA, CF6 2ZB, CF6 2ZE, CF6 2ZF, CF6 2ZG, CF6 2ZN, CF64 3DE, CF64 3DR, CF64 3DS, CF64 3DU, CF64 3EP, CF64 3EQ, CF64 3ER, CF64 3HG, CF64 3ZN",325,281,44
W00005890,CF6,"CF6 2ES, CF6 2QT, CF6 2QU, CF6 2QX, CF6 2QZ, CF6 2XW, CF64 3QT, CF64 3QU, CF64 3QX, CF64 3QZ, CF64 3RQ",384,336,48
W00005917,CF6,"CF6 9BG, CF6 9EA, CF6 9EF, CF62 3BF, CF62 3EA, CF62 3EF",252,227,25
W00005905,CF6,"CF6 9EL, CF6 9EX, CF6 9EY, CF6 9EZ, CF62 3EL, CF62 3EX, CF62 3EY, CF62 3EZ",193,174,19
W00010516,CF61,"CF61 2YZ, CF61 2ZA",123,106,17
W00005857,CF61,"CF61 1BA, CF61 1BB, CF61 1BD, CF61 1BE, CF61 1BF, CF61 1BG, CF61 1BH, CF61 1BJ, CF61 1BL, CF61 1BN",169,163,6
W00005858,CF61,"CF61 2SP, CF61 2SR, CF61 2UH",273,233,40
W00005840,CF61,"CF61 1WR, CF61 1WU, CF61 1XB, CF61 1XF, CF61 1XG, CF61 1YR, CF61 2YB, CF61 2YD, CF61 2YX, CF7 7LP, CF7 7LQ, CF7 7LY, CF7 7NX, CF7 7NY, CF7 7NZ, CF7 7PA, CF7 7PB, CF7 7PE, CF7 7PF, CF7 7PX, CF7 7PY, CF71 7GB, CF71 7LP, CF71 7LQ, CF71 7LY, CF71 7NX, CF71 7NY, CF71 7NZ, CF71 7PA, CF71 7PB, CF71 7PE, CF71 7PF, CF71 7PG, CF71 7PN, CF71 7PP, CF71 7PX, CF71 7PY, CF71 7UY, CF71 7WA, CF71 7WE, CF71 7WF, CF71 7WH, CF71 7WN, CF71 7WP, CF71 7WR, CF71 7WS, CF71 7WW, CF71 7WY, CF71 7WZ, CF71 7XA, CF71 7XF, CF71 7XG, CF71 7XJ, CF71 7XN, CF71 7XT, CF71 7XU, CF71 7ZA, CF71 7ZD, CF71 7ZP, CF71 7ZQ, CF71 7ZT, CF71 7ZU, CF71 7ZX, CF71 9AA, CF71 9AB, CF71 9AE, CF71 9AF, CF71 9AG, CF71 9AH, CF71 9AJ, CF71 9AL, CF71 9AN, CF71 9AP, CF71 9AQ, CF71 9AR, CF71 9AS, CF71 9AT, CF71 9AU, CF71 9AW, CF71 9AX, CF71 9AY, CF71 9AZ, CF71 9BA, CF71 9BB, CF71 9BD, CF71 9BE, CF71 9BF, CF71 9BG, CF71 9BH, CF71 9BJ, CF71 9BL, CF71 9BN, CF71 9BP, CF71 9BQ, CF71 9BR, CF71 9BS, CF71 9BT, CF71 9BU, CF71 9BW, CF71 9BX, CF71 9BY, CF71 9BZ, CF71 9DA, CF71 9DB, CF71 9DD, CF71 9DE, CF71 9DF, CF71 9DG, CF71 9DH, CF71 9DJ, CF71 9DL, CF71 9DN, CF71 9DP, CF71 9DQ, CF71 9DR, CF71 9DS, CF71 9DT, CF71 9DU, CF71 9DW, CF71 9DX, CF71 9DY, CF71 9DZ, CF71 9EA, CF71 9EB, CF71 9ED, CF71 9EF",321,274,47
W00005859,CF61,"CF61 2SA, CF61 2SB, CF61 2SF",242,220,22
W00005861,CF61,"CF61 2SJ, CF61 2SL, CF61 2SN, CF61 2SQ",212,185,27
W00009835,CF62,"CF62 5DB, CF62 5DD, CF62 5DE, CF62 5DF, CF62 5DG, CF62 5DW",255,208,47
W00010582,CF62,"CF62 5AZ, CF62 5BB, CF62 5BL, CF62 5BU, CF62 5RA",273,236,37
W00005903,CF62,"CF62 3HH, CF62 3HT, CF62 3HU",369,344,25
W00010622,CF62,"CF62 3FE, CF62 3FG",247,206,41
W00010539,CF62,"CF62 3FB, CF62 3FF, CF62 3FJ, CF62 3FL",274,224,50
W00009847,CF62,"CF62 3LN, CF62 3LP, CF62 3LR",292,251,41
W00010590,CF62,"CF62 5BF, CF62 5BG, CF62 5BR, CF62 5DH, CF62 5QP, CF62 5QT, CF62 5QU, CF62 5QW, CF62 5XX, CF63 4UU",202,180,22
W00010504,CF62,"CF62 5BS, CF62 5BZ, CF62 5DJ, CF62 5DL",277,243,34
W00010508,CF62,"CF62 5AU, CF62 5AX, CF62 5BA",352,293,59
W00010591,CF62,"CF62 9EU, CF62 9EW",520,428,92
W00010647,CF62,"CF62 5AT, CF62 5BP, CF62 5BQ, CF62 5BT, CF62 5BX, CF62 5BY",287,241,46
W00010634,CF62,"CF62 3FH, CF62 3HN, CF62 3LA, CF62 3LE, CF62 3LF, CF62 3LG",435,382,53
W00009848,CF62,"CF62 3LD, CF62 3LH, CF62 3LJ, CF62 3LL, CF62 3LY, CF62 3NB, CF62 3ND",563,477,86
W00010578,CF62,"CF62 5AA, CF62 5AB, CF62 5AD, CF62 5AE",266,239,27
W00009823,CF63,"CF63 1AD, CF63 1AF, CF63 1HD, CF63 1HF, CF63 1HG, CF63 1HH, CF63 1HJ, CF63 1HL",467,391,76
W00009843,CF63,"CF63 1FX, CF63 1FY, CF63 1HB, CF63 1HE",280,245,35
W00009842,CF63,"CF63 1AR, CF63 1BR, CF63 1EH, CF63 1FW",243,207,36
W00009821,CF63,"CF63 1AS, CF63 1AT, CF63 1BQ, CF63 1DE, CF63 1DF, CF63 1DZ, CF63 1FA, CF63 1FD",292,260,32
W00009822,CF63,"CF63 1BP, CF63 1DD, CF63 1FB, CF63 1FE, CF63 1FF",271,244,27
W00009825,CF64,"CF64 3RH, CF64 3RJ, CF64 3RR",339,303,36
W00009846,CF64,"CF64 1SL, CF64 1SP, CF64 1SS, CF64 1ST",226,208,18
W00009853,CF64,"CF64 1SJ, CF64 1SN",115,102,13
W00009833,CF64,"CF64 3HU, CF64 3RE, CF64 3RF, CF64 3RL",249,218,31
W00010284,CF7,"CF7 9RP, CF72 4AA, CF72 4AB, CF72 4AD, CF72 4AE, CF72 4AG, CF72 4AH, CF72 4AJ, CF72 4AP, CF72 9GX, CF72 9RP, CF72 9WA, CF72 9ZF",365,275,90
W00010289,CF7,"CF7 9DF, CF72 9DF, CF72 9GB, CF72 9GF, CF72 9GG, CF72 9GH, CF72 9GJ, CF72 9GQ, CF72 9NB, CF72 9NL, CF72 9WH, CF72 9WJ, CF72 9WL, CF72 9XD",526,425,101
W00010293,CF7,"CF7 9BD, CF7 9BU, CF7 9BX, CF7 9BY, CF7 9DB, CF7 9DH, CF7 9DJ, CF7 9XH, CF7 9XJ, CF72 9BD, CF72 9BU, CF72 9BX, CF72 9BY, CF72 9DB, CF72 9DH, CF72 9DJ",278,257,21
W00010313,CF7,"CF7 9DE, CF7 9NA, CF7 9ND, CF72 9DE, CF72 9NA, CF72 9ND",100,88,12
W00009913,CF7,"CF7 8BL, CF7 8BN, CF7 8DY, CF7 8HE, CF7 8NX, CF7 8NZ, CF7 8PS, CF7 8QB, CF72 8BF, CF72 8BL, CF72 8BN, CF72 8DY, CF72 8HE, CF72 8NX, CF72 8NZ, CF72 8PS, CF72 8PY, CF72 8QB",259,221,38
W00010267,CF7,"CF7 9DD, CF72 9DD, CF72 9FY, CF72 9GD, CF72 9GE, CF72 9GN",345,292,53
W00010303,CF7,"CF7 9RX, CF7 9SZ, CF72 9RX, CF72 9SZ",227,197,30
W00006265,CF7,"CF7 9RB, CF7 9RN, CF72 9FT, CF72 9GL, CF72 9GU, CF72 9RB, CF72 9TT, CF72 9TW, CF72 9TX",387,325,62
W00006124,CF7,"CF7 9QQ, CF7 9QR, CF7 9SU, CF7 9SW, CF7 9SX, CF72 9QQ, CF72 9QR, CF72 9SU, CF72 9SW, CF72 9SX, CF72 9TS",204,168,36
W00006125,CF7,"CF7 9PZ, CF7 9QG, CF7 9QZ, CF7 9SJ, CF7 9TW, CF72 9QG, CF72 9QZ, CF72 9SJ",340,279,61
W00006126,CF7,"CF7 9SL, CF7 9SN, CF7 9TA, CF7 9TB, CF72 9SL, CF72 9SN, CF72 9TA, CF72 9TB",239,213,26
W00006127,CF7,"CF7 9QY, CF7 9SG, CF7 9SH, CF7 9SP, CF7 9SQ, CF7 9SR, CF72 9QY, CF72 9SG, CF72 9SH, CF72 9SP, CF72 9SQ, CF72 9SR",335,316,19
W00006129,CF7,"CF7 9RQ, CF7 9RR, CF7 9RT, CF7 9RU, CF7 9RW, CF7 9RY, CF72 9RQ, CF72 9RR, CF72 9RT, CF72 9RU, CF72 9RW, CF72 9RY",327,270,57
W00006266,CF7,"CF7 8LG, CF7 8LH, CF7 8LJ, CF7 9JS, CF7 9JZ, CF72 8LG, CF72 8LH, CF72 8LJ, CF72 8TA, CF72 8TB, CF72 8TD, CF72 8TE, CF72 8TF, CF72 8TG, CF72 9JS, CF72 9JZ, CF72 9LA, CF72 9WB",185,166,19
W00006268,CF7,"CF7 8HJ, CF7 8XX, CF7 8YE, CF7 8YJ, CF7 9UA, CF7 9UE, CF7 9XA, CF7 9YR, CF7 9YS, CF72 8HJ, CF72 8TP, CF72 8TZ, CF72 8XX, CF72 8YE, CF72 8ZU, CF72 9DY, CF72 9FD, CF72 9FE, CF72 9HJ, CF72 9LU, CF72 9UA, CF72 9UE, CF72 9WX, CF72 9XA, CF72 9ZH, CF72 9ZJ",501,427,74
W00006269,CF7,"CF7 9UB, CF7 9UD, CF72 9UB, CF72 9UD, CF72 9WQ",359,310,49
W00006270,CF7,"CF7 9QU, CF7 9SD, CF7 9SE, CF7 9SS, CF7 9ST, CF72 9QU, CF72 9SD, CF72 9SE, CF72 9SS, CF72 9ST",224,207,17
W00006271,CF7,"CF7 9NT, CF7 9NX, CF7 9NZ, CF7 9PA, CF7 9PB, CF7 9PJ, CF7 9PL, CF7 9PN, CF7 9PP, CF7 9PQ, CF7 9PW, CF72 9NT, CF72 9NX, CF72 9NZ, CF72 9PA, CF72 9PB, CF72 9PJ, CF72 9PL, CF72 9PN, CF72 9PP, CF72 9PQ, CF72 9PW",253,229,24
W00006272,CF7,"CF7 9PR, CF7 9PS, CF7 9PU, CF7 9QB, CF7 9QW, CF7 9QX, CF7 9SF, CF72 9PR, CF72 9PS, CF72 9PU, CF72 9QB, CF72 9QW, CF72 9QX, CF72 9SF, CF72 9UF",296,248,48
W00006273,CF7,"CF7 9PT, CF7 9QA, CF7 9RA, CF7 9RD, CF7 9XF, CF7 9XP, CF7 9XW, CF7 9XZ, CF72 9BW, CF72 9GR, CF72 9PT, CF72 9RA, CF72 9RD, CF72 9WG, CF72 9XW",378,331,47
W00006274,CF7,"CF7 8XL, CF7 8XQ, CF7 9NF, CF7 9NG, CF7 9NH, CF7 9NR, CF7 9NS, CF7 9NU, CF7 9NW, CF7 9NY, CF7 9PD, CF7 9PE, CF7 9PF, CF7 9PG, CF7 9PH, CF72 9FB, CF72 9FG, CF72 9LE, CF72 9NG, CF72 9NH, CF72 9NR, CF72 9NS, CF72 9NU, CF72 9NW, CF72 9NY, CF72 9PD, CF72 9PE, CF72 9PF, CF72 9PG, CF72 9PH, CF72 9QA",460,376,84
W00006275,CF7,"CF7 9RL, CF7 9RZ, CF7 9SA, CF7 9SB, CF72 9RL, CF72 9RZ, CF72 9SA, CF72 9SB, CF72 9SY",310,288,22
W00006276,CF7,"CF7 9HU, CF7 9JA, CF7 9JF, CF7 9JW, CF7 9XD, CF72 9GW, CF72 9HU, CF72 9JA, CF72 9JF, CF72 9JW",325,290,35
W00006277,CF7,"CF7 9HR, CF7 9LJ, CF7 9LQ, CF72 9HR, CF72 9LJ, CF72 9LQ, CF72 9NN",197,169,28
W00006278,CF7,"CF7 9LR, CF7 9LS, CF72 9FA, CF72 9LR, CF72 9LS, CF72 9NF, CF72 9NJ, CF72 9WE, CF72 9WZ, CF72 9ZE, CF72 9ZG",490,368,122
W00006280,CF7,"CF7 9HL, CF7 9HN, CF7 9HQ, CF7 9HT, CF7 9HX, CF7 9HZ, CF72 9HL, CF72 9HN, CF72 9HQ, CF72 9HT, CF72 9HX, CF72 9HZ",302,272,30
W00006281,CF7,"CF7 9HP, CF7 9HY, CF7 9JB, CF7 9JD, CF7 9JE, CF72 9HP, CF72 9HY, CF72 9JB, CF72 9JD, CF72 9JE, CF72 9NP",285,245,40
W00005739,CF7,"CF7 7RX, CF7 7RY, CF7 7RZ, CF7 7SD, CF7 7TA, CF7 7TN, CF7 7TP, CF71 7FF, CF71 7FT, CF71 7FY, CF71 7GA, CF71 7GD, CF71 7GH, CF71 7RX, CF71 7RY, CF71 7RZ, CF71 7SD, CF71 7TA, CF71 7TN, CF71 7TP",305,262,43
W00006283,CF7,"CF7 9HS, CF7 9JG, CF7 9JH, CF7 9JL, CF7 9JQ, CF7 9LB, CF7 9LD, CF72 9FL, CF72 9FN, CF72 9HS, CF72 9JG, CF72 9JH, CF72 9JL, CF72 9JQ, CF72 9LB, CF72 9LD, CF72 9WU",417,383,34
W00006123,CF7,"CF7 9QS, CF7 9QT, CF7 9TT, CF7 9TU, CF72 9PX, CF72 9QS, CF72 9QT",136,119,17
W00006121,CF7,"CF7 9QF, CF7 9QH, CF7 9QJ, CF7 9QL, CF7 9QP, CF72 9QF, CF72 9QH, CF72 9QJ, CF72 9QL, CF72 9QP, CF72 9ZR",290,265,25
W00006120,CF7,"CF7 9QD, CF7 9QE, CF7 9RS, CF7 9SY, CF7 9TR, CF72 9GT, CF72 9PY, CF72 9PZ, CF72 9QD, CF72 9QE, CF72 9RS, CF72 9TR, CF72 9UU, CF72 9UY, CF72 9UZ, CF72 9WP",585,501,84
W00006119,CF7,"CF7 9TD, CF7 9TE, CF7 9TF, CF7 9TJ, CF7 9TL, CF72 9TD, CF72 9TE, CF72 9TF, CF72 9TJ, CF72 9TL",262,216,46
W00005839,CF7,"CF7 7LL, CF7 7LN, CF7 7NQ, CF7 7NR, CF7 7NS, CF7 7NT, CF7 7NU, CF7 7NW, CF7 7PD, CF7 7XQ, CF71 7LL, CF71 7LN, CF71 7NQ, CF71 7NS, CF71 7NT, CF71 7NU, CF71 7NW, CF71 7PD, CF71 7XQ",358,298,60
W00005878,CF7,"CF7 7UG, CF7 7UH, CF7 7UJ, CF7 7UL, CF7 7UN, CF7 7UP, CF7 7UQ, CF7 7UR, CF7 7US, CF7 7UX, CF7 7UY, CF7 7UZ, CF7 8JX, CF7 8JY, CF7 8JZ, CF7 8LD, CF7 8YS, CF71 7UF, CF71 7UG, CF71 7UH, CF71 7UJ, CF71 7UL, CF71 7UN, CF71 7UP, CF71 7UQ, CF71 7US, CF71 7WJ, CF72 8GD, CF72 8GE, CF72 8GF, CF72 8GG, CF72 8GH, CF72 8GJ, CF72 8GN, CF72 8GP, CF72 8GQ, CF72 8GR, CF72 8GS, CF72 8JX, CF72 8JY, CF72 8JZ, CF72 8LD, CF72 8XQ, CF72 8XY, CF72 8YS",503,428,75
W00005957,CF7,"CF7 7QH, CF7 7QJ, CF7 7QL, CF7 7QN, CF7 7QP, CF7 7QR, CF7 7QT, CF71 7QH, CF71 7QJ, CF71 7QL, CF71 7QN, CF71 7QP, CF71 7QR, CF71 7QS, CF71 7QT, CF71 7QU",412,350,62
W00005736,CF7,"CF7 7RL, CF7 7RN, CF7 7RP, CF7 7RQ, CF7 7RR, CF7 7RS, CF7 7RT, CF7 7RU, CF7 7SA, CF7 7SB, CF71 7RL, CF71 7RN, CF71 7RP, CF71 7RQ, CF71 7RR, CF71 7RS, CF71 7RT, CF71 7RU, CF71 7SA, CF71 7SB",524,454,70
W00005735,CF7,"CF7 7DP, CF7 7DQ, CF7 7DR, CF7 7DS, CF71 7DP, CF71 7DQ, CF71 7DR, CF71 7DS",219,189,30
W00005734,CF7,"CF7 7LR, CF7 7LS, CF7 7LT, CF7 7LU, CF7 7LW, CF7 7LX, CF7 7LZ, CF71 7HY, CF71 7LH, CF71 7LR, CF71 7LS, CF71 7LT, CF71 7LU, CF71 7LW, CF71 7LX, CF71 7LZ, CF71 7PH, CF71 7PJ",385,323,62
W00005733,CF7,"CF7 7AY, CF7 7AZ, CF7 7BA, CF7 7BT, CF7 7BU, CF7 7UT, CF7 7UU, CF7 7UW, CF7 7XA, CF7 7XB, CF7 7XF, CF7 7XH, CF7 7XJ, CF7 7XL, CF7 7XR, CF7 7YS, CF71 7AY, CF71 7AZ, CF71 7BA, CF71 7BT, CF71 7BU, CF71 7UT, CF71 7UU, CF71 7YS",256,234,22
W00005732,CF7,"CF7 7AE, CF7 7AF, CF7 7AG, CF7 7AJ, CF7 7AL, CF7 7AT, CF7 7BJ, CF7 7BL, CF7 7DA, CF7 7DB, CF7 7DD, CF7 7DF, CF7 7XS, CF7 7YG, CF7 7YH, CF7 7YL, CF7 7YP, CF7 7YQ, CF7 7ZZ, CF71 7AE, CF71 7AG, CF71 7AJ, CF71 7AL, CF71 7AT, CF71 7BJ, CF71 7BL, CF71 7DA, CF71 7DB, CF71 7DD, CF71 7DF, CF71 7FB, CF71 7FR, CF71 7NA, CF71 7NR, CF71 7YG, CF71 7YH, CF71 7YL, CF71 7YP, CF71 7YQ",247,213,34
W00005731,CF7,"CF7 7AH, CF7 7AP, CF7 7AQ, CF7 7AR, CF7 7BB, CF7 7BD, CF7 7BG, CF7 7DW, CF7 7DX, CF7 7XN, CF7 7YE, CF7 7YJ, CF7 7YN, CF7 7YR, CF7 7YT, CF7 7YW, CF71 7AF, CF71 7AH, CF71 7AP, CF71 7AQ, CF71 7AR, CF71 7BB, CF71 7BD, CF71 7BE, CF71 7BG, CF71 7DW, CF71 7DX, CF71 7RA, CF71 7XW, CF71 7YE, CF71 7YJ, CF71 7YN, CF71 7YT, CF71 7YU, CF71 7YW, CF71 7ZR",317,260,57
W00005730,CF7,"CF7 7AN, CF7 7AU, CF7 7AW, CF7 7AX, CF7 7BW, CF7 7BX, CF7 7DE, CF7 7JP, CF71 7AN, CF71 7AU, CF71 7AW, CF71 7AX, CF71 7BW, CF71 7BX, CF71 7DE, CF71 7JP",233,189,44
W00006284,CF7,"CF7 9JP, CF7 9LH, CF7 9LL, CF7 9LN, CF7 9LP, CF7 9LT, CF7 9LU, CF7 9LW, CF7 9LX, CF7 9LY, CF7 9LZ, CF7 9XE, CF7 9XG, CF7 9XL, CF7 9XN, CF7 9XQ, CF7 9XX, CF7 9YQ, CF72 9FJ, CF72 9JP, CF72 9LF, CF72 9LG, CF72 9LH, CF72 9LL, CF72 9LN, CF72 9LP, CF72 9LT, CF72 9LW, CF72 9LX, CF72 9LY, CF72 9LZ, CF72 9RN, CF72 9UP, CF72 9XE, CF72 9XF, CF72 9XJ, CF72 9XQ, CF72 9XR, CF72 9XS, CF72 9XU, CF72 9XY, CF72 9XZ, CF72 9YL, CF72 9YS",428,369,59
W00005729,CF7,"CF7 7BQ, CF7 7BR, CF7 7EF, CF71 7BQ, CF71 7BR, CF71 7EF",273,246,27
W00005727,CF7,"CF7 7EA, CF7 7EB, CF7 7HP, CF7 7HQ, CF7 7HR, CF71 7EA, CF71 7EB, CF71 7HP, CF71 7HQ, CF71 7HR",267,231,36
W00005726,CF7,"CF7 7EY, CF7 7JA, CF7 7JD, CF7 7JN, CF7 7JQ, CF7 7JR, CF7 7JX, CF7 7LJ, CF7 7YU, CF7 7YX, CF7 7YY, CF7 7YZ, CF71 7EY, CF71 7FA, CF71 7JA, CF71 7JD, CF71 7JN, CF71 7JQ, CF71 7JR, CF71 7JX, CF71 7JY, CF71 7LJ, CF71 7YY, CF71 7YZ",338,277,61
W00005725,CF7,"CF7 7DZ, CF7 7EP, CF7 7EQ, CF7 7HL, CF7 7HS, CF7 7HT, CF71 7DZ, CF71 7EP, CF71 7EQ, CF71 7HL, CF71 7HS, CF71 7HT",244,210,34
W00005724,CF7,"CF7 7DG, CF7 7DH, CF7 7DJ, CF7 7DY, CF7 7ED, CF7 7EL, CF7 7ER, CF7 7ES, CF7 7HJ, CF7 7HN, CF7 7XX, CF71 7DG, CF71 7DH, CF71 7DJ, CF71 7DY, CF71 7ED, CF71 7EL, CF71 7ER, CF71 7HJ, CF71 7HN, CF71 7UZ, CF71 7WB, CF71 7WD, CF71 7WL, CF71 7WQ, CF71 7WT, CF71 7WU, CF71 7WX, CF71 7XD, CF71 7XE, CF71 7XH, CF71 7XL, CF71 7XR, CF71 7XX, CF71 7YR",237,197,40
W00005723,CF7,"CF7 7HZ, CF7 7JE, CF7 7JF, CF7 7JG, CF7 7JH, CF7 7JJ, CF7 7JL, CF7 7JU, CF71 7FG, CF71 7FH, CF71 7FJ, CF71 7FL, CF71 7FN, CF71 7FP, CF71 7HZ, CF71 7JE, CF71 7JF, CF71 7JG, CF71 7JH, CF71 7JJ, CF71 7JL, CF71 7JU, CF71 7JZ",417,348,69
W00005722,CF7,"CF7 7BN, CF7 7EW, CF7 7EX, CF7 7EZ, CF7 7HH, CF7 7HX, CF7 7JS, CF71 7BN, CF71 7EW, CF71 7EX, CF71 7EZ, CF71 7HX, CF71 7JS",292,251,41
W00005721,CF7,"CF7 7AA, CF7 7AB, CF7 7BP, CF7 7DL, CF7 7DN, CF7 7XT, CF7 7XY, CF7 7XZ, CF7 7YA, CF7 7YB, CF7 7YF, CF71 7AA, CF71 7AB, CF71 7BP, CF71 7DL, CF71 7DN, CF71 7XY, CF71 7XZ, CF71 7YB, CF71 7YF, CF71 7YX",204,195,9
W00005720,CF7,"CF7 7AS, CF7 7BE, CF7 7BH, CF7 7BY, CF7 7HY, CF7 7JB, CF7 7JT, CF7 7JW, CF7 7XD, CF7 7XG, CF7 7XP, CF7 7XU, CF7 7XW, CF7 7YD, CF71 7AS, CF71 7BH, CF71 7BY, CF71 7JB, CF71 7JT, CF71 7JW, CF71 7UW, CF71 7WG, CF71 7XB, CF71 7XP, CF71 7XS, CF71 7YA, CF71 7YD",274,225,49
W00005719,CF7,"CF7 7AD, CF7 7BS, CF7 7BZ, CF7 7DU, CF7 7EE, CF7 7EG, CF7 7EH, CF7 7EJ, CF7 7EN, CF7 7ET, CF7 7EU, CF7 7HB, CF71 7AD, CF71 7BS, CF71 7BZ, CF71 7DU, CF71 7EE, CF71 7EG, CF71 7EH, CF71 7EJ, CF71 7EN, CF71 7ES, CF71 7ET, CF71 7EU, CF71 7FD, CF71 7HB, CF71 7HH, CF71 7LA, CF71 7LB, CF71 7LE, CF71 7LG",342,299,43
W00006118,CF7,"CF7 9TG, CF7 9TH, CF7 9TN, CF7 9TP, CF7 9TQ, CF72 9TG, CF72 9TH, CF72 9TN, CF72 9TP, CF72 9TQ",240,214,26
W00005728,CF7,"CF7 7DT, CF7 7HA, CF7 7HD, CF7 7HE, CF7 7HF, CF7 7HG, CF7 7HU, CF7 7HW, CF71 7DT, CF71 7FU, CF71 7GJ, CF71 7GX, CF71 7HA, CF71 7HD, CF71 7HE, CF71 7HF, CF71 7HG, CF71 7HU, CF71 7HW, CF71 7LD",282,240,42
W00006286,CF7,"CF7 8DG, CF7 8DH, CF7 8DP, CF7 8DQ, CF7 8DS, CF7 8DU, CF72 8DG, CF72 8DH, CF72 8DP, CF72 8DQ, CF72 8DS, CF72 8DU",273,233,40
W00006282,CF7,"CF7 9HW, CF7 9JJ, CF7 9JN, CF72 9HW, CF72 9JJ, CF72 9JN, CF72 9NQ",179,158,21
W00006289,CF7,"CF7 8EY, CF7 8HA, CF7 8HB, CF7 8HD, CF72 8EY, CF72 8HA, CF72 8HB, CF72 8HD",254,223,31
W00006441,CF7,"CF7 9AB, CF7 9AD, CF7 9DS, CF7 9DT, CF7 9DZ, CF7 9EF, CF7 9ES, CF7 9YL, CF7 9YW, CF72 9AB, CF72 9AD, CF72 9DS, CF72 9DT, CF72 9DZ, CF72 9EF, CF72 9ES, CF72 9TY, CF72 9TZ, CF72 9YW",244,218,26
W00006443,CF7,"CF7 9AA, CF7 9AE, CF7 9AF, CF7 9AH, CF7 9DP, CF7 9DQ, CF7 9DR, CF7 9YA, CF7 9YB, CF7 9YE, CF7 9YH, CF72 9AA, CF72 9AE, CF72 9AF, CF72 9AH, CF72 9DP, CF72 9DQ, CF72 9FF, CF72 9YA, CF72 9YB, CF72 9YH, CF72 9YZ",274,237,37
W00006287,CF7,"CF7 8BG, CF7 8BH, CF7 8BJ, CF7 8HF, CF7 8PR, CF72 8AG, CF72 8BG, CF72 8BH, CF72 8BJ, CF72 8HF, CF72 8PR",246,204,42
W00006444,CF7,"CF7 9AL, CF7 9AN, CF7 9AP, CF7 9AQ, CF7 9AR, CF7 9AS, CF7 9AT, CF72 9AL, CF72 9AN, CF72 9AP, CF72 9AQ, CF72 9AR, CF72 9AS, CF72 9AT",309,278,31
W00006445,CF7,"CF7 8JL, CF7 8JN, CF7 8JQ, CF7 8JR, CF7 8JS, CF72 8JL, CF72 8JN, CF72 8JQ, CF72 8JR, CF72 8JS, CF72 8QS, CF72 8QT, CF72 8QU, CF72 8SQ, CF72 8SS",546,384,162
W00006446,CF7,"CF7 9EN, CF7 9EP, CF7 9EQ, CF7 9HE, CF72 9EN, CF72 9EP, CF72 9EQ, CF72 9HE",233,202,31
W00006447,CF7,"CF7 9EG, CF7 9EH, CF7 9EJ, CF7 9EL, CF7 9ER, CF7 9HF, CF72 9EB, CF72 9EG, CF72 9EH, CF72 9EJ, CF72 9EL, CF72 9ER, CF72 9HF",275,228,47
W00006527,CF7,"CF7 8RB, CF7 8RN, CF7 8RQ, CF7 8SD, CF72 8RB, CF72 8RH, CF72 8RJ, CF72 8RL, CF72 8RN, CF72 8RQ, CF72 8SD",182,172,10
W00006439,CF7,"CF7 9AU, CF7 9AW, CF7 9AX, CF72 8QW, CF72 8QX, CF72 8SX, CF72 8TH, CF72 8TJ, CF72 8TL, CF72 9AU, CF72 9AW, CF72 9AX",557,427,130
W00006528,CF7,"CF7 8HL, CF7 8HX, CF7 8HY, CF7 8RA, CF7 8UU, CF7 8XR, CF7 8XT, CF7 8XU, CF7 8YB, CF7 8YH, CF7 8YN, CF7 8YY, CF7 9NE, CF7 9YF, CF72 0AA, CF72 0AB, CF72 0AD, CF72 0AE, CF72 0AF, CF72 0AG, CF72 0AH, CF72 0AJ, CF72 0AL, CF72 0AN, CF72 0AP, CF72 0AQ, CF72 0AR, CF72 0AS, CF72 0AT, CF72 0AU, CF72 0AW, CF72 0AX, CF72 0AY, CF72 0AZ, CF72 0BA, CF72 0BB, CF72 0BD, CF72 0BE, CF72 0BF, CF72 0BG, CF72 0BH, CF72 0BJ, CF72 0BL, CF72 0BN, CF72 0BP, CF72 0BQ, CF72 0BR, CF72 0BS, CF72 0BT, CF72 0BU, CF72 0BW, CF72 0BX, CF72 0BY, CF72 0BZ, CF72 0DA, CF72 0DB, CF72 0DD, CF72 0DE, CF72 0DF, CF72 0DG, CF72 0DH, CF72 0DJ, CF72 0DL, CF72 0DN, CF72 0DP, CF72 0DQ, CF72 0DR, CF72 0DS, CF72 0DT, CF72 0DU, CF72 0DW, CF72 0DX, CF72 0DZ, CF72 0EA, CF72 0EB, CF72 0ED, CF72 0EE, CF72 0EF, CF72 0EG, CF72 0EH, CF72 0EJ, CF72 0EL, CF72 0EN, CF72 0EP, CF72 0EQ, CF72 0ER, CF72 0ES, CF72 8FE, CF72 8HL, CF72 8HP, CF72 8HX, CF72 8HY, CF72 8LY, CF72 8RA, CF72 8UB, CF72 8UD, CF72 8UE, CF72 8UF, CF72 8UL, CF72 8UN, CF72 8UR, CF72 8UU, CF72 8UY, CF72 8UZ, CF72 8WA, CF72 8WB, CF72 8WD, CF72 8WE, CF72 8WF, CF72 8WG, CF72 8WH, CF72 8WJ, CF72 8WL, CF72 8WN, CF72 8WP, CF72 8WQ, CF72 8WR, CF72 8WS, CF72 8WT, CF72 8WU, CF72 8WW, CF72 8WX, CF72 8WY, CF72 8WZ, CF72 8XA, CF72 8XB, CF72 8XD, CF72 8XE, CF72 8XF, CF72 8XG, CF72 8XH, CF72 8XJ, CF72 8XP, CF72 8XS, CF72 8XU, CF72 8XW, CF72 8YA, CF72 8YH, CF72 8YZ, CF72 8ZQ, CF72 8ZT, CF72 9WF, CF72 9WN, CF72 9WY, CF72 9XG, CF72 9XH, CF72 9XL, CF72 9XN, CF72 9XP, CF72 9XT, CF72 9XX, CF72 9YD, CF72 9YE, CF72 9YF, CF72 9YP, CF72 9YQ, CF72 9YY, CF72 9ZA, CF72 9ZL, CF72 9ZT, CF72 9ZX, CF72 9ZY",423,340,83
W00006530,CF7,"CF7 8HH, CF7 8HN, CF7 8HS, CF7 8HZ, CF7 8JG, CF7 8LA, CF7 8LB, CF7 9LA, CF72 8HH, CF72 8HN, CF72 8HS, CF72 8HZ, CF72 8JG, CF72 8LA, CF72 8LB",246,212,34
W00006531,CF7,"CF7 8AB, CF7 8AL, CF7 8AN, CF7 8AP, CF7 8AQ, CF7 8AR, CF7 8LL, CF72 8AL, CF72 8AN, CF72 8AP, CF72 8AQ, CF72 8AR, CF72 8FL, CF72 8FP, CF72 8FR, CF72 8GL, CF72 8LL, CF72 8UX, CF72 8XL, CF72 8XN, CF72 8XR, CF72 8XT",353,319,34
W00006532,CF7,"CF7 8AA, CF7 8AD, CF7 8AE, CF7 8AF, CF7 8AH, CF7 8AS, CF7 8AU, CF7 8AW, CF7 8AX, CF7 8HT, CF7 8RD, CF7 8RH, CF7 8YD, CF7 8YF, CF72 8AA, CF72 8AB, CF72 8AD, CF72 8AE, CF72 8AF, CF72 8AH, CF72 8AS, CF72 8AU, CF72 8AX, CF72 8FD, CF72 8HT, CF72 8LW, CF72 8RD, CF72 8SY, CF72 8YB, CF72 8YD",306,254,52
W00006533,CF7,"CF7 8JA, CF7 8JB, CF7 8JD, CF7 8JE, CF7 8JF, CF72 8JA, CF72 8JB, CF72 8JD, CF72 8JE, CF72 8JF",299,260,39
W00006534,CF7,"CF7 8HP, CF7 8HQ, CF7 8HU, CF72 8FH, CF72 8HQ, CF72 8HU",362,325,37
W00009906,CF7,"CF7 9RE, CF7 9RF, CF7 9RG, CF7 9RH, CF7 9RJ, CF72 9GS, CF72 9RE, CF72 9RF, CF72 9RG, CF72 9RH, CF72 9RJ",190,164,26
W00006535,CF7,"CF7 8AJ, CF7 8HW, CF72 8AJ, CF72 8HW, CF72 8SE",264,243,21
W00009910,CF7,"CF7 9ET, CF7 9EU, CF7 9EW, CF7 9EX, CF7 9EY, CF7 9HB, CF7 9HG, CF7 9JR, CF7 9NJ, CF7 9NL, CF7 9XR, CF7 9XU, CF7 9YP, CF7 9YX, CF72 9DW, CF72 9DX, CF72 9ET, CF72 9EU, CF72 9EW, CF72 9EX, CF72 9EY, CF72 9FQ, CF72 9GP, CF72 9HB, CF72 9HG, CF72 9YN, CF72 9YX",279,233,46
W00006529,CF7,"CF7 8HR, CF7 8RE, CF7 8RF, CF7 8RG, CF7 8YL, CF7 8YQ, CF7 9YD, CF72 8HR, CF72 8RE, CF72 8RF, CF72 8RG, CF72 8RP, CF72 8YJ, CF72 8YL, CF72 8YQ",253,226,27
W00006438,CF7,"CF7 9AG, CF7 9AJ, CF7 9AY, CF7 9AZ, CF72 9AG, CF72 9AJ, CF72 9AY, CF72 9AZ, CF72 9DR",258,225,33
W00005738,CF7,"CF7 7TB, CF7 7TR, CF7 7TT, CF71 7SE, CF71 7SF, CF71 7SG, CF71 7TB, CF71 7TR, CF71 7TT, CF71 7TX",358,309,49
W00006435,CF7,"CF7 8JP, CF7 8PD, CF7 8PG, CF7 8PH, CF7 8PT, CF7 8YR, CF72 8JP, CF72 8PD, CF72 8PG, CF72 8PH, CF72 8PT, CF72 8SG, CF72 8SH, CF72 8YR",429,309,120
W00006290,CF7,"CF7 8BQ, CF7 8BR, CF7 8BT, CF7 8BZ, CF7 8EA, CF7 8EB, CF7 8EE, CF7 8EU, CF7 8EX, CF7 8YP, CF72 8BQ, CF72 8BR, CF72 8BT, CF72 8BU, CF72 8BZ, CF72 8EA, CF72 8EB, CF72 8EE, CF72 8EU, CF72 8EX, CF72 8GA, CF72 8SR",304,262,42
W00006292,CF7,"CF7 8DA, CF7 8DD, CF7 8ED, CF7 8EF, CF7 8EN, CF7 8EW, CF7 8EZ, CF72 8DA, CF72 8DD, CF72 8ED, CF72 8EF, CF72 8EN, CF72 8EW, CF72 8EZ",246,204,42
W00006293,CF7,"CF7 8AT, CF7 8BU, CF7 8DF, CF7 8EG, CF7 8EH, CF7 8EJ, CF7 8EL, CF7 8EP, CF7 8EQ, CF7 8ER, CF7 8ES, CF7 8ET, CF72 8AT, CF72 8AW, CF72 8DF, CF72 8EG, CF72 8EH, CF72 8EJ, CF72 8EL, CF72 8EP, CF72 8EQ, CF72 8ER, CF72 8ES, CF72 8ET, CF72 8FB, CF72 8SP",285,226,59
W00006294,CF7,"CF7 8DJ, CF7 8DL, CF7 8DN, CF7 8QJ, CF7 8QL, CF72 8DJ, CF72 8DL, CF72 8DN, CF72 8QJ, CF72 8QL",284,233,51
W00006295,CF7,"CF7 8AG, CF7 8AZ, CF7 8BA, CF7 8BB, CF7 8BD, CF7 8BE, CF7 8HG, CF7 8LU, CF72 8AZ, CF72 8BA, CF72 8BB, CF72 8BD, CF72 8BE, CF72 8HG, CF72 8LU, CF72 8LZ, CF72 8NL, CF72 8PF, CF72 8SN, CF72 8TT",325,270,55
W00006296,CF7,"CF7 8BX, CF7 8BY, CF7 8DZ, CF7 8QF, CF7 8QG, CF7 8QH, CF72 8BX, CF72 8BY, CF72 8DZ, CF72 8QF, CF72 8QG, CF72 8QH",274,230,44
W00006297,CF7,"CF7 8AY, CF7 8BP, CF7 8BS, CF7 8BW, CF7 8QD, CF7 8QE, CF7 8YG, CF72 8AY, CF72 8BP, CF72 8BS, CF72 8BW, CF72 8QD, CF72 8QE, CF72 8YG",276,230,46
W00006298,CF7,"CF7 8DW, CF7 8QA, CF7 8QN, CF7 8QP, CF7 8UA, CF7 8UE, CF7 8XA, CF7 8XP, CF7 8XW, CF7 8XY, CF7 8YA, CF72 8DW, CF72 8PZ, CF72 8QA, CF72 8QN, CF72 8QP, CF72 8UA, CF72 8UG, CF72 8UH, CF72 8UJ, CF72 8UQ, CF72 8YF",278,228,50
W00006429,CF7,"CF7 8JU, CF7 8JW, CF7 8LE, CF7 8NA, CF7 8NB, CF7 8ND, CF7 8NE, CF7 8NF, CF7 8NH, CF7 8NJ, CF7 8NN, CF7 8NS, CF7 8NT, CF7 8NW, CF7 8PJ, CF7 8PL, CF7 8PN, CF7 8PP, CF7 8PQ, CF7 8RU, CF7 8SA, CF7 8UB, CF7 8UD, CF7 8UF, CF72 8GB, CF72 8JU, CF72 8JW, CF72 8LE, CF72 8NA, CF72 8NB, CF72 8ND, CF72 8NE, CF72 8NF, CF72 8NH, CF72 8NJ, CF72 8NN, CF72 8NS, CF72 8NT, CF72 8NW, CF72 8PJ, CF72 8PL, CF72 8PN, CF72 8PP, CF72 8PQ, CF72 8RU, CF72 8UP",421,364,57
W00006430,CF7,"CF7 9BA, CF7 9BB, CF7 9BR, CF7 9BS, CF7 9BT, CF7 9DG, CF7 9DN, CF7 9EA, CF7 9EB, CF7 9ED, CF7 9EE, CF7 9NB, CF7 9YJ, CF7 9YT, CF7 9YU, CF7 9YY, CF7 9YZ, CF72 9BA, CF72 9BB, CF72 9BR, CF72 9BS, CF72 9BT, CF72 9DG, CF72 9DN, CF72 9EA, CF72 9ED, CF72 9EE, CF72 9NE, CF72 9WS, CF72 9YR, CF72 9YT, CF72 9YU",357,315,42
W00006431,CF7,"CF7 9BE, CF7 9BF, CF7 9BG, CF7 9BH, CF7 9BJ, CF7 9BL, CF7 9BN, CF7 9BP, CF7 9BQ, CF7 9DL, CF72 9BE, CF72 9BG, CF72 9BH, CF72 9BJ, CF72 9BL, CF72 9BN, CF72 9BP, CF72 9BQ, CF72 9DL",244,216,28
W00006299,CF7,"CF7 8DR, CF7 8DT, CF7 8DX, CF7 8JH, CF72 8DR, CF72 8DT, CF72 8DX, CF72 8JH",286,252,34
W00009902,CF7,"CF7 8XD, CF7 9BW, CF7 9EZ, CF7 9HA, CF7 9HD, CF7 9YG, CF7 9YN, CF72 9EZ, CF72 9FP, CF72 9FS, CF72 9GA, CF72 9HA, CF72 9HD, CF72 9YG",430,348,82
W00006432,CF7,"CF7 8XB, CF7 9BZ, CF7 9DA, CF7 9HH, CF7 9JT, CF7 9JU, CF7 9XB, CF72 9BF, CF72 9BZ, CF72 9DA, CF72 9DU, CF72 9FH, CF72 9HH, CF72 9JT, CF72 9JU, CF72 9UG, CF72 9UH, CF72 9WR, CF72 9WT, CF72 9XB",464,414,50
W00006434,CF7,"CF7 8JJ, CF7 8JT, CF7 8PE, CF7 8PU, CF7 8PW, CF7 8PX, CF72 8JJ, CF72 8JT, CF72 8PE, CF72 8PU, CF72 8PW, CF72 8PX",221,186,35
W00006433,CF7,"CF7 8NP, CF7 8NQ, CF7 8NR, CF7 8PA, CF7 8PB, CF7 8RP, CF7 8RR, CF7 8RS, CF7 8RT, CF72 8NP, CF72 8NQ, CF72 8NR, CF72 8PA, CF72 8PB, CF72 8RR, CF72 8RS, CF72 8RT",270,202,68
W00010314,CF72,"CF72 9FW, CF72 9FZ, CF72 9WD, CF72 9ZB",531,423,108
W00006437,CF72,"CF72 8RY, CF72 8RZ",253,194,59
W00006440,CF72,"CF72 8RW, CF72 8SB, CF72 8SF, CF72 8ST, CF72 8SW, CF72 8SZ",533,376,157
W00010275,CF72,"CF72 9FU, CF72 9FX",245,191,54
W00010272,CF72,"CF72 9UT, CF72 9UX, CF72 9WW",180,162,18
W00009900,CF72,"CF72 9TU, CF72 9UL, CF72 9UN, CF72 9ZD, CF72 9ZN",503,415,88
W00009893,CF72,"CF72 9UJ, CF72 9UQ, CF72 9UR, CF72 9US",297,240,57
W00009899,CF72,"CF72 9FR, CF72 9UW",317,234,83
W00006442,CF72,"CF72 8RX, CF72 8SJ, CF72 8SL, CF72 8SU, CF72 8TN",338,257,81
W00007194,CF8,"CF8 3AD, CF8 3AG, CF8 3FD, CF8 3FG, CF8 3NH, CF83 3AD, CF83 3AG, CF83 3FD, CF83 3FG, CF83 3NH",247,216,31
W00007191,CF8,"CF8 3FQ, CF8 3FS, CF8 3FT, CF8 3FU, CF8 3FW, CF83 3FQ, CF83 3FS, CF83 3FT, CF83 3FU, CF83 3FW",288,262,26
W00007192,CF8,"CF8 3FE, CF8 3FF, CF8 3FH, CF8 3FN, CF8 3FP, CF8 3FR, CF8 3JB, CF83 3FE, CF83 3FF, CF83 3FH, CF83 3FN, CF83 3FP, CF83 3FR, CF83 3JB, CF83 3RS, CF83 3SJ, CF83 3SP",468,372,96
W00007500,CF8,"CF8 8AA, CF8 8AB, CF8 8AD, CF8 8AE, CF8 8AF, CF8 8BA, CF82 8AA, CF82 8AB, CF82 8AD, CF82 8AE, CF82 8AF, CF82 8AX, CF82 8BA, CF82 8BG",231,204,27
W00007499,CF8,"CF8 7AT, CF8 7AU, CF8 7AW, CF8 7BN, CF82 7AT, CF82 7AU, CF82 7AW, CF82 7BN, CF82 7TU",339,308,31
W00007193,CF8,"CF8 3AA, CF8 3AB, CF8 3AE, CF8 3AF, CF8 3AH, CF8 3AJ, CF8 3HA, CF8 3HD, CF83 3AA, CF83 3AB, CF83 3AE, CF83 3AF, CF83 3AH, CF83 3AJ, CF83 3HA, CF83 3HD",291,239,52
W00007195,CF8,"CF8 1NY, CF8 1NZ, CF8 1PA, CF8 1PB, CF8 1PD, CF8 1WQ, CF8 3AL, CF8 3AP, CF8 3AS, CF8 3AT, CF8 3AX, CF8 3SL, CF83 1NY, CF83 1NZ, CF83 1PA, CF83 1PB, CF83 1PD, CF83 1UA, CF83 1XN, CF83 1XP, CF83 3AL, CF83 3AP, CF83 3AS, CF83 3AT, CF83 3AX, CF83 3SB, CF83 3SQ",367,304,63
W00007196,CF8,"CF8 1AB, CF8 1AL, CF8 1AP, CF8 1WG, CF8 3FA, CF8 3FB, CF8 3FJ, CF83 1AB, CF83 1AL, CF83 1AP, CF83 1JD, CF83 1WG, CF83 3FA, CF83 3FB, CF83 3FJ",255,221,34
W00007501,CF8,"CF8 7AB, CF8 7AE, CF8 7AJ, CF8 7AL, CF8 7AN, CF8 7AQ, CF8 7BE, CF8 7WU, CF8 7YY, CF82 7AB, CF82 7AE, CF82 7AJ, CF82 7AL, CF82 7AN, CF82 7AQ, CF82 7YT",262,221,41
W00007294,CF8,"CF8 2LR, CF8 2LS, CF8 2LW, CF8 2PS, CF8 2PT, CF8 2QU, CF8 2QX, CF8 2QY, CF8 3TE, CF83 2LW, CF83 2PS, CF83 2PT, CF83 2QU, CF83 2QX, CF83 2QY, CF83 2RB",251,236,15
W00007496,CF8,"CF8 7EP, CF8 7SF, CF8 7XS, CF8 7XX, CF8 7XZ, CF82 7DG, CF82 7DH, CF82 7DJ, CF82 7DL, CF82 7EP, CF82 7FG, CF82 7FP, CF82 7GP, CF82 7SL, CF82 7XS, CF82 7XW",333,282,51
W00007450,CF8,"CF8 1HD, CF8 1HE, CF8 1HF, CF8 1HG, CF8 1HR, CF8 1HT, CF8 1HY, CF8 1JR, CF8 1LL, CF8 1WS, CF8 2WX, CF83 1BH, CF83 1HD, CF83 1HE, CF83 1HF, CF83 1HG, CF83 1HR, CF83 1HT, CF83 1HY, CF83 1JB, CF83 1ZA, CF83 1ZW",349,318,31
W00007451,CF8,"CF8 1BB, CF8 1BW, CF8 1DP, CF8 1DQ, CF8 1XS, CF8 3TH, CF83 1BB, CF83 1BE, CF83 1BF, CF83 1BW, CF83 1DP, CF83 1DQ, CF83 1XJ, CF83 1XS, CF83 2BJ",270,235,35
W00007452,CF8,"CF8 1BQ, CF8 1XG, CF8 1XH, CF8 1XJ, CF8 1YD, CF8 1YE, CF8 1YH, CF8 1YY, CF83 1BQ, CF83 1SW, CF83 1SX, CF83 1TE, CF83 1XG, CF83 1XH, CF83 1YY",273,240,33
W00007453,CF8,"CF8 1HH, CF8 1HJ, CF8 1HL, CF8 1HN, CF8 1HP, CF8 1HQ, CF8 1HS, CF8 1XY, CF8 2XA, CF83 1HH, CF83 1HJ, CF83 1HL, CF83 1HN, CF83 1HP, CF83 1HQ, CF83 1HS, CF83 1HZ",354,277,77
W00007454,CF8,"CF8 1EH, CF8 1EL, CF8 1EN, CF8 1ER, CF8 1ES, CF8 1EU, CF8 1NS, CF8 1XD, CF8 2WP, CF8 2WW, CF83 1BJ, CF83 1EA, CF83 1EH, CF83 1EL, CF83 1EN, CF83 1ER, CF83 1ES, CF83 1EU, CF83 1NS, CF83 2WW",403,330,73
W00010278,CF8,"CF8 7GL, CF82 6AA, CF82 6AJ, CF82 6AL, CF82 6AN, CF82 6AQ, CF82 6BL, CF82 6BN, CF82 7GL",308,246,62
W00007190,CF8,"CF8 3EW, CF8 3FL, CF8 3HG, CF8 3HH, CF8 3HJ, CF8 3HL, CF8 3HP, CF8 3JQ, CF83 3EW, CF83 3FL, CF83 3HG, CF83 3HH, CF83 3HJ, CF83 3HL, CF83 3HP",320,267,53
W00010277,CF8,"CF8 7HP, CF8 7LS, CF82 7FH, CF82 7HP, CF82 7LS, CF82 8FN",167,148,19
W00007456,CF8,"CF8 1EE, CF8 1ET, CF8 1EW, CF8 1EX, CF8 1EZ, CF83 1EE, CF83 1ET, CF83 1EW, CF83 1EX, CF83 1EZ",275,237,38
W00007457,CF8,"CF8 1FA, CF8 1NN, CF8 1NQ, CF8 1NR, CF8 1NT, CF83 1FA, CF83 1NN, CF83 1NQ, CF83 1NR, CF83 1NT, CF83 1TY",358,318,40
W00007459,CF8,"CF8 1NJ, CF8 1NL, CF8 1NP, CF83 1NJ, CF83 1NL, CF83 1NP, CF83 1RY, CF83 1RZ",292,252,40
W00007460,CF8,"CF8 1LA, CF8 1LD, CF8 1LF, CF8 1LG, CF8 1LH, CF8 1LJ, CF8 1PE, CF8 1UT, CF8 1WN, CF83 1LA, CF83 1LD, CF83 1LF, CF83 1LG, CF83 1LH, CF83 1LJ, CF83 1LQ, CF83 1NU, CF83 1NW, CF83 1PE, CF83 1PY, CF83 1UT, CF83 1WN",337,301,36
W00007498,CF8,"CF8 7BG, CF8 7BH, CF8 7BJ, CF8 7BL, CF82 7BG, CF82 7BH, CF82 7BJ, CF82 7BL, CF82 7DZ, CF82 7GS, CF82 7GT",308,263,45
W00007461,CF8,"CF8 1BT, CF8 1BU, CF8 1BX, CF8 1BZ, CF8 1DA, CF8 1DR, CF8 1DT, CF8 1WY, CF83 1BT, CF83 1BU, CF83 1BX, CF83 1BZ, CF83 1DA, CF83 1DR, CF83 1DT",256,231,25
W00007463,CF8,"CF8 1AA, CF8 1FL, CF8 1FP, CF8 1FQ, CF8 1FR, CF8 1FU, CF8 1FW, CF8 1GA, CF8 1GB, CF8 1GD, CF8 1GE, CF8 1GF, CF8 1JL, CF8 1JN, CF8 1JP, CF8 1NW, CF8 1NX, CF8 1UA, CF8 1UB, CF8 1UD, CF8 1UE, CF8 1UJ, CF8 1UL, CF8 1UN, CF8 1UQ, CF8 1UU, CF8 1UY, CF8 1WA, CF8 1WD, CF8 1WF, CF8 1WP, CF8 1XB, CF8 1XE, CF8 1XT, CF8 1XU, CF83 1AA, CF83 1FP, CF83 1FQ, CF83 1FR, CF83 1FU, CF83 1FW, CF83 1GA, CF83 1GB, CF83 1GD, CF83 1GE, CF83 1GF, CF83 1GQ, CF83 1JL, CF83 1JN, CF83 1JP, CF83 1NX, CF83 1UB, CF83 1UD, CF83 1UE, CF83 1UJ, CF83 1UN, CF83 1UQ, CF83 1UU, CF83 1WA, CF83 1WB, CF83 1WD, CF83 1WF, CF83 1WJ, CF83 1WS, CF83 1XA, CF83 1XE",310,275,35
W00007464,CF8,"CF8 1FX, CF8 1FY, CF8 1JQ, CF8 1JS, CF8 1JT, CF8 1JU, CF83 1FX, CF83 1FY, CF83 1JQ, CF83 1JR, CF83 1JS, CF83 1JT, CF83 1JU",329,303,26
W00007465,CF8,"CF8 1HU, CF8 1HW, CF8 1HX, CF8 1JW, CF8 1JX, CF8 1LE, CF8 1UX, CF8 3EL, CF83 1BG, CF83 1GR, CF83 1HU, CF83 1HW, CF83 1HX, CF83 1JW, CF83 1JX, CF83 1LE, CF83 1LL, CF83 1LN, CF83 1UG, CF83 3DA",340,298,42
W00007466,CF8,"CF8 1BY, CF8 1DE, CF8 1DH, CF8 1DJ, CF8 1DL, CF8 1DN, CF8 1DS, CF83 1BY, CF83 1DE, CF83 1DH, CF83 1DJ, CF83 1DL, CF83 1DN, CF83 1DS, CF83 1NA",301,272,29
W00007467,CF8,"CF8 1DW, CF8 1GN, CF8 1GP, CF8 1WJ, CF8 1XL, CF8 1XX, CF83 1DW, CF83 1GN, CF83 1GP, CF83 1XL, CF83 1XX, CF83 1XY",157,148,9
W00007489,CF8,"CF8 7BR, CF8 7BS, CF8 7BT, CF8 7BU, CF8 7BW, CF8 7BX, CF8 7EH, CF8 7WF, CF8 7WG, CF82 7BF, CF82 7BR, CF82 7BS, CF82 7BT, CF82 7BU, CF82 7BW, CF82 7BX, CF82 7EH, CF82 7FN, CF82 7FQ, CF82 7PG, CF82 7WA, CF82 7WF, CF82 7WG, CF82 7ZA, CF82 9YE, CF82 9YF, CF82 9YG, CF82 9YH, CF82 9YJ, CF82 9YL, CF82 9YN, CF82 9YP, CF82 9YQ, CF82 9YR, CF82 9YS, CF82 9YT, CF82 9YU, CF82 9YW, CF82 9YX, CF82 9YY, CF82 9YZ, CF82 9ZA, CF82 9ZB, CF82 9ZD, CF82 9ZE, CF82 9ZF, CF82 9ZG, CF82 9ZH, CF82 9ZJ, CF82 9ZL, CF82 9ZN, CF82 9ZP, CF82 9ZQ, CF82 9ZR, CF82 9ZS, CF82 9ZT, CF82 9ZU, CF82 9ZW, CF82 9ZX, CF82 9ZY",241,206,35
W00007490,CF8,"CF8 7AA, CF8 7AD, CF8 7AP, CF8 7AR, CF8 7AS, CF8 7AX, CF8 7DU, CF8 7DW, CF8 7DZ, CF8 7EE, CF8 7WH, CF8 7WJ, CF8 7WL, CF8 7WN, CF8 7WR, CF8 7WS, CF8 7WT, CF8 7XQ, CF82 7AA, CF82 7AD, CF82 7AP, CF82 7AR, CF82 7AS, CF82 7AX, CF82 7BB, CF82 7BE, CF82 7DU, CF82 7DW, CF82 7EE, CF82 7WS, CF82 7WT, CF82 7WU, CF82 7XA, CF82 7XQ",249,203,46
W00007491,CF8,"CF8 7BP, CF8 7BQ, CF8 7BY, CF8 7DB, CF8 7DD, CF8 7DE, CF8 7DS, CF8 7EG, CF82 7BP, CF82 7BQ, CF82 7BY, CF82 7DB, CF82 7DD, CF82 7DE, CF82 7DS, CF82 7EG",319,271,48
W00007492,CF8,"CF8 7BD, CF8 7BZ, CF8 7DA, CF8 7DF, CF82 7BD, CF82 7BZ, CF82 7DA, CF82 7DF",168,163,5
W00007493,CF8,"CF8 7AF, CF8 7DX, CF8 7DY, CF8 7EA, CF8 7EB, CF8 7EF, CF8 7EL, CF8 7EN, CF8 7WW, CF8 7WX, CF8 7XT, CF82 7AF, CF82 7DP, CF82 7DX, CF82 7DY, CF82 7EA, CF82 7EB, CF82 7EF, CF82 7EL, CF82 7EN, CF82 7WW, CF82 7WX, CF82 7XT",275,238,37
W00007494,CF8,"CF8 7DR, CF8 7DT, CF8 7EJ, CF8 7FA, CF8 7FB, CF82 7DR, CF82 7DT, CF82 7EJ, CF82 7FA, CF82 7FB",253,223,30
W00007495,CF8,"CF8 7EQ, CF8 7ER, CF8 7ES, CF8 7ET, CF8 7EU, CF8 7EW, CF8 7EX, CF8 7EY, CF8 7EZ, CF8 7XR, CF8 7XU, CF82 7EQ, CF82 7ER, CF82 7ES, CF82 7ET, CF82 7EU, CF82 7EW, CF82 7EX, CF82 7EY, CF82 7EZ, CF82 7SF, CF82 7WH, CF82 7XR, CF82 7XU",252,203,49
W00007462,CF8,"CF8 1HA, CF8 1HB, CF8 1JY, CF8 1JZ, CF8 1LB, CF8 1WR, CF83 1HA, CF83 1HB, CF83 1JY, CF83 1JZ, CF83 1LB, CF83 1WR",306,248,58
W00007188,CF8,"CF8 3FX, CF8 3FY, CF8 3FZ, CF8 3GA, CF8 3GB, CF83 3FX, CF83 3FY, CF83 3FZ, CF83 3GA, CF83 3GB",275,253,22
W00007161,CF8,"CF8 3PH, CF8 3PJ, CF8 3PL, CF8 3PN, CF8 3PP, CF83 3PH, CF83 3PJ, CF83 3PL, CF83 3PN, CF83 3PP",323,285,38
W00007186,CF8,"CF8 3HB, CF8 3JF, CF8 3JG, CF8 3SP, CF83 3HB, CF83 3JF, CF83 3JG",253,210,43
W00007160,CF8,"CF8 3PR, CF8 3PS, CF8 3PT, CF8 3PW, CF8 3PY, CF83 3PR, CF83 3PS, CF83 3PT, CF83 3PW, CF83 3PY",271,246,25
W00007159,CF8,"CF8 2AB, CF8 2AD, CF8 2AE, CF8 2NF, CF8 2NG, CF8 2NH, CF8 2NP, CF8 2US, CF8 2UT, CF8 2UU, CF8 2UW, CF8 2UX, CF83 2AB, CF83 2AD, CF83 2AE, CF83 2AF, CF83 2NF, CF83 2NG, CF83 2NH, CF83 2NP, CF83 2US, CF83 2UT, CF83 2UU, CF83 2UW, CF83 2UX, CF83 2UY, CF83 2UZ",339,294,45
W00007158,CF8,"CF8 2NJ, CF8 2NL, CF8 2NN, CF8 3HW, CF8 3HX, CF8 3RL, CF83 2NJ, CF83 2NL, CF83 2NN, CF83 3HW, CF83 3HX, CF83 3RL, CF83 3SA",316,274,42
W00007157,CF8,"CF8 2WQ, CF8 3NX, CF8 3NY, CF8 3PU, CF8 3QR, CF8 7SL, CF83 3GU, CF83 3HZ, CF83 3NX, CF83 3NY, CF83 3PU, CF83 3QR",443,385,58
W00007156,CF8,"CF8 3LA, CF8 3LD, CF8 3NB, CF8 3NF, CF8 3NG, CF83 3LA, CF83 3LD, CF83 3NB, CF83 3NF, CF83 3NG",230,213,17
W00007155,CF8,"CF8 3JX, CF8 3JZ, CF8 3LB, CF8 3LE, CF83 3JX, CF83 3JZ, CF83 3LB, CF83 3LE",292,275,17
W00007154,CF8,"CF8 3PD, CF8 3PF, CF8 3PG, CF83 3PD, CF83 3PF, CF83 3PG, CF83 3RQ, CF83 3WQ, CF83 3YZ",246,228,18
W00007153,CF8,"CF8 3JR, CF8 3JS, CF8 3JT, CF8 3JU, CF8 3JY, CF8 3QQ, CF83 3JR, CF83 3JS, CF83 3JT, CF83 3JU, CF83 3JY, CF83 3QQ, CF83 3SF",255,222,33
W00007448,CF8,"CF8 1EY, CF8 1LP, CF8 1LY, CF8 1LZ, CF8 1NA, CF8 1NE, CF8 1NF, CF8 1UW, CF83 1BD, CF83 1EY, CF83 1JA, CF83 1LP, CF83 1LX, CF83 1LY, CF83 1LZ, CF83 1NE, CF83 1SP, CF83 1SQ, CF83 1UW",377,320,57
W00007152,CF8,"CF8 7HU, CF8 7LD, CF8 7LF, CF8 7LN, CF8 7LU, CF8 7NE, CF8 7NF, CF8 7NG, CF8 7NJ, CF82 7HU, CF82 7LD, CF82 7LF, CF82 7LN, CF82 7NE, CF82 7NF, CF82 7NG, CF82 7RQ, CF82 7RU",446,395,51
W00007150,CF8,"CF8 7HB, CF8 7HE, CF8 7HF, CF8 7HN, CF8 7HW, CF8 7LH, CF8 7LL, CF8 7LP, CF8 8BE, CF82 7HB, CF82 7HE, CF82 7HF, CF82 7HN, CF82 7HW, CF82 7LH, CF82 7LL, CF82 7LP, CF82 7PA",333,301,32
W00007149,CF8,"CF8 7HG, CF8 7HS, CF8 7JW, CF8 7LJ, CF82 7HG, CF82 7HS, CF82 7JW, CF82 7LJ",281,257,24
W00007148,CF8,"CF8 7HL, CF8 7HQ, CF8 7HR, CF8 7HT, CF82 7HL, CF82 7HQ, CF82 7HR, CF82 7HT",303,276,27
W00007147,CF8,"CF8 7HX, CF8 7HY, CF8 7HZ, CF8 7JB, CF8 7JG, CF8 7XN, CF8 8SJ, CF82 7HX, CF82 7HY, CF82 7HZ, CF82 7JB, CF82 7JG, CF82 7TY, CF82 8BF, CF82 8SJ, NP2 1UG",448,394,54
W00007145,CF8,"CF8 7JA, CF8 7JD, CF8 7JE, CF8 7JF, CF82 7JA, CF82 7JD, CF82 7JE, CF82 7JF",333,300,33
W00007144,CF8,"CF8 7AG, CF8 7AH, CF8 7AY, CF8 7BA, CF8 7JJ, CF8 7NY, CF8 7WQ, CF82 7AG, CF82 7AH, CF82 7AY, CF82 7BA, CF82 7JJ, CF82 7NX, CF82 7NY, CF82 7WQ",266,237,29
W00007143,CF8,"CF8 7LG, CF8 7LX, CF8 7LY, CF8 7NA, CF8 7NB, CF8 7ND, CF8 7RD, CF82 7LG, CF82 7LX, CF82 7LY, CF82 7NA, CF82 7NB, CF82 7ND, CF82 7RD, CF82 7RW, CF82 7SG",310,272,38
W00007142,CF8,"CF8 7LW, CF8 7NP, CF8 7NQ, CF8 7WY, CF8 7YA, CF8 7YD, CF8 7YF, CF8 7YG, CF8 7YJ, CF8 7YN, CF8 7YP, CF82 7LT, CF82 7LW, CF82 7NP, CF82 7NQ, CF82 7PB, CF82 7YF",248,216,32
W00007151,CF8,"CF8 7JX, CF8 7JY, CF8 7JZ, CF8 7LA, CF8 7LB, CF8 7LE, CF82 7JX, CF82 7JY, CF82 7JZ, CF82 7LA, CF82 7LB, CF82 7LE, CF82 7RS, CF82 7RT",385,340,45
W00007162,CF8,"CF8 3NL, CF8 3NU, CF8 3NW, CF8 3PB, CF83 3NU, CF83 3NW, CF83 3PB",232,221,11
W00007163,CF8,"CF8 3NT, CF8 3NZ, CF8 3PA, CF8 3PE, CF8 3PQ, CF83 3NT, CF83 3NZ, CF83 3PA, CF83 3PE, CF83 3PQ, CF83 3RW",250,233,17
W00007164,CF8,"CF8 3LY, CF8 3LZ, CF8 3NA, CF8 3NS, CF8 3QS, CF8 3QT, CF83 3LY, CF83 3LZ, CF83 3NA, CF83 3NS, CF83 3QS, CF83 3QT, CF83 3RX, CF83 3TA, CF83 3TE",322,273,49
W00007185,CF8,"CF8 3ES, CF8 3HR, CF8 3HS, CF8 3JN, CF83 3ES, CF83 3HR, CF83 3HS, CF83 3JN",263,234,29
W00007184,CF8,"CF8 2XS, CF8 2XT, CF8 3EZ, CF8 3GD, CF8 3HN, CF8 3RA, CF8 3RF, CF8 3SX, CF83 2XT, CF83 3EZ, CF83 3GD, CF83 3HN, CF83 3RA, CF83 3RF, CF83 3SX",257,229,28
W00007183,CF8,"CF8 3EY, CF8 3JP, CF8 3JW, CF8 3PX, CF8 3QU, CF83 3EY, CF83 3JP, CF83 3JW, CF83 3PX, CF83 3QU",248,220,28
W00007182,CF8,"CF8 3JJ, CF8 3JL, CF8 3NJ, CF8 3QW, CF8 3QX, CF83 3JJ, CF83 3JL, CF83 3NJ, CF83 3QW, CF83 3QX",227,203,24
W00007181,CF8,"CF8 3ER, CF8 3JH, CF8 3QY, CF8 3QZ, CF83 3ER, CF83 3GE, CF83 3JH, CF83 3QY, CF83 3QZ",282,239,43
W00007179,CF8,"CF8 1AN, CF8 1AQ, CF8 1AR, CF8 1AS, CF8 1AT, CF83 1AN, CF83 1AQ, CF83 1AR, CF83 1AS, CF83 1AT",281,256,25
W00007178,CF8,"CF8 1AD, CF8 1AE, CF8 1AF, CF8 1AG, CF8 1AH, CF8 1AJ, CF8 1WH, CF8 1XN, CF83 1AD, CF83 1AE, CF83 1AF, CF83 1AG, CF83 1AH, CF83 1AJ, CF83 1WH",254,229,25
W00007177,CF8,"CF8 1AU, CF8 1AW, CF8 1AX, CF8 1AY, CF8 1AZ, CF8 1BA, CF83 1AU, CF83 1AW, CF83 1AX, CF83 1AY, CF83 1AZ, CF83 1BA",288,261,27
W00007176,CF8,"CF8 1UF, CF8 3AZ, CF8 3BA, CF8 3BH, CF8 3BN, CF83 1UF, CF83 3AZ, CF83 3BA, CF83 3BH, CF83 3BN, CF83 3GX, CF83 3NL, CF83 3XG, CF83 3XN, CF83 3XP, CF83 3YD, CF83 3YE, CF83 3YN, CF83 3YP, CF83 3YY",251,209,42
W00007175,CF8,"CF8 3AR, CF8 3AW, CF8 3BL, CF8 3BP, CF8 3BQ, CF8 3SZ, CF83 3AR, CF83 3AW, CF83 3BL, CF83 3BP, CF83 3BQ, CF83 3GJ",245,211,34
W00007293,CF8,"CF8 2JX, CF8 2NB, CF8 2NE, CF8 2NS, CF8 2NT, CF8 2NZ, CF8 2TT, CF8 2TZ, CF83 2JX, CF83 2LN, CF83 2NB, CF83 2NS, CF83 2NT, CF83 2NZ, CF83 2TT, CF83 2TZ",465,400,65
W00007173,CF8,"CF8 7PA, CF8 7PF, CF8 7PX, CF8 7PY, CF8 7QD, CF8 7QE, CF82 7PF, CF82 7PX, CF82 7PY, CF82 7QD, CF82 7QE",220,201,19
W00007172,CF8,"CF8 7PP, CF8 7PR, CF8 7PU, CF8 7PW, CF8 7QF, CF8 7QG, CF8 7QH, CF8 7SB, CF82 7PP, CF82 7PR, CF82 7PU, CF82 7PW, CF82 7QF, CF82 7QG, CF82 7QH, CF82 7SB",328,305,23
W00007171,CF8,"CF8 7QJ, CF8 7QL, CF8 7QT, CF8 7QU, CF82 7QJ, CF82 7QL, CF82 7QT, CF82 7QU",233,213,20
W00007169,CF8,"CF8 7PH, CF8 7PJ, CF8 7PL, CF8 7PN, CF8 7QN, CF8 7RF, CF8 7RH, CF8 7RP, CF8 7RS, CF8 7RX, CF8 7RY, CF8 7RZ, CF8 7SA, CF82 7GX, CF82 7PE, CF82 7PH, CF82 7PJ, CF82 7PL, CF82 7PN, CF82 7QN, CF82 7RF, CF82 7RH, CF82 7RP, CF82 7RX, CF82 7RY, CF82 7RZ, CF82 7SA, NP2 2QH",275,248,27
W00007168,CF8,"CF8 7ED, CF8 7QQ, CF8 7QR, CF8 7QS, CF8 7RJ, CF8 7SN, CF8 7SP, CF8 7SQ, CF81 8ZY, CF81 9YB, CF81 9YD, CF81 9YE, CF81 9YG, CF81 9YL, CF81 9YQ, CF82 7ED, CF82 7QQ, CF82 7QR, CF82 7QS, CF82 7RB, CF82 7RJ, CF82 7SN, CF82 7SP, CF82 7SQ, CF82 7SY, CF82 7SZ, CF82 7TR, CF82 7TS, CF82 7TT, CF82 7TW, CF82 7TX, CF82 7TZ, CF82 7UA, CF82 7UB, CF82 7WZ, CF82 7YA, CF82 7YD, CF82 7YH, CF82 7YL, CF82 7YP, CF82 7YR, CF82 7YY, CF82 7ZR, CF82 7ZS, CF82 7ZX, CF82 8YN, CF82 8YQ, CF82 8ZX, CF82 9AA, CF82 9AB, CF82 9AD, CF82 9AE, CF82 9AF, CF82 9AG, CF82 9AH, CF82 9AJ, CF82 9AL, CF82 9AN, CF82 9AP, CF82 9AQ, CF82 9AR, CF82 9AS, CF82 9AT, CF82 9AU, CF82 9AW, CF82 9AX, CF82 9AY, CF82 9AZ, CF82 9BA, CF82 9BB, CF82 9BD, CF82 9BE, CF82 9BF, CF82 9BG, CF82 9BH, CF82 9BJ, CF82 9BL, CF82 9BN, CF82 9BP, CF82 9BQ, CF82 9BR, CF82 9BS, CF82 9BT, CF82 9BU, CF82 9BW, CF82 9BX, CF82 9BY, CF82 9DA, CF82 9DB, CF82 9DD, CF82 9ZZ",392,347,45
W00007167,CF8,"CF8 3JE, CF8 3LG, CF8 3NE, CF8 3TG, CF83 3GN, CF83 3JE, CF83 3LG, CF83 3NE, CF83 3SH",212,193,19
W00007166,CF8,"CF8 2XF, CF8 3LF, CF8 3LH, CF8 3LJ, CF8 3LN, CF8 3LP, CF8 3LQ, CF8 3LR, CF83 3LF, CF83 3LH, CF83 3LJ, CF83 3LN, CF83 3LP, CF83 3LQ, CF83 3LR",294,263,31
W00007165,CF8,"CF8 3LL, CF8 3LS, CF8 3LT, CF8 3LU, CF8 3LW, CF8 3LX, CF8 3ND, CF8 3NQ, CF8 3NR, CF8 3YB, CF8 3YD, CF8 3YE, CF8 3YF, CF8 3YH, CF8 3YL, CF83 3LL, CF83 3LS, CF83 3LT, CF83 3LU, CF83 3LW, CF83 3LX, CF83 3ND, CF83 3NQ, CF83 3NR, CF83 3SZ",311,286,25
W00007187,CF8,"CF8 2WS, CF8 2WT, CF8 2WU, CF8 3BB, CF8 3BD, CF8 3BE, CF8 3BG, CF8 3HF, CF8 3SW, CF83 3BB, CF83 3BD, CF83 3BE, CF83 3BG, CF83 3GH, CF83 3HF, CF83 3RY, CF83 3SU, CF83 3SW, CF83 3TF",536,429,107
W00007447,CF8,"CF8 1BP, CF8 1FN, CF8 1FT, CF8 1FZ, CF8 1GG, CF8 1GH, CF8 1GJ, CF8 1GL, CF8 1GQ, CF8 1UH, CF8 1UZ, CF8 1WE, CF8 1WT, CF8 1WW, CF8 1XA, CF8 1YA, CF8 1YB, CF8 2WY, CF8 2XD, CF83 1FN, CF83 1FZ, CF83 1GG, CF83 1GH, CF83 1GJ, CF83 1GL, CF83 1UZ, CF83 1WE, CF83 1WT, CF83 1XD, CF83 1XF, CF83 1YD, CF83 1YE, CF83 1YF, CF83 1YT, CF83 1YW, CF83 2WY, CF83 2XB, CF83 2XD",264,215,49
W00007358,CF8,"CF8 9PR, CF8 9PX, CF8 9QA, CF8 9QL, CF8 9QN, CF8 9QQ, CF8 9QW, CF81 9PR, CF81 9PX, CF81 9PY, CF81 9PZ, CF81 9QA, CF81 9QF, CF81 9QL, CF81 9QN, CF81 9QQ",271,253,18
W00007444,CF8,"CF8 1BR, CF8 1BS, CF8 1DB, CF8 1DD, CF8 1DF, CF8 1DG, CF83 1BR, CF83 1BS, CF83 1DB, CF83 1DD, CF83 1DF, CF83 1DG",242,226,16
W00007318,CF8,"CF8 2QG, CF8 2QJ, CF8 2QL, CF8 2QN, CF8 2RS, CF83 2QG, CF83 2QJ, CF83 2QL, CF83 2QN, CF83 2RS",276,248,28
W00007319,CF8,"CF8 2QE, CF8 2QF, CF8 2SY, CF8 2TB, CF83 2QE, CF83 2QF, CF83 2SY, CF83 2TB",244,211,33
W00007322,CF8,"CF8 2EX, CF8 2LA, CF83 2EX, CF83 2LA, CF83 2NE, CF83 2NU, CF83 2NW",486,398,88
W00007323,CF8,"CF8 2BY, CF8 2BZ, CF8 2EU, CF83 2BY, CF83 2BZ, CF83 2EU",230,199,31
W00007324,CF8,"CF8 2JF, CF8 2JY, CF8 2LD, CF8 2LE, CF8 2NY, CF83 2JY, CF83 2LD, CF83 2LE, CF83 2NY",271,245,26
W00007325,CF8,"CF8 2AA, CF8 2AL, CF8 2AN, CF8 2BW, CF8 2BX, CF8 2TW, CF83 2AA, CF83 2AL, CF83 2AN, CF83 2BP, CF83 2BW, CF83 2BX, CF83 2TW",263,239,24
W00007326,CF8,"CF8 2JW, CF8 2JZ, CF8 2LB, CF8 2PE, CF8 2PF, CF8 2WA, CF83 2JW, CF83 2JZ, CF83 2LB, CF83 2PE, CF83 2PF",305,266,39
W00007327,CF8,"CF8 2JH, CF8 2JL, CF8 2JN, CF8 2NA, CF8 2PD, CF83 2JH, CF83 2JL, CF83 2JN, CF83 2NA, CF83 2PD",318,285,33
W00007299,CF8,"CF8 2LY, CF8 2LZ, CF8 2ND, CF8 2NR, CF83 2LY, CF83 2LZ, CF83 2ND, CF83 2NR",299,234,65
W00007298,CF8,"CF8 2ET, CF8 2JJ, CF8 2JS, CF8 2JU, CF83 2ET, CF83 2JJ, CF83 2JS, CF83 2JU",282,245,37
W00007297,CF8,"CF8 2JQ, CF8 2JR, CF8 2PA, CF8 2PB, CF8 2PJ, CF8 2PN, CF83 2JQ, CF83 2JR, CF83 2PA, CF83 2PB, CF83 2PJ, CF83 2PN",339,314,25
W00007296,CF8,"CF8 2AH, CF8 2AJ, CF8 2AP, CF8 2BT, CF8 2BU, CF8 2JP, CF8 2JT, CF83 2AH, CF83 2AJ, CF83 2AP, CF83 2BT, CF83 2BU, CF83 2JG, CF83 2JP, CF83 2JT, CF83 2XZ",272,227,45
W00007295,CF8,"CF8 2RB, CF8 2RL, CF8 2TF, CF8 2TG, CF8 2TX, CF8 2TY, CF8 2UB, CF8 2UP, CF83 2BL, CF83 2RJ, CF83 2TF, CF83 2TG, CF83 2TX, CF83 2TY, CF83 2UB, CF83 2UP",392,357,35
W00007355,CF8,"CF8 9RL, CF8 9RN, CF8 9RP, CF8 9RS, CF8 9RT, CF8 9RU, CF81 9RL, CF81 9RN, CF81 9RP, CF81 9RS, CF81 9RT, CF81 9RU",255,233,22
W00007356,CF8,"CF8 9PD, CF8 9PF, CF8 9PH, CF8 9PJ, CF8 9PL, CF8 9PN, CF8 9PP, CF8 9PQ, CF8 9PT, CF8 9PU, CF8 9PW, CF8 9QB, CF8 9QD, CF8 9QT, CF8 9UF, CF8 9UG, CF8 9UL, CF81 9PA, CF81 9PD, CF81 9PF, CF81 9PH, CF81 9PJ, CF81 9PL, CF81 9PN, CF81 9PP, CF81 9PQ, CF81 9PT, CF81 9PU, CF81 9PW, CF81 9QB, CF81 9QD, CF81 9QT, CF81 9QZ, NP2 5LT, NP2 5LW, NP2 5RN, NP2 5XQ, NP22 5BL, NP22 5BR, NP22 5LW, NP22 5PT",315,274,41
W00007357,CF8,"CF8 9QE, CF8 9QG, CF8 9QX, CF8 9QY, CF8 9QZ, CF8 9RA, CF8 9RB, CF8 9RD, CF8 9RE, CF8 9RF, CF8 9RG, CF81 9PS, CF81 9QE, CF81 9QG, CF81 9QW, CF81 9QX, CF81 9QY, CF81 9RA, CF81 9RB, CF81 9RD, CF81 9RE, CF81 9RF, CF81 9RG",275,252,23
W00007141,CF8,"CF8 7JL, CF8 7JN, CF8 7JP, CF8 7JQ, CF8 7NW, CF8 7NX, CF8 7SR, CF8 7WE, CF8 7XP, CF8 7XW, CF8 7YB, CF8 7YE, CF8 7YH, CF8 7YL, CF81 8YL, CF81 9YF, CF81 9YH, CF81 9YJ, CF81 9YP, CF81 9YR, CF82 7JL, CF82 7JN, CF82 7JP, CF82 7JQ, CF82 7NW, CF82 7SR, CF82 7WE, CF82 7XP, CF82 7YB, CF82 7YE, CF82 7YG, CF82 7YJ, CF82 7YN, CF82 7YQ, CF82 7YS, CF82 7YU, CF82 7YW, CF82 7YX, CF82 8YE, CF82 8YF, CF82 8YP",292,262,30
W00007316,CF8,"CF8 2SA, CF8 2SE, CF8 2SZ, CF8 2TD, CF8 2TE, CF83 2SA, CF83 2SE, CF83 2SZ, CF83 2TD, CF83 2TE",266,242,24
W00007315,CF8,"CF8 2QP, CF83 2BE, CF83 2BF, CF83 2BG, CF83 2QP",266,223,43
W00007314,CF8,"CF8 2RZ, CF8 2SB, CF8 2SG, CF8 2SN, CF83 1BP, CF83 1UH, CF83 1WL, CF83 1WP, CF83 1WU, CF83 1WW, CF83 1WX, CF83 1WY, CF83 1WZ, CF83 1XB, CF83 1XQ, CF83 1XR, CF83 1XT, CF83 1XU, CF83 1XW, CF83 1XZ, CF83 1YA, CF83 1YB, CF83 1YG, CF83 1YH, CF83 1YJ, CF83 1YL, CF83 1YN, CF83 1YP, CF83 1YQ, CF83 1YR, CF83 1YS, CF83 1YU, CF83 1YX, CF83 1YZ, CF83 1ZF, CF83 1ZQ, CF83 1ZR, CF83 2RZ, CF83 2SB, CF83 2SG, CF83 2SN, CF83 2XA, CF83 2XE, CF83 2XF, CF83 2XG, CF83 2XH, CF83 2XL, CF83 2XQ, CF83 2XU, CF83 2XX, CF83 2YA, CF83 2YB, CF83 2YD, CF83 2YE, CF83 2YG, CF83 2YH, CF83 2YL, CF83 2YN, CF83 2YP, CF83 2YQ, CF83 2YR, CF83 2YS, CF83 2YT, CF83 2YU, CF83 2YW, CF83 2YX, CF83 2YY, CF83 2YZ, CF83 2ZW, CF83 2ZX, CF83 2ZY, CF83 3XA, CF83 3XB, CF83 3XD, CF83 3XE, CF83 3XH, CF83 3XL, CF83 3XQ, CF83 3XR, CF83 3XS, CF83 3XT, CF83 3XU, CF83 3YA, CF83 3YJ, CF83 3YQ, CF83 3YT, CF83 3YU, CF83 3YX, CF83 3ZQ, CF83 4YB, CF83 4YG, CF83 8WR, CF83 8WY, CF83 8WZ, CF83 8XU, CF83 8XZ, CF83 8YF, CF83 8YH, CF83 8YJ, CF83 8YR, CF83 8YS, CF83 8YT, CF83 8YU, CF83 8YW, CF83 8ZD, CF83 8ZR, CF83 9AA, CF83 9AB, CF83 9AD, CF83 9AE, CF83 9AF, CF83 9AG, CF83 9AH, CF83 9AJ, CF83 9AL, CF83 9AN, CF83 9AP, CF83 9AQ, CF83 9AR, CF83 9AS, CF83 9AT, CF83 9AU, CF83 9AX, CF83 9AY, CF83 9AZ, CF83 9BA, CF83 9BB, CF83 9BD, CF83 9BE, CF83 9BF, CF83 9BG, CF83 9BH, CF83 9BJ, CF83 9BL, CF83 9BN, CF83 9BP, CF83 9BQ, CF83 9BR, CF83 9BS, CF83 9BT, CF83 9BU, CF83 9BW, CF83 9BX, CF83 9BY, CF83 9BZ, CF83 9DA, CF83 9DB, CF83 9DD, CF83 9DE, CF83 9DF, CF83 9DG, CF83 9DH, CF83 9DJ, CF83 9DL, CF83 9DN, CF83 9DP, CF83 9DQ, CF83 9DR, CF83 9DS, CF83 9DT, CF83 9DU, CF83 9DW, CF83 9DX, CF83 9DY, CF83 9DZ, CF83 9EA, CF83 9EB, CF83 9ED, CF83 9EE, CF83 9EF, CF83 9EG, CF83 9EH, CF83 9EJ, CF83 9EN, CF83 9EP, CF83 9EQ, CF83 9ER, CF83 9ES, CF83 9ET, CF83 9EU, CF83 9EW, CF83 9EX, CF83 9EY, CF83 9EZ, CF83 9FA, CF83 9FB, CF83 9FD, CF83 9FE, CF83 9FF, CF83 9FG, CF83 9FH, CF83 9FJ, CF83 9FL, CF83 9FN, CF83 9FP, CF83 9FQ, CF83 9FR, CF83 9FS, CF83 9FT, CF83 9FU, CF83 9FW, CF83 9FX, CF83 9FY, CF83 9FZ, CF83 9GA, CF83 9GB, CF83 9GD, CF83 9GE, CF83 9GF, CF83 9GG, CF83 9GH, CF83 9GJ, CF83 9GL, CF83 9GN, CF83 9ZZ",278,247,31
W00007313,CF8,"CF8 2SD, CF8 2SP, CF8 2SQ, CF8 2SR, CF8 2XR, CF83 2LH, CF83 2LP, CF83 2LQ, CF83 2SD, CF83 2SP, CF83 2SQ, CF83 2SR",258,234,24
W00007292,CF8,"CF8 2QB, CF8 2QD, CF8 2QH, CF8 2RT, CF83 2QB, CF83 2QD, CF83 2QH, CF83 2RT",249,227,22
W00010298,CF8,"CF8 1XF, CF8 2WG, CF8 2WH, CF8 2WJ, CF8 2WL, CF8 2XE, CF8 2YA, CF8 2YF, CF8 2YG, CF8 2YH, CF8 2YL, CF8 2YN, CF8 2YP, CF8 2YT, CF8 2YY, CF8 3RB, CF8 3RD, CF8 3RE, CF8 3RG, CF8 3RH, CF8 3RJ, CF8 3RN, CF8 3SQ, CF8 3SR, CF8 3SS, CF8 3SU, CF8 3TA, CF8 3TF, CF83 2WG, CF83 2WL, CF83 3HU, CF83 3RB, CF83 3RD, CF83 3RE, CF83 3RG, CF83 3RH, CF83 3RJ",162,150,12
W00010297,CF8,"CF8 1UG, CF8 3AU, CF8 3SN, CF83 3AU, CF83 3RT, CF83 3RU, CF83 3SD, CF83 3SN, CF83 3WZ",490,383,107
W00010292,CF8,"CF8 3AN, CF8 3AQ, CF8 3HE, CF8 3JA, CF8 3JD, CF8 3ST, CF83 3AN, CF83 3AQ, CF83 3BF, CF83 3HE, CF83 3JA, CF83 3JD",148,129,19
W00010285,CF8,"CF8 7RE, CF8 7RG, CF82 7RE, CF82 7RG, CF82 7SE, NP12 2EU, NP12 2QA, NP12 2QU, NP12 2QW, NP12 2QX, NP12 2QY, NP12 2QZ, NP12 2RD, NP12 2RE, NP12 2RG, NP2 2QA, NP2 2QF, NP2 2QL, NP2 2XU, NP2 2XZ",307,258,49
W00010283,CF8,"CF8 7RL, CF8 7RN, CF8 7RR, CF8 7SH, CF82 7RL, CF82 7RN, CF82 7RR, CF82 7SD, CF82 7SH, NP12 2RB, NP2 2RA",281,251,30
W00007300,CF8,"CF8 2PG, CF8 2PH, CF8 2PL, CF8 2PP, CF8 2PQ, CF8 2PU, CF8 2PX, CF8 2QA, CF83 2PG, CF83 2PH, CF83 2PL, CF83 2PP, CF83 2PQ, CF83 2PU, CF83 2PX, CF83 2QA, CF83 2WH, CF83 2WP",389,342,47
W00007301,CF8,"CF8 2LT, CF8 2LU, CF8 2LX, CF8 2NQ, CF8 2PR, CF83 2LT, CF83 2LU, CF83 2LX, CF83 2NQ, CF83 2PR, CF83 2TP",274,236,38
W00007359,CF8,"CF8 9QH, CF8 9QJ, CF8 9QP, CF8 9QR, CF8 9QS, CF81 9QH, CF81 9QJ, CF81 9QP, CF81 9QR, CF81 9QS, CF81 9QU",374,349,25
W00007302,CF8,"CF8 2LF, CF8 2NX, CF8 2PW, CF8 2PY, CF8 2PZ, CF8 2QZ, CF8 2RD, CF8 2YB, CF8 2YD, CF8 2YJ, CF8 2YQ, CF8 2YR, CF8 2YS, CF8 2YU, CF8 2YW, CF8 2YX, CF8 3SJ, CF83 2NX, CF83 2PW, CF83 2PY, CF83 2PZ, CF83 2QZ, CF83 2RD, CF83 2YJ",235,222,13
W00007304,CF8,"CF8 2UF, CF8 2UJ, CF8 2UL, CF8 2UQ, CF8 2UR, CF83 2UF, CF83 2UJ, CF83 2UL, CF83 2UQ, CF83 2UR, CF83 2WA, CF83 2WB, CF83 2WD, CF83 2WE",247,219,28
W00007305,CF8,"CF8 2RA, CF8 2RE, CF8 2RF, CF8 2RN, CF8 2RP, CF8 2TS, CF83 2FR, CF83 2RA, CF83 2RE, CF83 2RF, CF83 2RN, CF83 2RP, CF83 2TS, CF83 2YF",242,218,24
W00007306,CF8,"CF8 2QQ, CF8 2QR, CF8 2QS, CF8 2QT, CF8 2QW, CF8 2XJ, CF83 2QQ, CF83 2QR, CF83 2QS, CF83 2QT, CF83 2QW",277,241,36
W00007308,CF8,"CF8 2TN, CF8 2UH, CF8 2UN, CF83 2TN, CF83 2UH, CF83 2UN",278,238,40
W00007309,CF8,"CF8 2TL, CF8 2TQ, CF8 2TR, CF8 2UE, CF8 2UG, CF83 2TL, CF83 2TQ, CF83 2TR, CF83 2UE, CF83 2UG",340,300,40
W00007310,CF8,"CF8 2SF, CF8 2ST, CF8 2SU, CF8 2SW, CF8 2SX, CF83 2SF, CF83 2ST, CF83 2SU, CF83 2SW, CF83 2SX",254,233,21
W00007311,CF8,"CF8 2RY, CF8 2SH, CF8 2SJ, CF8 2SL, CF8 2SS, CF83 2RY, CF83 2SH, CF83 2SJ, CF83 2SL, CF83 2SS",208,193,15
W00007312,CF8,"CF8 1XQ, CF8 2RU, CF8 2RW, CF8 2RX, CF8 2TA, CF83 2RU, CF83 2RW, CF83 2RX, CF83 2TA",186,180,6
W00007303,CF8,"CF8 2RG, CF8 2RH, CF8 2RQ, CF8 2RR, CF8 2TH, CF8 2TJ, CF83 2RG, CF83 2RH, CF83 2RQ, CF83 2RR, CF83 2TH, CF83 2TJ, CF83 2UA, CF83 2UD",299,248,51
W00007360,CF8,"CF8 9RH, CF8 9RJ, CF8 9RQ, CF8 9RR, CF81 9RH, CF81 9RJ, CF81 9RQ, CF81 9RR",288,266,22
W00007400,CF8,"CF8 7TA, CF8 7TD, CF8 7TE, CF8 7TF, CF8 7TG, CF8 7TP, CF8 8AW, CF8 8AX, CF8 8AY, CF82 7TA, CF82 7TD, CF82 7TE, CF82 7TF, CF82 7TG, CF82 7TP, CF82 8AW, CF82 8AY, NP2 1XX",315,267,48
W00007402,CF8,"CF8 7TB, CF8 8BS, CF82 7TB, CF82 7TH, CF82 7TJ, CF82 8BS, CF82 8LA",348,282,66
W00007426,CF8,"CF8 3DR, CF8 3EA, CF8 3EF, CF8 3EG, CF8 3EJ, CF8 3EN, CF83 3DR, CF83 3EA, CF83 3EF, CF83 3EG, CF83 3EJ, CF83 3EN, CF83 3JQ, CF83 8LY, CF83 8NJ, CF83 8NL, CF83 8NP, CF83 8NR, CF83 8NT, CF83 8PB, CF83 8PN, CF83 8YN, NP1 8NJ, NP1 8NL, NP1 8NN, NP1 8NP, NP1 8NR, NP1 8NS, NP1 8NT, NP1 8NX, NP1 8PB, NP1 8YL, NP1 8YN, NP10 8GJ",376,323,53
W00007427,CF8,"CF8 3BJ, CF8 3BZ, CF8 3DT, CF8 3DU, CF8 3DW, CF8 3DX, CF8 3ET, CF8 3EU, CF8 3EX, CF8 3NN, CF8 3NP, CF83 3BJ, CF83 3BZ, CF83 3DT, CF83 3DU, CF83 3DW, CF83 3DX, CF83 3ET, CF83 3EU, CF83 3EX, CF83 3NN, CF83 3NP, CF83 3RZ, NP1 8DY, NP1 8DZ",352,309,43
W00007428,CF8,"CF8 3AY, CF8 3BX, CF8 3QB, CF8 3QE, CF8 3QF, CF8 3QG, CF83 3AY, CF83 3BX, CF83 3QB, CF83 3QE, CF83 3QF, CF83 3QG",314,271,43
W00007429,CF8,"CF8 3BY, CF8 3QH, CF8 3QJ, CF8 3QL, CF8 3QN, CF8 3QP, CF83 3BY, CF83 3QH, CF83 3QJ, CF83 3QL, CF83 3QN, CF83 3QP",408,360,48
W00007430,CF8,"CF8 3BR, CF8 3BS, CF8 3PZ, CF83 3BR, CF83 3BS, CF83 3PZ",268,243,25
W00007431,CF8,"CF8 3BT, CF8 3BU, CF8 3BW, CF8 3QA, CF8 3QD, CF83 3BT, CF83 3BU, CF83 3BW, CF83 3QA, CF83 3QD",244,207,37
W00007432,CF8,"CF8 1RR, CF8 1RS, CF8 1RT, CF83 1RR, CF83 1RS, CF83 1RT, CF83 3GT",213,201,12
W00007433,CF8,"CF8 1QH, CF8 1RA, CF8 1RW, CF8 1RX, CF8 3DG, CF8 3DJ, CF83 1QH, CF83 1RA, CF83 1RW, CF83 1RX, CF83 3DG, CF83 3DJ, CF83 3RN, CF83 3RR",276,254,22
W00007424,CF8,"CF8 3DF, CF8 3DH, CF8 3DL, CF8 3DN, CF8 3DP, CF8 3DQ, CF8 3DS, CF8 3EH, CF8 3EP, CF83 3DF, CF83 3DH, CF83 3DL, CF83 3DN, CF83 3DP, CF83 3DQ, CF83 3DS, CF83 3EH, CF83 3EP, CF83 8NN, CF83 8NQ",273,240,33
W00007434,CF8,"CF8 1QP, CF8 1QQ, CF8 1QS, CF8 1RU, CF83 1QP, CF83 1QQ, CF83 1QS, CF83 1RU",265,250,15
W00007436,CF8,"CF8 1QN, CF8 1RG, CF8 1RJ, CF8 1RL, CF83 1QN, CF83 1RG, CF83 1RJ, CF83 1RL",274,239,35
W00007437,CF8,"CF8 1QR, CF8 1RE, CF8 1RH, CF8 1TY, CF83 1QR, CF83 1RE, CF83 1RH",235,214,21
W00007438,CF8,"CF8 1QJ, CF8 1QL, CF8 1RN, CF8 1RP, CF8 1RQ, CF83 1QJ, CF83 1QL, CF83 1RN, CF83 1RP, CF83 1RQ",254,231,23
W00007439,CF8,"CF8 1QU, CF8 1RB, CF8 1RD, CF8 1RF, CF83 1QU, CF83 1RB, CF83 1RD, CF83 1RF",237,220,17
W00007440,CF8,"CF8 1PF, CF8 1PG, CF8 1PJ, CF8 1PP, CF8 1PX, CF8 1PY, CF8 1PZ, CF83 1PF, CF83 1PG, CF83 1PJ, CF83 1PP, CF83 1PX",206,186,20
W00007441,CF8,"CF8 1PH, CF8 1PL, CF8 1PQ, CF8 1PR, CF83 1PH, CF83 1PL, CF83 1PQ, CF83 1PR",207,185,22
W00007442,CF8,"CF8 1PN, CF8 1PS, CF8 1PT, CF8 1PU, CF8 1PW, CF83 1PN, CF83 1PS, CF83 1PT, CF83 1PU, CF83 1PW",244,222,22
W00007443,CF8,"CF8 1UP, CF8 3DA, CF8 3DB, CF8 3ED, CF8 3EE, CF8 3EQ, CF83 3DB, CF83 3ED, CF83 3EE, CF83 3EL, CF83 3EQ, CF83 3GG, CF83 3GP, CF83 3GQ, CF83 3GR, CF83 3GS, CF83 3GW, CF83 3SG",192,173,19
W00007435,CF8,"CF8 1QT, CF8 1QW, CF8 1QX, CF8 1QY, CF8 1QZ, CF83 1QT, CF83 1QW, CF83 1QX, CF83 1QY, CF83 1QZ",265,247,18
W00007446,CF8,"CF8 1DU, CF8 1ED, CF8 1EF, CF8 1EG, CF8 1EJ, CF8 1EP, CF8 1EQ, CF8 1FS, CF8 2XB, CF83 1DU, CF83 1ED, CF83 1EF, CF83 1EG, CF83 1EJ, CF83 1EP, CF83 1EQ",311,263,48
W00007423,CF8,"CF8 8DJ, CF8 8DL, CF8 8DN, CF8 8HE, CF8 8HF, CF8 8HG, CF82 8DJ, CF82 8DL, CF82 8DN, CF82 8HE, CF82 8HF, CF82 8HG",265,240,25
W00007421,CF8,"CF8 8BT, CF8 8BX, CF8 8DF, CF8 8DG, CF8 8DH, CF82 8BT, CF82 8BX, CF82 8DF, CF82 8DG, CF82 8DH, CF82 8GA",256,229,27
W00007404,CF8,"CF8 8BP, CF8 8DP, CF8 8DQ, CF8 8DR, CF8 8HA, CF8 8HB, CF8 8HD, CF82 8BP, CF82 8DP, CF82 8DQ, CF82 8DR, CF82 8HA, CF82 8HB, CF82 8HD",295,259,36
W00007405,CF8,"CF8 8BH, CF8 8BL, CF8 8HP, CF8 8HR, CF8 8HS, CF8 8HT, CF82 8BL, CF82 8GD, CF82 8HP, CF82 8HR, CF82 8HS, CF82 8HT",289,259,30
W00010280,CF8,"CF8 7LQ, CF8 7LR, CF8 8FL, CF82 6BB, CF82 6BD, CF82 6BE, CF82 6BF, CF82 6BG, CF82 6BH, CF82 7DQ, CF82 7LQ, CF82 7LR, CF82 8FL",495,403,92
W00007406,CF8,"CF8 7TL, CF8 8BG, CF8 8BQ, CF8 8BW, CF8 8BY, CF8 8BZ, CF82 7TL, CF82 8BQ, CF82 8BW, CF82 8BY, CF82 8BZ",283,250,33
W00007407,CF8,"CF8 7TN, CF8 7TQ, CF8 8BR, CF8 8HH, CF8 8HJ, CF8 8HN, CF82 7TN, CF82 7TQ, CF82 8BR, CF82 8HH, CF82 8HJ, CF82 8HN",246,227,19
W00007408,CF8,"CF8 8BJ, CF8 8FF, CF8 8FH, CF8 8HL, CF8 8HQ, CF8 8HU, CF8 8HZ, CF82 8BJ, CF82 8FF, CF82 8FG, CF82 8FH, CF82 8HL, CF82 8HQ, CF82 8HZ",313,273,40
W00007409,CF8,"CF8 7XG, CF8 7XJ, CF8 8AU, CF8 8AZ, CF8 8BD, CF82 8AU, CF82 8AZ, CF82 8BD, CF82 8BE, CF82 8FR, CF82 8GB, CF82 8NR, NP12 3XP, NP12 3XR, NP12 3XW, NP2 1XR",393,358,35
W00007410,CF8,"CF8 7FR, CF8 7FS, CF8 7FT, CF8 7GP, CF8 8DY, CF8 8DZ, CF8 8EE, CF8 8EF, CF8 8EZ, CF8 8HY, CF82 7FR, CF82 7FS, CF82 7FT, CF82 7GR, CF82 7PQ, CF82 7PS, CF82 7SS, CF82 8DY, CF82 8DZ, CF82 8EE, CF82 8EF, CF82 8EZ, CF82 8FA, CF82 8FQ, CF82 8HU, CF82 8HY",272,241,31
W00007422,CF8,"CF8 7WD, CF8 8BB, CF8 8DA, CF8 8DB, CF8 8DD, CF8 8DE, CF82 8BB, CF82 8DA, CF82 8DB, CF82 8DD, CF82 8DE",289,262,27
W00007411,CF8,"CF8 8FA, CF8 8FB, CF8 8FD, CF8 8FE, CF82 8FB, CF82 8FD, CF82 8FE",256,225,31
W00007413,CF8,"CF8 8FJ, CF8 8YG, CF8 8YN, CF8 8YS, CF8 8YT, CF82 8FJ, CF82 8FS, CF82 8LB, CF82 8LD, CF82 8LE, CF82 8LF, CF82 8YA, CF82 8YB, CF82 8YD, CF82 8YG, CF82 8YL, CF82 8YR, CF82 8YS, CF82 8YT",391,346,45
W00007414,CF8,"CF8 8EG, CF8 8EH, CF8 8EN, CF8 8EP, CF8 8EQ, CF82 8EG, CF82 8EH, CF82 8EN, CF82 8EP, CF82 8EQ",270,252,18
W00007415,CF8,"CF8 8EL, CF8 8ES, CF8 8EW, CF8 8EX, CF82 8EL, CF82 8ES, CF82 8EW, CF82 8EX",298,268,30
W00007416,CF8,"CF8 8AL, CF8 8AR, CF8 8AS, CF8 8AT, CF82 8AL, CF82 8AR, CF82 8AS, CF82 8AT",241,220,21
W00007417,CF8,"CF8 7XL, CF8 8AG, CF8 8AH, CF8 8AJ, CF8 8AN, CF8 8AP, CF8 8AQ, CF82 8AG, CF82 8AH, CF82 8AJ, CF82 8AN, CF82 8AP, CF82 8AQ, CF82 8XL",327,298,29
W00007418,CF8,"CF8 7FU, CF8 7FY, CF8 7GE, CF8 7GF, CF8 7GG, CF8 7QZ, CF8 7XB, CF8 7XH, CF82 7FU, CF82 7FY, CF82 7GE, CF82 7GF, CF82 7GG, CF82 7QZ, CF82 7ST, CF82 7SU, CF82 7SW, CF82 7XH",292,247,45
W00007419,CF8,"CF8 7FW, CF8 7FX, CF8 7FZ, CF8 7GA, CF8 7GB, CF8 7GD, CF82 7FW, CF82 7FX, CF82 7FZ, CF82 7GA, CF82 7GB, CF82 7GD",276,251,25
W00007420,CF8,"CF8 7XF, CF81 8LJ, CF82 8XF, NP12 3XD, NP12 3XE, NP12 3XF, NP12 3XG, NP12 3XH, NP12 3XJ, NP12 3XL, NP12 3XN, NP12 3XQ, NP12 3XX, NP12 3ZH, NP2 1XD, NP2 1XE, NP2 1XF, NP2 1XH, NP2 1XJ, NP2 1XL, NP2 1XN, NP2 1XP, NP2 1XQ, NP2 1XW, NP2 1ZH, NP2 1ZJ, NP2 1ZN, NP2 1ZQ",397,342,55
W00007412,CF8,"CF8 8EJ, CF8 8ET, CF8 8EU, CF8 8EY, CF82 8EJ, CF82 8ET, CF82 8EU, CF82 8EY, CF82 8GE",282,258,24
W00007140,CF8,"CF8 7JH, CF8 7JR, CF8 7JS, CF8 7JT, CF8 7JU, CF8 7NN, CF8 7NU, CF8 7XD, CF82 7JH, CF82 7JR, CF82 7JS, CF82 7JT, CF82 7JU, CF82 7NN, CF82 7NU, CF82 7PD",399,373,26
W00007174,CF8,"CF8 7PT, CF8 7PZ, CF8 7QA, CF8 7QB, CF8 7QP, CF8 7QW, CF8 7XE, CF82 7PT, CF82 7PZ, CF82 7QA, CF82 7QB, CF82 7QP, CF82 7QW, CF82 7XE",314,281,33
W00007138,CF8,"CF8 7LZ, CF8 7NH, CF8 7NL, CF8 7NR, CF8 7NS, CF8 7NT, CF8 7RA, CF8 7XA, CF82 7GU, CF82 7LU, CF82 7LZ, CF82 7NH, CF82 7NJ, CF82 7NL, CF82 7NR, CF82 7NS, CF82 7NT, CF82 7RA",324,293,31
W00007000,CF8,"CF8 8NP, CF8 8PP, CF8 8PZ, CF8 8QL, CF8 8QP, CF81 8NP, CF81 8PP, CF81 8PZ, CF81 8QL, CF81 8QP",278,244,34
W00007139,CF8,"CF8 7HA, CF8 7HD, CF8 7HH, CF8 7HJ, CF82 7HA, CF82 7HD, CF82 7HH, CF82 7HJ",320,302,18
W00006991,CF8,"CF8 2DL, CF8 2DQ, CF8 2DR, CF8 2DS, CF8 2EP, CF8 2ES, CF83 4DL, CF83 4DQ, CF83 4DR, CF83 4DS, CF83 4EP, CF83 4ES",336,292,44
W00006990,CF8,"CF8 2EW, CF8 2FA, CF8 2FD, CF8 2FF, CF8 2FH, CF8 2FQ, CF83 4EW, CF83 4FA, CF83 4FD, CF83 4FF, CF83 4FH",292,252,40
W00006989,CF8,"CF8 2EY, CF8 2FB, CF8 2FE, CF8 2FJ, CF8 2FL, CF83 4EY, CF83 4FB, CF83 4FE, CF83 4FJ, CF83 4FL, CF83 4YA, CF83 4YD, CF83 4YE, CF83 4YF",278,255,23
W00006988,CF8,"CF8 2EZ, CF8 2FN, CF8 2FP, CF8 2FT, CF8 2FX, CF83 4EU, CF83 4EX, CF83 4EZ, CF83 4FN, CF83 4FP, CF83 4FQ, CF83 4FT, CF83 4FX",369,318,51
W00006987,CF8,"CF8 2GP, CF8 2GZ, CF8 2HA, CF8 2HB, CF8 2HE, CF8 2HF, CF8 2HZ, CF83 4GP, CF83 4GZ, CF83 4HA, CF83 4HB, CF83 4HF, CF83 4HZ",261,228,33
W00006986,CF8,"CF8 2FG, CF8 2FR, CF8 2FS, CF8 2FU, CF8 2GE, CF83 4FG, CF83 4FR, CF83 4FS, CF83 4FU, CF83 4GE",257,225,32
W00010266,CF8,"CF8 2WN, CF8 2WZ, CF8 2XG, CF8 3HQ, CF8 3HT, CF8 3HU, CF8 3HY, CF8 3HZ, CF8 3TD, CF8 3YA, CF8 3YG, CF83 2WJ, CF83 2WN, CF83 2WZ, CF83 3GL, CF83 3HQ, CF83 3HT, CF83 3HY, CF83 3SE, CF83 3SL, CF83 3SR, CF83 3SS, CF83 3ST, CF83 3SY, CF83 3TB, CF83 3TD, CF83 3TG, CF83 3TH, CF83 3XF, CF83 3XJ, CF83 3YB, CF83 3YF, CF83 3YG, CF83 3YH, CF83 3YL, CF83 3YR, CF83 3YS, CF83 3YW",570,453,117
W00007001,CF8,"CF8 8SY, CF8 8SZ, CF8 8TB, CF8 8UU, CF8 8UY, CF81 8SY, CF81 8SZ, CF81 8TB, CF81 8UU, CF81 8UY, CF81 8WA, CF81 8WS",248,221,27
W00007123,CF8,"CF8 9GY, CF8 9HB, CF8 9HD, CF8 9HE, CF8 9HF, CF8 9HX, CF8 9HY, CF8 9JE, CF8 9NT, CF8 9NU, CF81 9GE, CF81 9GY, CF81 9HB, CF81 9HD, CF81 9HE, CF81 9HF, CF81 9HX, CF81 9HY, CF81 9JE, CF81 9NT, CF81 9NU",255,225,30
W00007124,CF8,"CF8 9LL, CF8 9LN, CF8 9LP, CF8 9LQ, CF81 9LL, CF81 9LN, CF81 9LP, CF81 9LQ",241,224,17
W00006984,CF8,"CF8 2GH, CF8 2GJ, CF8 2GL, CF8 2GN, CF8 2HU, CF8 2HW, CF83 4BW, CF83 4GH, CF83 4GJ, CF83 4GL, CF83 4GN, CF83 4GR, CF83 4HU, CF83 4HW, CF83 4HX",324,276,48
W00006983,CF8,"CF8 2FW, CF8 2GA, CF8 2HG, CF8 2HH, CF8 2HJ, CF8 2JG, CF8 2WD, CF83 4AE, CF83 4FW, CF83 4GA, CF83 4HG, CF83 4HH, CF83 4HJ, CF83 4JG, CF83 4WD, CF83 4YQ",354,297,57
W00006982,CF8,"CF8 2HL, CF8 2HN, CF8 2HP, CF8 2HQ, CF83 4HE, CF83 4HL, CF83 4HN, CF83 4HP, CF83 4HQ",280,244,36
W00006981,CF8,"CF8 2AG, CF8 2AS, CF8 2EG, CF8 2EJ, CF8 2ER, CF83 2TU, CF83 4AG, CF83 4AS, CF83 4EG, CF83 4EJ, CF83 4ER, CF83 4ET, CF83 4GQ",267,223,44
W00006980,CF8,"CF8 2AQ, CF8 2AR, CF8 2AT, CF8 2BP, CF83 4AQ, CF83 4AR, CF83 4AT, CF83 4BP",267,211,56
W00006979,CF8,"CF8 2DZ, CF8 2EB, CF8 2ED, CF8 2EE, CF8 2EF, CF83 4DZ, CF83 4EB, CF83 4EE, CF83 4EF",235,181,54
W00007126,CF8,"CF8 9JN, CF8 9JP, CF8 9JQ, CF8 9JR, CF8 9JS, CF8 9JT, CF8 9JU, CF8 9JW, CF8 9NA, CF8 9NB, CF8 9ND, CF8 9NE, CF8 9NF, CF81 9JH, CF81 9JJ, CF81 9JL, CF81 9JN, CF81 9JP, CF81 9JQ, CF81 9JR, CF81 9JS, CF81 9JT, CF81 9JU, CF81 9JW, CF81 9NB",281,259,22
W00007127,CF8,"CF8 9JY, CF8 9LA, CF8 9LB, CF8 9LE, CF8 9LF, CF81 9JY, CF81 9LA, CF81 9LB, CF81 9LE, CF81 9LF",311,286,25
W00006985,CF8,"CF8 2GY, CF8 2HD, CF8 2HT, CF8 2HY, CF83 4GY, CF83 4HD, CF83 4HT, CF83 4HY",227,209,18
W00007128,CF8,"CF8 9GH, CF8 9GJ, CF8 9GL, CF8 9GX, CF8 9GZ, CF8 9HA, CF8 9HG, CF81 9GH, CF81 9GJ, CF81 9GL, CF81 9GX, CF81 9GZ, CF81 9HA, CF81 9HG",319,292,27
W00007002,CF8,"CF8 8RN, CF8 8TE, CF8 8TL, CF8 8TN, CF81 8RN, CF81 8RP, CF81 8TE, CF81 8TL, CF81 8TN",285,266,19
W00007004,CF8,"CF8 8NX, CF8 8QT, CF8 8QU, CF8 8QW, CF8 8QX, CF8 8QY, CF8 8RB, CF8 8RD, CF8 8RE, CF8 8RF, CF8 8RG, CF8 8RP, CF8 8RQ, CF8 8RR, CF8 8RX, CF8 8XD, CF8 8XE, CF8 8XF, CF8 8XU, CF8 8XX, CF8 8YA, CF8 8YE, CF8 8YF, CF8 8YH, CF8 8YL, CF8 8YP, CF8 8YR, CF8 8YW, CF81 8NX, CF81 8QT, CF81 8QU, CF81 8QW, CF81 8QX, CF81 8QY, CF81 8RB, CF81 8RD, CF81 8RE, CF81 8RF, CF81 8RG, CF81 8RQ, CF81 8RR, CF81 8RX, CF81 8XD, CF81 8XE, CF81 8XF, CF81 8XU, CF81 8YA, CF81 8YE, CF81 8YF, CF82 8YW",248,226,22
W00009923,CF8,"CF8 7GJ, CF82 6GT, CF82 6GU, CF82 6GX, CF82 7GJ, CF82 7GW",283,234,49
W00009926,CF8,"CF8 7AZ, CF8 7NZ, CF82 7AZ, CF82 7NZ",229,198,31
W00009927,CF8,"CF8 7GH, CF8 7GN, CF82 6AB, CF82 6AH, CF82 7GH, CF82 7GN, CF82 7GQ",354,280,74
W00007035,CF8,"CF8 2WR, CF8 3DY, CF8 3DZ, CF83 3DY, CF83 3DZ, CF83 3RP, CF83 8DW, CF83 8EP, CF83 8EQ, CF83 8ER, CF83 8ES, CF83 8ET, CF83 8FN, CF83 8FS, CF83 8HA, CF83 8HL, CF83 8HR, CF83 8JQ, CF83 8JR, CF83 8JS, CF83 8JT, CF83 8JU, CF83 8JW, CF83 8JX, CF83 8RR, CF83 8XL, CF83 8YG, CF83 8YQ, NP1 8EQ, NP1 8ER, NP1 8ES, NP1 8ET, NP1 8FF, NP1 8FJ, NP1 8FN, NP1 8GD, NP1 8HD",470,394,76
W00007020,CF8,"CF8 8QR, CF8 8QS, CF8 8QZ, CF8 8RA, CF8 8RH, CF8 8RJ, CF8 8RL, CF8 8TJ, CF8 8TS, CF8 8XA, CF8 8XG, CF8 8XZ, CF8 8YB, CF8 8YJ, CF8 8YQ, CF8 9AA, CF8 9AL, CF8 9UP, CF81 8AB, CF81 8QR, CF81 8QS, CF81 8QZ, CF81 8RA, CF81 8RH, CF81 8RJ, CF81 8RL, CF81 8TJ, CF81 8TS, CF81 8XA, CF81 8XG, CF81 8YB, CF81 8YH, CF81 8YJ, CF81 8YP, CF81 8YQ, CF81 9AA, CF81 9AL",283,254,29
W00007019,CF8,"CF8 8LF, CF8 8NQ, CF8 8NR, CF8 8NS, CF8 8NT, CF8 8PU, CF8 8PW, CF81 8LF, CF81 8NQ, CF81 8NR, CF81 8NS, CF81 8NT, CF81 8NU, CF81 8PU, CF81 8PW, CF81 8PX",333,298,35
W00007018,CF8,"CF8 8NE, CF8 8NL, CF8 8NN, CF8 8PQ, CF8 8QE, CF8 8XS, CF81 8NE, CF81 8NL, CF81 8NN, CF81 8PQ, CF81 8QE",252,217,35
W00007017,CF8,"CF8 8QA, CF8 8QB, CF8 8QD, CF8 8QN, CF8 8UL, CF8 8XL, CF8 9GF, CF81 8QA, CF81 8QB, CF81 8QD, CF81 8QN, CF81 8UL, CF81 8XL, CF81 9GF",248,230,18
W00007016,CF8,"CF8 8LR, CF8 8NY, CF8 8PB, CF8 8PD, CF8 8PH, CF8 8PJ, CF8 8YU, CF81 8LR, CF81 8NY, CF81 8PD, CF81 8PH, CF81 8PJ, CF81 8YG, CF81 8YN, CF81 8YU",247,219,28
W00007003,CF8,"CF8 8SW, CF8 8SX, CF8 8TA, CF8 8TD, CF8 8TG, CF8 8TH, CF81 8SW, CF81 8SX, CF81 8TA, CF81 8TD, CF81 8TG, CF81 8TH, CF81 8TT",297,269,28
W00007015,CF8,"CF8 8PF, CF8 8PL, CF8 8PN, CF8 8SA, CF81 8PF, CF81 8PL, CF81 8PN, CF81 8QF, CF81 8SA",354,326,28
W00007013,CF8,"CF8 8NW, CF8 8NZ, CF8 8PE, CF8 8PG, CF8 8XN, CF81 8AA, CF81 8NW, CF81 8NZ, CF81 8PE, CF81 8PG, CF81 8WZ, CF81 8XN",294,272,22
W00007012,CF8,"CF8 8LQ, CF8 8LS, CF8 8LT, CF8 8LU, CF8 8PA, CF8 8XB, CF8 8XH, CF8 8XP, CF8 8YD, CF81 8AD, CF81 8LQ, CF81 8LS, CF81 8LT, CF81 8LU, CF81 8PA, CF81 8XP, CF81 8YD",235,219,16
W00007011,CF8,"CF8 8QQ, CF8 8RU, CF8 8RZ, CF8 8SB, CF8 8SP, CF8 8SS, CF8 8ST, CF81 8QQ, CF81 8RU, CF81 8RZ, CF81 8SB, CF81 8SP, CF81 8SS, CF81 8ST",279,257,22
W00007010,CF8,"CF8 8TR, CF8 8UJ, CF8 8UN, CF8 8UQ, CF8 8UW, CF81 8TR, CF81 8UJ, CF81 8UN, CF81 8UQ, CF81 8UW",251,217,34
W00007009,CF8,"CF8 8SQ, CF8 8SU, CF8 8UA, CF8 8UB, CF8 8UD, CF81 8SQ, CF81 8SU, CF81 8UA, CF81 8UB, CF81 8UD",284,261,23
W00007008,CF8,"CF8 8SR, CF8 8UE, CF8 8UF, CF8 8UG, CF8 8UH, CF8 8XJ, CF81 8SR, CF81 8UE, CF81 8UF, CF81 8UG, CF81 8UH",292,264,28
W00007007,CF8,"CF8 8TF, CF8 8TP, CF8 8TQ, CF8 9GG, CF81 8TF, CF81 8TP, CF81 8TQ, CF81 9GG",286,257,29
W00007006,CF8,"CF8 8RS, CF8 8RT, CF8 8RW, CF8 8RY, CF81 8RS, CF81 8RT, CF81 8RW, CF81 8RY",258,226,32
W00007005,CF8,"CF8 8UP, CF8 8UR, CF8 8US, CF8 8UT, CF8 8UX, CF81 8UP, CF81 8UR, CF81 8US, CF81 8UT, CF81 8UX",303,258,45
W00007014,CF8,"CF8 8LE, CF8 8NU, CF8 8QG, CF8 8QH, CF8 8QJ, CF81 8LE, CF81 8QG, CF81 8QH, CF81 8QJ",255,242,13
W00006978,CF8,"CF8 2AW, CF8 2BD, CF8 2BR, CF8 2DJ, CF8 2EH, CF8 2EL, CF83 4AW, CF83 4BD, CF83 4BR, CF83 4DJ, CF83 4EH, CF83 4EL",303,266,37
W00007401,CF8,"CF8 8BN, CF8 8BU, CF8 8DS, CF8 8DT, CF8 8EA, CF8 8EB, CF8 8ED, CF8 8FW, CF8 8FX, CF82 8BH, CF82 8BN, CF82 8BU, CF82 8DS, CF82 8DT, CF82 8EA, CF82 8EB, CF82 8ED, CF82 8FP, CF82 8FT, CF82 8FW, CF82 8FX",381,321,60
W00006976,CF8,"CF8 2AX, CF8 2AY, CF8 2BA, CF8 2BB, CF8 2BG, CF8 2BJ, CF8 2BL, CF83 4AX, CF83 4AY, CF83 4BA, CF83 4BB, CF83 4BG, CF83 4BJ, CF83 4BL",332,271,61
W00006948,CF8,"CF8 8XQ, CF8 9EU, CF8 9EX, CF8 9FB, CF8 9FH, CF8 9FU, CF8 9UH, CF81 9EU, CF81 9EX, CF81 9FB, CF81 9FH, CF81 9FU",303,278,25
W00006977,CF8,"CF8 2DP, CF8 2DT, CF8 2DU, CF8 2DX, CF8 2EN, CF8 2EQ, CF83 4DP, CF83 4DT, CF83 4DU, CF83 4DX, CF83 4EN, CF83 4EQ",361,299,62
W00006947,CF8,"CF8 9FE, CF8 9FF, CF8 9FL, CF8 9FN, CF8 9FQ, CF81 9FE, CF81 9FF, CF81 9FL, CF81 9FN, CF81 9FQ",239,206,33
W00006946,CF8,"CF8 9AB, CF8 9AJ, CF8 9AW, CF8 9AZ, CF8 9BY, CF8 9BZ, CF8 9DA, CF8 9EQ, CF8 9ER, CF8 9ES, CF8 9ET, CF8 9UB, CF81 9AJ, CF81 9AW, CF81 9AZ, CF81 9BY, CF81 9BZ, CF81 9DA, CF81 9DD, CF81 9EQ, CF81 9ER, CF81 9ES, CF81 9ET",325,301,24
W00006945,CF8,"CF8 9EW, CF8 9EY, CF8 9EZ, CF8 9FA, CF8 9FD, CF81 9EW, CF81 9EY, CF81 9EZ, CF81 9FA, CF81 9FD",263,233,30
W00006944,CF8,"CF8 9AY, CF8 9BA, CF8 9DN, CF8 9UE, CF81 9AN, CF81 9AY, CF81 9BA, CF81 9DL, CF81 9DN, CF81 9EE, NP12 0BB, NP12 0BD, NP12 0RU, NP2 0BB, NP2 0BD, NP2 0RX",442,378,64
W00006943,CF8,"CF8 9AF, CF8 9BL, CF8 9DB, CF8 9DY, CF8 9EA, CF8 9EB, CF81 9AF, CF81 9BL, CF81 9DB, CF81 9DY, CF81 9EA, CF81 9EB, CF81 9ED",229,199,30
W00006949,CF8,"CF8 9EP, CF8 9FG, CF8 9FJ, CF8 9FP, CF8 9FR, CF8 9FS, CF8 9FT, CF8 9FW, CF8 9FX, CF8 9FY, CF8 9FZ, CF8 9SW, CF8 9TT, CF8 9UA, CF81 9AB, CF81 9AG, CF81 9BF, CF81 9EF, CF81 9EG, CF81 9EH, CF81 9EJ, CF81 9EP, CF81 9FG, CF81 9FJ, CF81 9FP, CF81 9FR, CF81 9FS, CF81 9FT, CF81 9FW, CF81 9FX, CF81 9FY, CF81 9FZ, CF81 9GB, CF81 9HH, CF81 9SW, CF81 9TT, CF81 9UA, CF81 9YN",387,326,61
W00006950,CF8,"CF8 9DU, CF8 9DW, CF8 9DX, CF8 9DZ, CF81 9DU, CF81 9DW, CF81 9DX, CF81 9DZ",282,254,28
W00007131,CF8,"CF8 8NF, CF8 8NJ, CF8 8PR, CF8 8PS, CF8 8PT, CF8 8PX, CF8 8PY, CF81 8NF, CF81 8NJ, CF81 8PB, CF81 8PR, CF81 8PS, CF81 8PT, CF81 8PY",273,249,24
W00007132,CF8,"CF8 8JR, CF8 8JS, CF8 8JT, CF8 8JU, CF8 8JW, CF8 8JZ, CF81 8JR, CF81 8JS, CF81 8JT, CF81 8JU, CF81 8JW, CF81 8JZ, NP2 1XG",301,261,40
W00007133,CF8,"CF8 8JA, CF8 8LH, CF8 8LW, CF8 8LX, CF8 8LZ, CF8 8NA, CF8 8ND, CF8 8XR, CF81 8JA, CF81 8LH, CF81 8LW, CF81 8LX, CF81 8LZ, CF81 8NA, CF81 8ND, CF81 8SD, CF81 8XQ",291,261,30
W00007135,CF8,"CF8 8JJ, CF8 8JL, CF8 8JN, CF8 8JP, CF8 8JQ, CF81 8JJ, CF81 8JL, CF81 8JN, CF81 8JP, CF81 8JQ",283,260,23
W00007136,CF8,"CF8 8JF, CF8 8JG, CF8 8JH, CF8 8LG, CF8 8LY, CF81 8JF, CF81 8JG, CF81 8JH, CF81 8LG, CF81 8LY",254,223,31
W00006951,CF8,"CF8 9DQ, CF8 9DR, CF8 9DS, CF8 9DT, CF81 9DQ, CF81 9DR, CF81 9DS, CF81 9DT",353,314,39
W00007134,CF8,"CF8 8JB, CF8 8JD, CF8 8JE, CF8 8NB, CF8 8NG, CF8 8NH, CF81 8JB, CF81 8JD, CF81 8JE, CF81 8LP, CF81 8NB, CF81 8NG, CF81 8NH",264,239,25
W00006953,CF8,"CF8 8FG, CF8 9AE, CF8 9AH, CF8 9AU, CF8 9AX, CF8 9BN, CF8 9BP, CF8 9BR, CF8 9BT, CF8 9EN, CF81 9AD, CF81 9AE, CF81 9AH, CF81 9AU, CF81 9AX, CF81 9BN, CF81 9BP, CF81 9BR, CF81 9BT, CF81 9EN",256,224,32
W00006952,CF8,"CF8 9BH, CF8 9BJ, CF8 9BQ, CF8 9BS, CF8 9DP, CF8 9UD, CF81 9BH, CF81 9BJ, CF81 9BQ, CF81 9BS, CF81 9DP",298,258,40
W00006954,CF8,"CF8 9BB, CF8 9BD, CF8 9BE, CF8 9BG, CF8 9BU, CF8 9BW, CF8 9BX, CF81 9BB, CF81 9BD, CF81 9BE, CF81 9BG, CF81 9BU, CF81 9BW, CF81 9BX, CF81 9DE",307,266,41
W00007129,CF8,"CF8 9GP, CF8 9GQ, CF8 9GR, CF8 9GS, CF8 9GT, CF8 9GU, CF8 9GW, CF8 9HU, CF8 9HW, CF8 9YA, CF8 9YB, CF8 9YD, CF8 9YE, CF8 9YF, CF8 9YG, CF81 9GA, CF81 9GP, CF81 9GQ, CF81 9GR, CF81 9GS, CF81 9GT, CF81 9GU, CF81 9GW, CF81 9HS, CF81 9HU, CF81 9HW, CF81 9JF, CF81 9JG, CF81 9YA",383,350,33
W00006974,CF8,"CF8 2BH, CF8 2BN, CF8 2BQ, CF8 2BS, CF8 2DA, CF8 2TU, CF8 2WF, CF83 2WF, CF83 4BH, CF83 4BN, CF83 4BQ, CF83 4BS, CF83 4DA",299,260,39
W00007137,CF8,"CF8 8JX, CF8 8JY, CF8 8LA, CF8 8LB, CF8 8LD, CF81 8JX, CF81 8JY, CF81 8LA, CF81 8LB, CF81 8LD, CF81 8LL",274,244,30
W00006973,CF8,"CF8 2FY, CF8 2FZ, CF8 2GB, CF8 2GD, CF8 2GF, CF8 2GG, CF8 2HR, CF8 2HS, CF83 4FY, CF83 4FZ, CF83 4GB, CF83 4GD, CF83 4GF, CF83 4GG, CF83 4HR, CF83 4HS",336,292,44
W00006975,CF8,"CF8 2DB, CF8 2DN, CF8 2DW, CF8 2DY, CF8 2EA, CF83 4AD, CF83 4BZ, CF83 4DB, CF83 4DN, CF83 4DW, CF83 4DY, CF83 4EA",363,311,52
W00007130,CF8,"CF8 9HT, CF8 9HZ, CF8 9JA, CF8 9JB, CF8 9JD, CF8 9NJ, CF8 9NL, CF8 9NN, CF8 9NP, CF8 9NR, CF81 9HT, CF81 9HZ, CF81 9JA, CF81 9JB, CF81 9JD, CF81 9NJ, CF81 9NL, CF81 9NN, CF81 9NP, CF81 9NR",310,288,22
W00006972,CF8,"CF8 2AF, CF8 2AU, CF8 2AZ, CF8 2BE, CF8 2DD, CF8 2DE, CF8 2DF, CF8 2DH, CF8 2WB, CF83 4AF, CF83 4AU, CF83 4AZ, CF83 4BE, CF83 4DD, CF83 4DE, CF83 4DF, CF83 4DH",316,265,51
W00006971,CF8,"CF8 2DG, CF8 2WE, CF83 4AB, CF83 4DG, CF83 4ED",223,177,46
W00010296,CF82,"CF82 6AP, CF82 6AR, CF82 6AS, CF82 6AU, CF82 6AW, CF82 6AX, CF82 6AY, CF82 6AZ, CF82 6BA",415,322,93
W00007488,CF82,"CF82 7DN, CF82 7FD, CF82 7FE, CF82 7FF, CF82 7FJ, CF82 7FL",502,408,94
W00007455,CF83,"CF83 1SB, CF83 1ST, CF83 1SU, CF83 1SY, CF83 1SZ, CF83 1TL",320,276,44
W00007033,CF83,"CF83 8AX, CF83 8AY, CF83 8AZ, CF83 8BA, CF83 8BD, CF83 8EF, CF83 8EG, CF83 8EZ, CF83 8FF, CF83 8FG, CF83 8FJ, CF83 8GD, CF83 8QZ, NP1 8AX, NP1 8AY, NP1 8AZ, NP1 8BD, NP1 8EF, NP1 8EZ, NP1 8FG, NP1 8FL",279,249,30
W00007032,CF83,"CF83 3GF, CF83 8AA, CF83 8AB, CF83 8AD, CF83 8BG, CF83 8BH, CF83 8BJ, CF83 8BX, CF83 8BZ, CF83 8DR, CF83 8DX, CF83 8DY, CF83 8GE, CF83 8HZ, CF83 8JB, CF83 8XA, CF83 8XD, CF83 8YA, CF83 8YB, CF83 8YD, CF83 8YE, NP1 8AA, NP1 8AB, NP1 8AD, NP1 8BG, NP1 8BH, NP1 8BJ, NP1 8BL, NP1 8BS, NP1 8BW, NP1 8BZ, NP1 8DX, NP1 8GB, NP1 8GY, NP1 8GZ, NP1 8XA, NP1 8XB, NP1 8XD, NP1 8XG, NP1 8XJ, NP1 8YB, NP1 8YE, NP1 8YQ",347,315,32
W00007031,CF83,"CF83 8AE, CF83 8AF, CF83 8AG, CF83 8AH, CF83 8AL, CF83 8EB, NP1 8AF, NP1 8AG, NP1 8AH, NP1 8AL, NP1 8XQ",312,293,19
W00007030,CF83,"CF83 8BL, CF83 8BN, CF83 8BR, CF83 8BS, CF83 8BT, CF83 8BW, CF83 8DJ, CF83 8DT, CF83 8FL, CF83 8JA, NP1 8BN, NP1 8BP, NP1 8BR, NP1 8BT, NP1 8BU, NP1 8BX, NP1 8BY, NP1 8DA, NP1 8DB, NP1 8DE, NP1 8DJ, NP1 8DL, NP1 8DN, NP1 8DP, NP1 8DQ, NP1 8DR, NP1 8DS, NP1 8DT, NP1 8DU, NP1 8DW",280,242,38
W00007029,CF83,"CF83 8JE, CF83 8RA, CF83 8RF, CF83 8RG, CF83 8RH, CF83 8RJ, CF83 8RP, CF83 8WW, NP1 8RA, NP1 8RE, NP1 8RF, NP1 8RG, NP1 8RH, NP1 8RJ, NP1 8SY, NP1 8SZ, NP1 8TA, NP1 8TE, NP1 8TF, NP1 8TG",249,230,19
W00007028,CF83,"CF83 8EW, CF83 8HG, CF83 8HH, CF83 8PE, NP1 8BA, NP1 8HG",347,312,35
W00007026,CF83,"CF83 8HD, CF83 8HP, CF83 8HQ, CF83 8HS, CF83 8HT, NP1 8HB",406,350,56
W00007025,CF83,"CF83 8QE, CF83 8QN, CF83 8QP, CF83 8QQ, CF83 8RL, CF83 8RN, CF83 8RQ, CF83 8RS, CF83 8RZ, CF83 8SF, CF83 8SN, CF83 8SP, CF83 8SQ, CF83 8SR, CF83 8ST, CF83 8SW, CF83 8YP, NP1 8GA, NP1 8QB, NP1 8QE, NP1 8QP, NP1 8QQ, NP1 8RL, NP1 8RN, NP1 8RS, NP1 8RZ, NP1 8SF, NP1 8SG, NP1 8SH, NP1 8SJ, NP1 8SL, NP1 8SN, NP1 8SP, NP1 8SQ, NP1 8SR, NP1 8SS, NP1 8ST, NP1 8XL, NP1 8XW, NP1 8YP",309,261,48
W00007024,CF83,"CF83 8DD, CF83 8DS, CF83 8DU, CF83 8DZ, CF83 8EA, CF83 8ED, CF83 8EH, CF83 8EL, CF83 8EU, CF83 8EY, CF83 8FW, CF83 8GF, CF83 8HU, CF83 8HW, CF83 8HX, CF83 8JG, CF83 8WT, CF83 8XP, CF83 8XQ, NP1 8AE, NP1 8EA, NP1 8EB, NP1 8ED, NP1 8EH, NP1 8EJ, NP1 8EL, NP1 8EN, NP1 8EP, NP1 8EU, NP1 8EW, NP1 8EX, NP1 8EY, NP1 8HA, NP1 8HH, NP1 8HJ, NP1 8LA, NP1 8LB, NP1 8LD, NP1 8LE, NP1 8LF, NP1 8LG, NP1 8LY, NP1 8XH, NP1 8XP, NP1 8XX, NP1 8XZ, NP1 8YG, NP1 8YT, NP1 8YY",390,352,38
W00007023,CF83,"CF83 8DN, CF83 8EE, CF83 8EJ, CF83 8EX, CF83 8FH, CF83 8HJ, CF83 8UA, CF83 8UD, NP1 8EE, NP1 8EG",302,269,33
W00007022,CF83,"CF83 8DB, CF83 8FT, CF83 8FU, CF83 8FY, CF83 8FZ, CF83 8GA, CF83 8XY, CF83 8YL, NP1 8FT, NP1 8FU, NP1 8FZ",290,262,28
W00007021,CF83,"CF83 8EN, CF83 8HB, CF83 8HE, CF83 8HF, NP1 8HE, NP1 8HF",324,289,35
W00007445,CF83,"CF83 1TN, CF83 1TP, CF83 1TT",279,239,40
W00009925,CF83,"CF83 2AS, CF83 2AT, CF83 2BA, CF83 2XP, CF83 2XR",292,250,42
W00007458,CF83,"CF83 1SA, CF83 1SD, CF83 1SL, CF83 1TS",279,239,40
W00007034,CF83,"CF83 8DG, CF83 8DH, CF83 8FP, CF83 8FQ, CF83 8FR, CF83 8FX, CF83 8JD, NP1 8DH, NP1 8FP, NP1 8FQ, NP1 8FX, NP1 8FY",290,257,33
W00007307,CF83,"CF83 2LF, CF83 2LG, CF83 2LJ, CF83 2LL, CF83 2LR, CF83 2LS",476,430,46
W00007320,CF83,"CF83 1SE, CF83 1SF, CF83 1SG, CF83 1SH, CF83 1SJ, CF83 1SN, CF83 1TF, CF83 1TQ, CF83 1TU",371,322,49
W00009921,CF83,"CF83 1TH, CF83 2AX, CF83 2AZ, CF83 2BH, CF83 2XJ",357,308,49
W00009930,CF83,"CF83 1SS, CF83 1TG, CF83 1TJ, CF83 1TR, CF83 1TW",277,242,35
W00007027,CF83,"CF83 8PX, CF83 8PY, CF83 8PZ, CF83 8QA, CF83 8QB, CF83 8QD, CF83 8QW, NP1 8QD",264,227,37
W00007037,CF83,"CF83 8GH, CF83 8GJ, CF83 8GL, CF83 8GW, CF83 8GZ, NP1 8FH, NP1 8GL, NP1 8GW",319,292,27
W00010288,CF83,"CF83 1DX, CF83 1TA, CF83 1TB, CF83 1TD",379,313,66
W00009932,CF83,"CF83 2AG, CF83 2AR, CF83 2BB, CF83 2BD, CF83 2BN",346,295,51
W00007036,CF83,"CF83 8GB, CF83 8RB, CF83 8RD, CF83 8RE, CF83 8TT, NP1 8RB, NP1 8RD, NP1 8RP, NP1 8RR, NP1 8TR, NP1 8TU, NP1 8XE, NP1 8XY, NP1 8YA, NP1 8YD, NP1 8YF, NP1 8YH, NP1 8YJ, NP1 8YR, NP1 8YS, NP1 8YU, NP1 8YW",299,272,27
W00007054,CF83,"CF83 8AN, CF83 8AQ, CF83 8FA, CF83 8FB, CF83 8FE, CF83 8JH, NP1 8BB, NP1 8FA, NP1 8FD, NP1 8GG, NP1 8GJ",250,238,12
W00007053,CF83,"CF83 8BU, CF83 8BY, CF83 8DE, CF83 8DL, CF83 8HN, NP1 8DD, NP1 8DF, NP1 8DG",311,279,32
W00007052,CF83,"CF83 8BQ, CF83 8FD, CF83 8GN, CF83 8GP, CF83 8GQ, CF83 8GR, CF83 8GY, NP1 8BQ, NP1 8FB, NP1 8FE, NP1 8GN, NP1 8GP, NP1 8GQ, NP1 8GR, NP1 8GS, NP1 8GT",223,205,18
W00007051,CF83,"CF83 8SY, CF83 8SZ, CF83 8TE, CF83 8TF, CF83 8TX, NP1 8TX",243,227,16
W00007049,CF83,"CF83 8BP, CF83 8GS, CF83 8GT, CF83 8GU, CF83 8GX, NP1 8FR, NP1 8GU, NP1 8GX",313,285,28
W00007048,CF83,"CF83 8HY, CF83 8NG, CF83 8NH, CF83 8NY, CF83 8NZ, CF83 8PA, CF83 8PU, CF83 8QF, CF83 8QH, CF83 8QJ, CF83 8QL, CF83 8QS, CF83 8QT, NP1 8NG, NP1 8NH, NP1 8NQ, NP1 8NY, NP1 8NZ, NP1 8PF, NP1 8PP, NP1 8PU, NP1 8PW, NP1 8PX, NP1 8PY, NP1 8PZ, NP1 8QA, NP1 8QJ, NP1 8QL, NP1 8QN, NP1 8SX",289,266,23
W00007047,CF83,"CF83 8TA, CF83 8TB, CF83 8TD, CF83 8TH, CF83 8TY, CF83 8TZ, NP1 8TB, NP1 8TD, NP1 8TH, NP1 8TL, NP1 8TY",290,272,18
W00007050,CF83,"CF83 8TG, CF83 8TN, CF83 8TQ, CF83 8TU, CF83 8TW, NP1 8TN, NP1 8TQ, NP1 8TT, NP1 8TW, NP1 8TZ",252,233,19
W00007045,CF83,"CF83 8DA, CF83 8DF, CF83 8DP, CF83 8DQ",288,254,34
W00007038,CF83,"CF83 8LB, CF83 8LD, CF83 8PF, CF83 8PJ, CF83 8PP, CF83 8PW, CF83 8SA, CF83 8SB, CF83 8SU, NP1 8PL, NP1 8PN, NP1 8SB, NP1 8SE",277,244,33
W00007039,CF83,"CF83 8AJ, CF83 8AS, CF83 8AT, CF83 8AU, CF83 8AW, CF83 8BE, NP1 8AJ, NP1 8AN, NP1 8AQ, NP1 8AR, NP1 8AS, NP1 8AT, NP1 8AU, NP1 8AW, NP1 8BE",282,252,30
W00007040,CF83,"CF83 8AP, CF83 8AR, CF83 8BB, CF83 8GG, NP1 8AP, NP1 8GH",265,244,21
W00007041,CF83,"CF83 8TJ, CF83 8TL, CF83 8TP, CF83 8TR, CF83 8TS, NP1 8RQ, NP1 8TJ, NP1 8TP, NP1 8TS",304,270,34
W00007046,CF83,"CF83 8LE, CF83 8LF, CF83 8NE, CF83 8NS, CF83 8NU, CF83 8NX, CF83 8PD, CF83 8PL, CF83 8QU, CF83 8UH, NP1 8NU, NP1 8PD",302,265,37
W00007042,CF83,"CF83 8LA, CF83 8LG, CF83 8NB, CF83 8PG, CF83 8PQ, CF83 8PR, CF83 8PS, CF83 8PT, CF83 8QR, NP1 8PJ, NP1 8PQ, NP1 8PR, NP1 8PT, NP1 8SA, NP1 8SD, NP1 8SU",300,271,29
W00009931,CF83,"CF83 2XN, CF83 2XW, CF83 2XY",290,236,54
W00007043,CF83,"CF83 8SD, CF83 8SE, CF83 8SG, CF83 8SH, CF83 8SJ, CF83 8SL, CF83 8SX, NP1 8SW",221,200,21
W00007044,CF83,"CF83 8LH, CF83 8NA, CF83 8ND, CF83 8NF, CF83 8NW, CF83 8PH, CF83 8QG, NP1 8NA, NP1 8NB, NP1 8ND, NP1 8NE, NP1 8NF, NP1 8NW, NP1 8PA, NP1 8PG, NP1 8PH, NP1 8PS, NP1 8QF, NP1 8QG, NP1 8QH, NP1 8QR, NP1 8QS, NP1 8QZ",267,250,17
W00010273,CF83,"CF83 1SR, CF83 1TX",250,215,35
W00001788,CH1,"CH1 4QL, CH1 6BA, CH1 6BB, CH1 6BL, CH1 6BP, CH1 6BQ, CH1 6BR, CH1 6BS, CH1 6BT, CH1 6BX, CH1 6BY, CH1 6BZ, CH1 6DD, CH1 6EB, CH1 6HA, CH1 6HB, CH1 6HH, CH1 6QB, CH1 6QE, CH1 6QF, CH1 6QG, CH1 6QQ, CH5 2LQ, CH5 2QT",464,434,30
W00001378,CH4,"CH4 0QS, CH4 0RB, CH4 0RD, CH4 0RJ, CH4 0RT, CH4 0RY, CH4 0RZ",306,281,25
W00001379,CH4,"CH4 0PY, CH4 0QW, CH4 0RA, CH4 0RH, CH4 0RX",281,259,22
W00001377,CH4,"CH4 0PP, CH4 0PT, CH4 0PU, CH4 0PW, CH4 0PX",320,300,20
W00001380,CH4,"CH4 0FA, CH4 0FB, CH4 0FE, CH4 0FF, CH4 0FH, CH4 0WA, CH4 0WE, CH4 0ZB, CH4 0ZN, CH4 0ZQ, CH4 0ZR, CH4 0ZS",303,277,26
W00001376,CH4,"CH4 0PA, CH4 0PR, CH4 0PS, CH4 0PZ, CH4 0QA, CH4 0QJ, CH4 0TD, CH4 0TG",319,303,16
W00010469,CH4,"CH4 8BT, CH4 8LG, CH4 8LJ, CH4 8NH, CH4 8QF, CH4 8QG, CH4 8QH, CH4 8QJ, CH4 8QL, CH4 8QS, CH4 8QZ, CH4 8SD",332,318,14
W00010475,CH4,"CH4 0SN, CH4 0SQ, CH4 0SW",200,186,14
W00001369,CH4,"CH4 0NY, CH4 0PF, CH4 0PH, CH4 0QR, CH4 0RN",265,242,23
W00010483,CH4,"CH4 0FQ, CH4 0FS, CH4 0FT, CH4 0FW, CH4 0TA, CH4 0TB, CH4 0TP",484,444,40
W00001370,CH4,"CH4 0NZ, CH4 0QQ, CH4 0RE, CH4 0RF, CH4 0RL",260,240,20
W00010485,CH4,"CH4 0AJ, CH4 0AW, CH4 0BS, CH4 0DD, CH4 0FL, CH4 0FN, CH4 0FP, CH4 0FR, CH4 0GB, CH4 0GD, CH4 0GE, CH4 0GF, CH4 0GG, CH4 0GH",570,497,73
W00010486,CH4,"CH4 8LR, CH4 8QB, CH4 8QE",215,207,8
W00001371,CH4,"CH4 0PD, CH4 0QP, CH4 0RG, CH4 0RP, CH4 0RQ, CH4 0RR, CH4 0RW",284,250,34
W00001372,CH4,"CH4 0AD, CH4 0DJ, CH4 0NN, CH4 0NP, CH4 0NR, CH4 0NS, CH4 0NW, CH4 0NX, CH4 0PE, CH4 0PG",309,285,24
W00010490,CH4,"CH4 0AA, CH4 0AN, CH4 0AU, CH4 0JN",97,90,7
W00001375,CH4,"CH4 0BU, CH4 0DL, CH4 0DT, CH4 0FX, CH4 0QB, CH4 0QD, CH4 0QE, CH4 0QG, CH4 0QZ, CH4 0TH, CH4 0TJ",358,336,22
W00001374,CH4,"CH4 0DA, CH4 0DE, CH4 0DN, CH4 0DP, CH4 0DU, CH4 0DW, CH4 0DX, CH4 0DY, CH4 0DZ, CH4 0QF, CH4 0QH",273,265,8
W00010491,CH4,"CH4 0FY, CH4 0TL, CH4 0TN, CH4 0TQ",314,287,27
W00001373,CH4,"CH4 0BA, CH4 0BB, CH4 0BY, CH4 0BZ, CH4 0DB, CH4 0DF, CH4 0DG, CH4 0DH, CH4 0DQ, CH4 0DR, CH4 0DS, CH4 0GZ, CH4 0HA, CH4 0NQ, CH5 3NU, CH5 3PJ, CH5 3PL, CH5 3PP, CH5 3PR, CH5 3PS, CH5 3PT, CH5 3PU, CH5 3PW, CH5 3PZ, CH5 3QB, CH5 3QP, CH5 3QW, CH5 3QX, CH5 3QY, CH5 3QZ, CH5 3SN, CH5 3SP, CH5 3SR, CH5 3ST, CH5 3SW, CH5 3US",459,403,56
W00010492,CH4,"CH4 0JB, CH4 0JS, CH4 0JU",128,119,9
W00001768,CH4,"CH4 0AG, CH4 0AQ, CH4 0AR, CH4 0AX, CH4 0AY, CH4 0BF, CH4 0BG, CH4 0BN, CH4 0BQ, CH4 0BX",290,277,13
W00001767,CH4,"CH4 0AL, CH4 0AT, CH4 0AZ, CH4 0BE",265,253,12
W00001759,CH4,"CH4 0JJ, CH4 0JQ, CH4 0LF, CH4 0LT, CH4 0NB, CH4 0NE",279,246,33
W00001758,CH4,"CH4 0GJ, CH4 0GL, CH4 0GN, CH4 0GP, CH4 0GQ, CH4 0LG, CH4 0LJ, CH4 0LL, CH4 0LP, CH4 0LU, CH4 0LW, CH4 0ND, CH4 0NG, CH4 0NJ, CH4 0TR, CH4 0TS, CH4 0TT, CH4 0TU, CH4 0TW, CH4 0YR, CH4 0YS, CH4 0YT, CH4 0YU, CH4 0YX, CH4 0YY",518,462,56
W00001757,CH4,"CH4 0JH, CH4 0LY, CH4 0LZ, CH4 0NA, CH4 0XA, CH4 0XB, CH4 0XD",283,254,29
W00001756,CH4,"CH4 0GY, CH4 0HN, CH4 0HP, CH4 0HR, CH4 0HS",297,256,41
W00001754,CH4,"CH4 0HD, CH4 0HF, CH4 0HH, CH4 0HW, CH4 0HY, CH4 0JG",327,289,38
W00001753,CH4,"CH4 0HL, CH4 0HZ, CH4 0JA, CH4 0JR, CH4 0JT, CH4 0JW, CH4 0JX, CH4 0JY",297,266,31
W00001752,CH4,"CH4 0EY, CH4 0GA, CH4 0HQ, CH4 0JF, CH4 0JP, CH4 0JZ, CH4 0LD, CH4 0LE, CH4 0LN, CH4 0LR, CH4 0LX, CH4 0NF",343,308,35
W00001751,CH4,"CH4 0LB, CH4 0LQ, CH4 0NH, CH4 0PJ, CH4 0YP",302,268,34
W00001750,CH4,"CH4 0EL, CH4 0EN, CH4 0EP, CH4 0FZ, CH4 0GX, CH4 0JD, CH4 0JE, CH4 0JL, CH4 0LH, CH4 0LS, CH7 3BD",325,287,38
W00001749,CH4,"CH4 0AB, CH4 0EF, CH4 0EQ, CH4 0ER, CH4 0ES, CH5 3FH, CH5 3LU, CH5 3LX, CH5 3LZ, CH5 3NA, CH5 3ND, CH5 3NF",332,297,35
W00001748,CH4,"CH4 0EA, CH4 0EB, CH4 0ET, CH4 0EU, CH4 0EZ, CH4 0HB, CH4 0HE, CH4 0HJ, CH4 0HT, CH4 0HX",434,372,62
W00001769,CH4,"CH4 8BF, CH4 8FA, CH4 8FB, CH4 8FD, CH4 8FE, CH4 8FG, CH4 8GA, CH4 8RB, CH4 8RE, CH4 8RF, CH4 8RG, CH4 8RH, CH4 8RL, CH4 8RN, CH4 8RP, CH4 8RQ, CH4 8RU, CH4 8RW, CH4 8RX, CH4 8RY, CH4 8SB, CH4 8SE, CH4 8SF, CH4 8SL, CH4 8SN, CH4 8SP, CH4 8SQ, CH4 8SR, CH4 8SW, CH4 8SX",383,357,26
W00001770,CH4,"CH4 0BH, CH4 0BJ, CH4 0BL, CH4 0BP, CH4 0BR, CH4 0BT, CH4 0BW",325,301,24
W00001772,CH4,"CH4 8RR, CH4 8SY, CH4 8SZ, CH4 8TH, CH4 8TJ, CH4 8TQ, CH4 8TU",335,318,17
W00001381,CH4,"CH4 0NT, CH4 0NU, CH4 0PB, CH4 0PL, CH4 0PN, CH4 0SB, CH4 0TF",280,265,15
W00001382,CH4,"CH4 0QN, CH4 0SE, CH4 0SG, CH4 0SH, CH4 0SP, CH4 0SR",230,219,11
W00001384,CH4,"CH4 0SF, CH4 0SS, CH4 0ST, CH4 0SU, CH4 0SX, CH4 0SY",257,236,21
W00001385,CH4,"CH4 0QL, CH4 0QT, CH4 0QU, CH4 0QX, CH4 0QY, CH4 0RS",276,252,24
W00001386,CH4,"CH4 0SA, CH4 0SJ, CH4 0SL, CH4 0SZ, CH4 0TE",253,244,9
W00001387,CH4,"CH4 0ED, CH4 0EE, CH4 0EG, CH4 0EH, CH4 0EW, CH4 0FD, CH4 0FG, CH4 0FJ, CH4 0HG, CH4 0PQ, CH4 0RU, CH4 0SD",289,259,30
W00001782,CH4,"CH4 8QN, CH4 8QW, CH4 8UG, CH4 8UQ",295,267,28
W00001781,CH4,"CH4 8TG, CH4 8TR, CH4 8TS, CH4 8TX, CH4 8TY, CH4 8TZ",314,292,22
W00001780,CH4,"CH4 8UD, CH4 8UE, CH4 8UF, CH4 8UH",270,257,13
W00001779,CH4,"CH4 8LH, CH4 8LT, CH4 8SA, CH4 8SG, CH4 8TB, CH4 8TD, CH4 8TE, CH4 8TF, CH4 8TP, CH4 8TT, CH4 8UT, CH4 8WN",301,283,18
W00001777,CH4,"CH4 8LQ, CH4 8LW, CH4 8RT, CH4 8TL, CH4 8TN, CH4 8TW",324,306,18
W00001776,CH4,"CH4 8QP, CH4 8QY, CH4 8UB, CH4 8UP, CH4 8UR",256,248,8
W00001775,CH4,"CH4 8SH, CH4 8SJ, CH4 8SS, CH4 8ST, CH4 8SU, CH4 8TA",290,274,16
W00001774,CH4,"CH4 8QR, CH4 8UA, CH4 8UJ, CH4 8UL",265,249,16
W00001773,CH4,"CH4 8LA, CH4 8NA, CH4 8NB, CH4 8PB, CH4 8PY, CH4 8QQ, CH4 8QT",240,234,6
W00001771,CH4,"CH4 0AE, CH4 0AF, CH4 0AH, CH4 0AP, CH4 0AS, CH4 0BD, CH4 8FF, CH4 8RJ, CH4 8RS, CH4 8RZ",292,265,27
W00001627,CH4,"CH4 9AY, CH4 9AZ, CH4 9BA, CH4 9BT, CH4 9BU, CH4 9BX, CH4 9DX, CH4 9DZ",258,237,21
W00001626,CH4,"CH4 9AA, CH4 9AS, CH4 9AT, CH4 9BG, CH4 9FW, CH4 9FX, CH4 9GF, CH4 9GG, CH4 9GN, CH4 9GW, CH4 9PA, CH4 9PD, CH4 9XA",399,348,51
W00001628,CH4,"CH4 9AB, CH4 9AR, CH4 9DY, CH4 9EH, CH4 9GD, CH4 9PF, CH4 9PG",321,289,32
W00001653,CH4,"CH4 9BP, LL12 9PP, LL12 9RF, LL12 9RH, LL12 9RL, LL12 9RN, LL12 9RP, LL12 9RQ, LL12 9RR, LL12 9RS, LL12 9RT, LL12 9RW, LL12 9SD",205,190,15
W00001654,CH4,"CH4 0HU, LL12 9NB, LL12 9ND, LL12 9NQ, LL12 9NX, LL12 9NZ, LL12 9PU, LL12 9RE, LL12 9RG",282,251,31
W00001625,CH4,"CH4 9AJ, CH4 9AL, CH4 9BE, CH4 9BF, CH4 9BN, CH4 9BY, CH4 9PB",384,346,38
W00001624,CH4,"CH4 0EX, CH4 9AH, CH4 9AN, CH4 9AP, CH4 9AQ, CH4 9AU, CH4 9AW, CH4 9AX, CH4 9BB, CH4 9BD, CH4 9BH, CH4 9BJ, CH4 9BL, CH4 9BQ, CH4 9BR, CH4 9BS, CH4 9BZ, CH4 9DA, CH4 9DB, CH4 9DD, CH4 9EA",321,291,30
W00001484,CH5,"CH5 4BW, CH5 4DN, CH5 4GG, CH5 4GY, CH5 4GZ",294,269,25
W00001485,CH5,"CH5 4QU, CH5 4RL, CH5 4WY, CH5 4WZ, CH5 4YH, CH5 4YQ",304,277,27
W00001468,CH5,"CH5 4SJ, CH5 4SL, CH5 4SP, CH5 4SQ, CH5 4SZ, CH5 4WW",294,272,22
W00001486,CH5,"CH5 4WB, CH5 4WG, CH5 4XJ, CH5 4XL",311,289,22
W00001467,CH5,"CH5 4FH, CH5 4SE, CH5 4SF, CH5 4SX, CH5 4TS, CH5 4XW, CH5 4XZ, CH5 4ZJ",290,261,29
W00001469,CH5,"CH5 4QE, CH5 4QF, CH5 4QP, CH5 4RD, CH5 4SG, CH5 4UH",235,222,13
W00001475,CH5,"CH5 4DB, CH5 4DL, CH5 4DP, CH5 4DR, CH5 4DW, CH5 4DZ, CH5 4ET, CH5 4EU, CH5 4EY, CH5 4EZ, CH5 4FN, CH5 4RQ, CH5 4WR, CH5 4WT",216,211,5
W00001487,CH5,"CH5 4GW, CH5 4RJ, CH5 4UD, CH5 4UE, CH5 4YA, CH5 4YB, CH5 4YD, CH5 4YL",274,246,28
W00001488,CH5,"CH5 4RT, CH5 4RW, CH5 4UF, CH5 4UG, CH5 4UJ, CH5 4UL, CH5 4UP, CH5 4UQ, CH5 4WL",292,255,37
W00001796,CH5,"CH5 1AL, CH5 1AN, CH5 1AS, CH5 1AX, CH5 1BB, CH5 1BD, CH5 1BE",292,275,17
W00001797,CH5,"CH5 1AY, CH5 1BG, CH5 1BH, CH5 1BQ, CH5 1QS, CH5 1QY, CH5 1QZ, CH5 1RA, CH5 1RE",279,251,28
W00001527,CH5,"CH5 3AY, CH5 3AZ, CH5 3BB, CH5 3BE, CH5 3BW, CH5 3EA, CH5 3GY, CH5 3UP, CH5 3UR, CH7 3LN, CH7 3LP, CH7 3LR, CH7 3LS, CH7 3LT, CH7 3LU, CH7 3LW, CH7 3LX, CH7 3LZ, CH7 3PZ",348,321,27
W00001528,CH5,"CH5 3DT, CH5 3DX, CH5 3DY, CH5 3DZ, CH5 3EB, CH5 3ED, CH5 3FF, CH5 3JD, CH5 3JJ, CH5 3JQ, CH5 3JW, CH5 3NH, CH5 3UZ, CH5 3WD, CH5 3WG, CH5 3WY, CH5 3WZ, CH5 3XT, CH5 3XU, CH5 3YB, CH5 3ZB, CH5 3ZF, CH5 3ZH, CH5 3ZL, CH5 3ZT, CH5 3ZU, CH5 3ZW",301,281,20
W00001795,CH5,"CH5 1AH, CH5 1AP, CH5 1AW, CH5 1BF, CH5 1QH, CH5 1QQ, CH5 1QT, CH5 1QW",282,266,16
W00001794,CH5,"CH5 1AJ, CH5 1AR, CH5 1AT, CH5 1AU, CH5 1AZ, CH5 1BA, CH5 1BJ, CH5 1QA",318,291,27
W00001483,CH5,"CH5 4JG, CH5 4JQ, CH5 4RN, CH5 4RP, CH5 4WH, CH5 4WJ, CH5 4YG, CH5 4YJ",278,247,31
W00001482,CH5,"CH5 4JW, CH5 4XH, CH5 4XQ, CH5 4YN",317,300,17
W00001471,CH5,"CH5 4QA, CH5 4QB, CH5 4QD, CH5 4SA, CH5 4SB",215,198,17
W00001481,CH5,"CH5 4DT, CH5 4JH, CH5 4WD, CH5 4WE, CH5 4WF, CH5 4WP, CH5 4WQ, CH5 4WS",286,260,26
W00001480,CH5,"CH5 4UU, CH5 4UX, CH5 4UY, CH5 4UZ, CH5 4XB, CH5 4XG, CH5 4ZZ",341,308,33
W00001479,CH5,"CH5 4BE, CH5 4BF, CH5 4BG, CH5 4BQ, CH5 4BU, CH5 4BX, CH5 4FA, CH5 4FB",297,275,22
W00001472,CH5,"CH5 4NP, CH5 4QN, CH5 4RA, CH5 4RB",282,255,27
W00001530,CH5,"CH5 3LQ, CH5 3SA, CH5 3SB, CH5 3SD, CH5 3SE, CH5 3SJ",309,285,24
W00001478,CH5,"CH5 4NS, CH5 4NT, CH5 4QG, CH5 4QH, CH5 4QJ, CH5 4QQ",312,290,22
W00001477,CH5,"CH5 4DQ, CH5 4NR, CH5 4NW, CH5 4PL",221,197,24
W00001476,CH5,"CH5 2LW, CH5 2NH, CH5 2UL, CH5 4DH, CH5 4DJ, CH5 4DS, CH5 4DU, CH5 4EB, CH5 4ED, CH5 4EE, CH5 4EF, CH5 4EG, CH5 4EH, CH5 4EQ",354,331,23
W00001473,CH5,"CH5 4AA, CH5 4AB, CH5 4AD, CH5 4AE, CH5 4AF, CH5 4AH, CH5 4AN, CH5 4AP, CH5 4AT, CH5 4AU, CH5 4AW, CH5 4BS, CH5 4DX, CH5 4DY, CH5 4FQ, CH5 4PN, CH5 4UW",338,309,29
W00010474,CH5,"CH5 4EA, CH5 4ES, CH5 4FE, CH5 4FF, CH5 4FP, CH5 4GH, CH5 4GJ, CH5 4ZE",468,414,54
W00010473,CH5,"CH5 4QS, CH5 4ZA, CH5 4ZB, CH5 4ZD, CH5 4ZP, CH5 4ZS, CH5 4ZW",205,179,26
W00001474,CH5,"CH5 4AL, CH5 4BD, CH5 4SU, CH5 4US, CH5 4UT, CH5 4WA",295,270,25
W00001470,CH5,"CH5 4SN, CH5 4SR, CH5 4SS, CH5 4ST, CH5 4SW, CH5 4TR",283,262,21
W00001798,CH5,"CH5 1LN, CH5 1LP, CH5 1LR, CH5 1LW, CH5 1LX, CH5 1ND, CH5 1NE, CH5 1NF, CH5 1NG, CH5 1NQ",285,269,16
W00001623,CH5,"CH5 3DW, CH5 3LL, CH5 3LR, CH5 3LW, CH5 3NB, CH5 3QN, CH5 3QR",156,144,12
W00001680,CH5,"CH5 2BG, CH5 2BJ, CH5 2BL, CH5 2BN, CH5 2BU, CH5 2BY, CH5 2BZ, CH5 2EE, CH5 2QL, CH5 2QW, CH5 3PA, CH5 3PF, CH5 3PG, CH5 3PN, CH5 3PQ",365,336,29
W00001617,CH5,"CH5 3HB, CH5 3HD, CH5 3HE, CH5 3HG, CH5 3HJ, CH5 3HQ, CH5 3HU, CH5 3JB",493,428,65
W00001805,CH5,"CH5 1LD, CH5 1LS, CH5 1LU, CH5 1NU, CH5 1NX, CH5 1NY, CH5 1NZ, CH5 1PA, CH5 1PN, CH5 1QE, CH5 1QR",277,261,16
W00001806,CH5,"CH5 1DD, CH5 1DE, CH5 1DS, CH5 1DZ, CH5 1EA, CH5 1GA, CH5 1GB, CH5 1GE, CH5 1GF, CH5 1GG, CH5 1GH, CH5 1GJ, CH5 1HA, CH5 1HB, CH5 1HZ, CH5 1JA, CH5 1JB, CH5 1JD, CH5 1JE",344,303,41
W00001807,CH5,"CH5 1EF, CH5 1HP, CH5 1HU, CH5 1HX, CH5 1HY, CH5 1RF, CH5 1RG, CH5 4ZF",269,252,17
W00001808,CH5,"CH5 1BT, CH5 1BU, CH5 1BX, CH5 1DF, CH5 1DL, CH5 1DN, CH5 1DR, CH5 1DW, CH5 1QG",288,272,16
W00001809,CH5,"CH5 1BY, CH5 1DP, CH5 1DT, CH5 1DU, CH5 1DX, CH5 1ED, CH5 1TW",296,280,16
W00001804,CH5,"CH5 1LF, CH5 1LG, CH5 1LH, CH5 1LJ, CH5 1LT, CH5 1LZ, CH5 1NN, CH5 1NS, CH5 1NT",285,265,20
W00001810,CH5,"CH5 1BZ, CH5 1DA, CH5 1DB, CH5 1DG, CH5 1EE, CH5 1EL, CH5 1EP, CH5 1ES, CH5 1ET, CH5 1EW, CH5 1EX, CH5 1EY, CH5 1EZ, CH5 1HG, CH5 1HH, CH5 1HL, CH5 1HQ",371,335,36
W00001812,CH5,"CH5 1HE, CH5 1HF, CH5 1HJ, CH5 1HN, CH5 1HR, CH5 1HS, CH5 1HT, CH5 1HW",272,251,21
W00001618,CH5,"CH5 3HR, CH5 3HS, CH5 3HT",269,248,21
W00001619,CH5,"CH5 3DD, CH5 3DL, CH5 3DR, CH5 3DS, CH5 3EE, CH5 3EF, CH5 3FL, CH5 3LS",295,269,26
W00001620,CH5,"CH5 3DF, CH5 3DG, CH5 3DH, CH5 3DQ, CH5 3FB, CH5 3FD, CH5 3GL, CH5 3LN, CH5 3NE, CH5 3RZ",209,186,23
W00001621,CH5,"CH5 3DE, CH5 3GX, CH5 3LT, CH5 3NL, CH5 3NN, CH5 3NP, CH5 3NR, CH5 3NS, CH5 3NX, CH5 3NY, CH5 3NZ, CH5 3PB, CH5 3PD, CH5 3PE, CH5 3PH, CH5 3PX, CH5 3PY, CH5 3QU",220,202,18
W00001425,CH5,"CH5 3BQ, CH7 3NS, CH7 3NT, CH7 6FS, CH7 6FT, CH7 6HD, CH7 6HG, CH7 6LG, CH7 6LH, CH7 6NY, CH7 6NZ, CH7 6RJ, CH7 6RL, CH7 6RN, CH7 6RW, CH7 6SB",238,217,21
W00001811,CH5,"CH5 1DY, CH5 1EB, CH5 1JW, CH5 1PE, CH5 1PF",254,231,23
W00001803,CH5,"CH5 1LY, CH5 1NA, CH5 1NH, CH5 1NJ, CH5 1NL, CH5 1NW, CH5 1PB, CH5 1PD, CH5 1PJ, CH5 1PL",229,212,17
W00001534,CH5,"CH5 3JA, CH5 3JT, CH5 3JU, CH5 3JY",205,195,10
W00001802,CH5,"CH5 1JR, CH5 1JZ, CH5 1LB, CH5 1LE",339,315,24
W00001679,CH5,"CH5 2BH, CH5 2BP, CH5 2BQ, CH5 2BS, CH5 2BW, CH5 2EZ",197,186,11
W00001678,CH5,"CH5 2DX, CH5 2DY, CH5 2ED, CH5 2EF, CH5 2EG, CH5 2EJ, CH5 2ES, CH5 2ET, CH5 2EU",240,226,14
W00001677,CH5,"CH5 2AR, CH5 2BE, CH5 2BR, CH5 2BX",289,272,17
W00001676,CH5,"CH5 2AX, CH5 2EL, CH5 2EP, CH5 2ER, CH5 2EW",255,237,18
W00001531,CH5,"CH5 3RX, CH5 3TP, CH5 3TW, CH5 3TX, CH5 3TZ, CH5 3UG, CH5 3UH, CH5 3UJ, CH5 3UL, CH5 3UN, CH5 3UQ, CH5 3UT, CH5 3UX, CH5 3XA, CH5 3XD, CH5 3XE, CH5 3XF, CH5 3XJ, CH5 3XP, CH5 3XW, CH5 3YA, CH5 3YE, CH5 3YF",406,355,51
W00001675,CH5,"CH5 2BF, CH5 2EH, CH5 2EN, CH5 2EQ, CH5 2EX, CH5 2EY, CH5 2GA, CH5 2GB",301,290,11
W00001622,CH5,"CH5 3HH, CH5 3HL, CH5 3HN, CH5 3HP, CH5 3HW",254,230,24
W00001672,CH5,"CH5 2BB, CH5 3HF, CH5 3HX, CH5 3HY, CH5 3HZ",283,253,30
W00001671,CH5,"CH5 1BW, CH5 2AF, CH5 2AH, CH5 2AS, CH5 2AT, CH5 2AU, CH5 2AY, CH5 2AZ, CH5 2BA",258,231,27
W00001532,CH5,"CH5 3GA, CH5 3GR, CH5 3JG, CH5 3LE, CH5 3LF, CH5 3LG, CH5 3UA, CH5 3UD, CH5 3UE, CH5 3UU, CH5 3UY",375,344,31
W00001533,CH5,"CH5 3LD, CH5 3TA, CH5 3TB, CH5 3TD, CH5 3TF, CH5 3TG, CH5 3TN, CH5 3TQ, CH5 3TR, CH5 3TT, CH5 3TY",335,289,46
W00001799,CH5,"CH5 1JT, CH5 1JU, CH5 1LL, CH5 1LQ, CH5 1SE, CH5 1TJ, CH5 1TP, CH5 1TQ, CH5 1TR",314,280,34
W00001800,CH5,"CH5 1XS, CH5 1XU, CH5 1XX, CH5 1XY, CH5 1XZ, CH5 1YA, CH5 1YB, CH5 1YD, CH5 1YF, CH5 1YJ, CH5 1YN, CH5 1YP, CH5 1YR, CH5 1YT, CH5 1YU, CH5 1YW, CH5 1YZ",353,324,29
W00001489,CH5,"CH5 4FJ, CH5 4RH, CH5 4RR, CH5 4RS, CH5 4SD, CH5 4SH, CH5 4WX, CH7 6BX, CH7 6DF, CH7 6DQ, CH7 6DW, CH7 6EP",466,416,50
W00001801,CH5,"CH5 1AE, CH5 1BP, CH5 1BR, CH5 1EH, CH5 1JG, CH5 1JP, CH5 1JS, CH5 1JX, CH5 1JY, CH5 1LA, CH5 1QD, CH5 1QP, CH5 1QU, CH5 1SD, CH5 1YS, CH5 1ZB, CH5 1ZD, CH5 1ZF, CH5 1ZG, CH5 1ZH, CH5 1ZJ, CH5 1ZL, CH5 1ZN",450,413,37
W00001681,CH5,"CH5 2AB, CH5 2FA, CH5 2FB, CH5 2FD, CH5 2FE, CH5 2TX",317,285,32
W00001674,CH5,"CH5 2AJ, CH5 2AN, CH5 2AP, CH5 2AW",304,282,22
W00001491,CH5,"CH5 4UR, CH5 4YP, CH5 4YR, CH5 4YS, CH5 4YT, CH5 4YU, CH5 4YW, CH5 4YX",150,144,6
W00001345,CH5,"CH5 3RA, CH5 3RD, CH5 3RF, CH5 3RG, CH5 3RH, CH5 3RL, CH5 3RN, CH5 3RQ",285,262,23
W00010455,CH5,"CH5 1EG, CH5 1EJ, CH5 1SA, CH5 1SB, CH5 1SF, CH5 1SL, CH5 1SN, CH5 1SP, CH5 1SQ, CH5 1SR, CH5 1SS, CH5 1ST, CH5 1SU, CH5 1SW, CH5 1SX, CH5 1SY, CH5 1TD, CH5 1TE, CH5 1TF, CH5 1TG, CH5 1WZ, CH5 1ZA, CH5 1ZE, CH5 1ZP, CH5 1ZQ, CH5 1ZT, CH5 1ZU, CH5 2DU, CH5 2DW, CH5 2EB, CH5 2LP, CH5 2TA, CH5 2TB, CH5 2TD, CH5 2TE, CH5 2TF, CH5 2WB, CH5 2WD, CH5 2WE, CH5 2WF, CH5 2WG, CH5 2WH, CH5 2WJ, CH5 2WL, CH5 2WN, CH5 2WP, CH5 2WQ, CH5 2WW, CH5 2XB, CH5 2YB, CH5 2YL, CH5 2ZA, CH5 2ZB, CH5 2ZF, CH5 2ZH, CH5 2ZJ, CH5 2ZL, CH5 2ZQ, CH5 2ZX, CH5 3WA, CH5 3WB, CH5 3WE, CH5 3WF, CH5 3WH, CH5 3WJ, CH5 3WL, CH5 3WN, CH5 3WP, CH5 3WQ, CH5 3WR, CH5 3WS, CH5 3WT, CH5 3WU, CH5 3WW, CH5 3WX, CH5 3XH, CH5 3XS, CH5 3XX, CH5 3XY, CH5 3XZ, CH5 3YD, CH5 3YH, CH5 3YJ, CH5 3YL, CH5 3YQ, CH5 3YR, CH5 3YS, CH5 3YT, CH5 3ZA, CH5 3ZD, CH5 3ZE, CH5 3ZG, CH5 3ZJ, CH5 3ZN, CH5 3ZP, CH5 3ZQ, CH5 3ZR, CH5 3ZS, CH5 3ZY, CH5 4ZG, CH5 4ZH, CH5 4ZN, CH5 4ZQ, CH5 4ZX, CH5 4ZY, CH5 9AA, CH5 9AB, CH5 9AD, CH5 9AE, CH5 9AF, CH5 9AH, CH5 9AJ, CH5 9AL, CH5 9AN, CH5 9AP, CH5 9AQ, CH5 9AR, CH5 9AS, CH5 9AT, CH5 9AU, CH5 9AW, CH5 9AX, CH5 9AY, CH5 9AZ, CH5 9BA, CH5 9BB, CH5 9BD, CH5 9BE, CH5 9BF, CH5 9BG, CH5 9BH, CH5 9BJ, CH5 9BL, CH5 9BN, CH5 9BP, CH5 9BQ, CH5 9BR, CH5 9BS, CH5 9BT, CH5 9BU, CH5 9BW, CH5 9BX, CH5 9BY, CH5 9BZ, CH5 9DA, CH5 9DB, CH5 9DD, CH5 9DF, CH5 9DG, CH5 9DH, CH5 9DJ, CH5 9DL, CH5 9DN, CH5 9DP, CH5 9DQ, CH5 9DR, CH5 9DS, CH5 9DT, CH5 9DU, CH5 9DW, CH5 9DX, CH5 9DY, CH5 9DZ, CH5 9EA, CH5 9EB, CH5 9ED, CH5 9EE, CH5 9EF, CH5 9EG, CH5 9EH, CH5 9EL, CH5 9EN, CH5 9EP, CH5 9EQ, CH5 9ER, CH5 9ES, CH5 9ET, CH5 9EU, CH5 9EW, CH5 9EX, CH5 9EY, CH5 9EZ, CH5 9FA, CH5 9FB, CH5 9FD, CH5 9FE, CH5 9FF, CH5 9FG, CH5 9FH, CH5 9FJ, CH5 9FL, CH5 9FN, CH5 9FP, CH5 9FQ, CH5 9FR, CH5 9WL, CH5 9WS, CH5 9WT, CH5 9WW, CH5 9ZF, CH5 9ZN, CH5 9ZQ, CH5 9ZW",321,300,21
W00010454,CH5,"CH5 3GD, CH5 3GE, CH5 3GF, CH5 3GG, CH5 3GH, CH5 3UB, CH5 3UW, CH5 3XB, CH5 3XN, CH5 3XR",338,307,31
W00001793,CH5,"CH5 1AD, CH5 1JJ, CH5 1PP, CH5 1PU, CH5 1PX, CH5 1PY, CH5 1PZ, CH5 1QB, CH5 1QJ, CH5 1QL, CH5 1QN, CH5 1QX",251,232,19
W00001792,CH5,"CH5 1AA, CH5 1AB, CH5 1AF, CH5 1AG, CH5 1AQ, CH5 1DH, CH5 1DJ, CH5 1DQ",278,249,29
W00001791,CH5,"CH5 2HN, CH5 2HP, CH5 2HZ, CH5 2JA, CH5 2JE, CH5 2JL",307,283,24
W00001789,CH5,"CH5 2GE, CH5 2GG, CH5 2HJ, CH5 2HQ, CH5 2JB, CH5 2JD, CH5 2RA, CH5 2RW, CH5 2TW, CH5 2UA, CH5 2WA, CH5 2XA, CH5 2XD",255,243,12
W00001787,CH5,"CH5 2HT, CH5 2SH, CH5 2SL, CH5 2SN, CH5 2SP, CH5 2SR, CH5 2SS, CH5 2ST, CH5 2SW",281,268,13
W00001526,CH5,"CH5 3DP, CH5 3JP, CH5 3JR, CH5 3JX, CH5 3LA, CH5 3LH, CH5 3LJ, CH5 3LP, CH5 3QS, CH5 3RY, CH5 3SS",412,375,37
W00001786,CH5,"CH5 2HH, CH5 2HL, CH5 2HS, CH5 2HU, CH5 2HX, CH5 2HY, CH5 2JJ",315,295,20
W00001785,CH5,"CH5 2GF, CH5 2JR, CH5 2JS, CH5 2JT, CH5 2JU, CH5 2RL, CH5 2RN",261,244,17
W00001784,CH5,"CH5 2JF, CH5 2JG, CH5 2JH, CH5 2JN, CH5 2JP, CH5 2JQ, CH5 2JW, CH5 2JX",287,267,20
W00001783,CH5,"CH5 2RJ, CH5 2SA, CH5 2SB, CH5 2SD, CH5 2SE, CH5 2SF, CH5 2SG, CH5 2SJ, CH5 2SQ",433,393,40
W00001525,CH5,"CH5 3GB, CH5 3JS, CH5 3JZ, CH5 3NJ, CH5 3NT, CH5 3NW, CH5 3QD, CH5 3QE, CH5 3QF, CH5 3QT",335,305,30
W00001766,CH5,"CH5 2PB, CH5 2PF, CH5 2PG, CH5 2PH, CH5 2PQ, CH5 2PU, CH5 2QG, CH5 2QU, CH5 2UW",250,240,10
W00001765,CH5,"CH5 2AL, CH5 2DA, CH5 2DB, CH5 2DD, CH5 2DE, CH5 2DF, CH5 2DG, CH5 2DH, CH5 2DJ, CH5 2DL, CH5 2DN, CH5 2DP, CH5 2DQ, CH5 2DR, CH5 2DS, CH5 2DT, CH5 2DZ, CH5 2EA, CH5 2QA, CH5 2QD, CH5 2QJ, CH5 2QQ, CH5 2RE, CH5 2ZD, CH5 2ZE, CH5 2ZG",282,264,18
W00001763,CH5,"CH5 1BS, CH5 1SZ, CH5 1TA, CH5 1TB",263,245,18
W00001352,CH5,"CH5 3DN, CH5 3EP, CH5 3EW, CH5 3RP, CH5 3RT",217,200,17
W00001498,CH5,"CH5 4NJ, CH5 4PP, CH5 4PS, CH5 4PY, CH5 4PZ",229,212,17
W00001497,CH5,"CH5 4TH, CH5 4TP, CH5 4TT, CH5 4TU, CH5 4TX, CH5 4TY, CH5 4TZ, CH5 4UA, CH5 4UB",329,301,28
W00001496,CH5,"CH5 4HD, CH5 4NB, CH5 4NE, CH5 4NG, CH5 4PX",237,221,16
W00001495,CH5,"CH5 4JJ, CH5 4JN, CH5 4XS, CH5 4XT, CH5 4XU, CH5 4YE",287,263,24
W00010022,CH5,"CH5 2AA, CH5 2AD, CH5 2AE, CH5 2AG, CH5 2BD, CH5 2TT, CH5 2TY, CH5 2TZ, CH5 2YA, CH5 2YW",389,374,15
W00010017,CH5,"CH5 3JE, CH5 3LY, CH5 3XG, CH5 3XL, CH5 3XQ",285,243,42
W00001501,CH5,"CH5 4GL, CH5 4GN, CH5 4GP, CH5 4GR, CH5 4GS, CH5 4GT, CH5 4GU, CH5 4GX, CH5 4HY, CH7 6BY, CH7 6BZ",337,312,25
W00001760,CH5,"CH5 2FF, CH5 2FG, CH5 2PA, CH5 2PD, CH5 2PE, CH5 2PT, CH5 2PW, CH5 2PX, CH5 2PY, CH5 2QB, CH5 2QE, CH5 2QF, CH5 2QH, CH5 2QN, CH5 2QP, CH5 2QS, CH5 2QX, CH5 2QY, CH5 2QZ",472,436,36
W00001347,CH5,"CH5 3AD, CH5 3AH, CH5 3AJ, CH5 3BZ, CH5 3EY, CH5 3EZ, CH5 3FE, CH5 3RW",332,303,29
W00001348,CH5,"CH5 1UP, CH5 1US, CH5 1UW, CH5 1XH, CH5 1XP, CH5 1XR, CH5 1XT, CH5 3AA, CH5 3AB, CH5 3AE, CH5 3AF, CH5 3AG, CH5 3EU",242,211,31
W00001349,CH5,"CH5 3AP, CH5 3AR, CH5 3AS, CH5 3AT, CH5 3BS, CH5 3BU, CH5 3BY, CH5 3DU, CH5 3GJ, CH5 3RU",430,380,50
W00001350,CH5,"CH5 3AL, CH5 3AN, CH5 3AW, CH5 3BF, CH5 3RB, CH5 3RE, CH5 3RJ, CH5 3RR, CH5 3RS",287,263,24
W00001351,CH5,"CH5 3EN, CH5 3ER, CH5 3ES, CH5 3ET",285,263,22
W00001490,CH5,"CH5 4BH, CH5 4BJ, CH5 4BL, CH5 4BR, CH5 4BZ, CH5 4DG, CH6 5GX, CH6 5SJ, CH6 5TE, CH6 5TF, CH6 5TH",301,279,22
W00001761,CH5,"CH5 2PJ, CH5 2PL, CH5 2PN, CH5 2PP, CH5 2PR, CH5 2PS, CH5 2PZ",278,260,18
W00001500,CH5,"CH5 4HH, CH5 4PR, CH5 4PU, CH5 4QT, CH5 4QZ, CH5 4RU, CH5 4RX, CH5 4RY, CH5 4RZ",285,257,28
W00010465,CH5,"CH5 2FN, CH5 2FS, CH5 2FT, CH5 2FY, CH5 2FZ, CH5 2RG, CH5 2RQ",140,134,6
W00001509,CH5,"CH5 4FX, CH5 4FZ, CH5 4GA, CH5 4QR, CH5 4QY, CH5 4UN",325,295,30
W00001512,CH5,"CH5 4JP, CH5 4JT, CH5 4JU, CH5 4LA, CH5 4LQ, CH5 4ND, CH5 4NF, CH5 4NQ, CH5 4QX",259,234,25
W00001513,CH5,"CH5 4BT, CH5 4HF, CH5 4HG, CH5 4HJ, CH5 4HN, CH5 4HP, CH5 4HR, CH5 4HS, CH5 4NN",305,289,16
W00001514,CH5,"CH5 4HL, CH5 4HT, CH5 4HU, CH5 4HW, CH5 4HX, CH5 4HZ, CH5 4JB, CH5 4JD",299,277,22
W00001515,CH5,"CH5 2LF, CH5 2LL, CH5 4DD, CH5 4DE, CH5 4DF, CH5 4EJ, CH5 4ER, CH5 4EW, CH5 4FL, CH5 4NL, CH5 4NU, CH5 4NX, CH5 4PQ, CH5 4WN",444,403,41
W00001516,CH5,"CH5 4DA, CH5 4EN, CH5 4HA, CH5 4HB, CH5 4NZ, CH5 4PH, CH5 4PJ",319,301,18
W00001492,CH5,"CH5 4BB, CH5 4BN, CH5 4BY, CH5 4EX, CH5 4YF",285,262,23
W00001511,CH5,"CH5 4LE, CH5 4LG, CH5 4LP, CH5 4LR, CH5 4LS",299,268,31
W00001517,CH5,"CH5 4FD, CH5 4FG, CH5 4NY, CH5 4PA, CH5 4PD, CH5 4PE, CH5 4PF, CH5 4PG, CH5 4QL",368,347,21
W00001519,CH5,"CH5 4JE, CH5 4JF, CH5 4PB",269,250,19
W00001520,CH5,"CH5 3BH, CH5 3BT, CH5 3BX, CH5 3DA, CH5 3DB, CH5 3FJ, CH5 3HA",333,307,26
W00001521,CH5,"CH5 3AQ, CH5 3AU, CH5 3AX, CH5 3BD, CH5 3BG, CH5 3BJ, CH5 3BL, CH5 3BN, CH5 3BP, CH5 3BR, CH5 3FA, CH5 3GU, CH5 3GW, CH7 6HB",419,367,52
W00001522,CH5,"CH5 3DJ, CH5 3EG, CH5 3EH, CH5 3EJ, CH5 3EL, CH5 3EQ, CH5 3GZ, CH5 3NG, CH5 3NQ, CH5 3QG, CH5 3QH, CH5 3QJ, CH5 3QL, CH5 3QQ",301,265,36
W00001523,CH5,"CH5 3JH, CH5 3JL, CH5 3JN, CH5 3SF, CH5 3SG, CH5 3SH, CH5 3SL, CH5 3SQ",320,298,22
W00001524,CH5,"CH5 3JF, CH5 3LB, CH5 3TE, CH5 3TH, CH5 3TJ, CH5 3TS, CH5 3TU, CH5 3UF",356,320,36
W00001518,CH5,"CH5 4EL, CH5 4JA, CH5 4LY, CH5 4QW, CH5 4RE, CH5 4RF, CH5 4RG",248,227,21
W00001510,CH5,"CH5 4FT, CH5 4GB, CH5 4GD, CH5 4GE, CH5 4GQ, CH5 4HQ, CH5 4LH",508,472,36
W00001346,CH5,"CH5 1BL, CH5 1BN, CH5 1QF, CH5 1RB, CH5 1RD, CH5 1UB, CH5 1UD, CH5 1XE, CH5 1XL",257,231,26
W00001508,CH5,"CH5 4FW, CH5 4FY, CH5 4GF, CH5 4HE, CH5 4LZ, CH5 4NH, CH5 4PT, CH5 4PW",419,370,49
W00001502,CH5,"CH5 4TJ, CH5 4TL, CH5 4TN, CH5 4TW, CH5 4XN",274,258,16
W00010471,CH5,"CH5 2FH, CH5 2FJ, CH5 2FL, CH5 2FP, CH5 2FQ, CH5 2FR, CH5 2FW, CH5 2FX, CH5 2HR, CH5 2HW, CH5 2JY, CH5 2JZ, CH5 2LA, CH5 2LB, CH5 2LD, CH5 2LE, CH5 2LG, CH5 2LH, CH5 2LJ, CH5 2LN, CH5 2LR, CH5 2LS, CH5 2LT, CH5 2LU, CH5 2LX, CH5 2LY, CH5 2LZ, CH5 2NA, CH5 2NB, CH5 2ND, CH5 2NE, CH5 2NF, CH5 2NG, CH5 2NL, CH5 2NN, CH5 2NP, CH5 2NQ, CH5 2NR, CH5 2NS, CH5 2NT, CH5 2NU, CH5 2NW, CH5 2NX, CH5 2NY, CH5 2NZ, CH5 2QR, CH5 2RB, CH5 2RD, CH5 2RF, CH5 2RH",447,411,36
W00001353,CH5,"CH5 1UA, CH5 1UH, CH5 1XA, CH5 1XD, CH5 1XJ, CH5 1XQ",255,244,11
W00001494,CH5,"CH5 4AS, CH5 4XA, CH5 4XD, CH5 4XE, CH5 4XF, CH5 4XX, CH5 4XY",299,283,16
W00001493,CH5,"CH5 4AG, CH5 4AJ, CH5 4AQ, CH5 4AR, CH5 4AX, CH5 4AY, CH5 4AZ, CH5 4BA, CH5 4BP",285,265,20
W00001354,CH5,"CH5 1UJ, CH5 1XB, CH5 1XF, CH5 1XG",227,217,10
W00001503,CH5,"CH5 4EP, CH5 4TA, CH5 4TB, CH5 4TD, CH5 4TE, CH5 4TG, CH5 4TQ, CH5 4XR, CH5 4ZT, CH5 4ZU",234,218,16
W00001504,CH5,"CH5 4JL, CH5 4JR, CH5 4JS, CH5 4LB, CH5 4LF",253,243,10
W00001505,CH5,"CH5 4JZ, CH5 4LL, CH5 4SY, CH5 4TF, CH5 4XP",290,271,19
W00001506,CH5,"CH5 4JX, CH5 4JY, CH5 4LD, CH5 4LT, CH5 4LU, CH5 4LX",308,283,25
W00001507,CH5,"CH5 4LJ, CH5 4LN, CH5 4LW, CH5 4NA",305,273,32
W00001355,CH5,"CH5 1TL, CH5 1UL, CH5 1UN, CH5 1UQ, CH5 1UR, CH5 2AQ, CH5 2BT, CH5 3BA, CH5 3EX, CH5 3TL",290,270,20
W00001580,CH6,"CH6 5PA, CH6 5PB, CH6 5PL, CH6 5PY, CH6 5QD, CH6 5QH, CH6 5QJ, CH6 5US",337,307,30
W00001582,CH6,"CH6 5BN, CH6 5FZ, CH6 5LL, CH6 5PW, CH6 5QG, CH6 5QN, CH6 5QP, CH6 5QQ, CH6 5QT, CH6 5QU, CH6 5SG, CH6 5UL, CH6 5WA",438,388,50
W00001581,CH6,"CH6 5LY, CH6 5PN, CH6 5SA, CH6 5SH, CH6 5TA, CH6 5TB, CH6 5TP, CH6 5UP, CH6 5UT",323,284,39
W00001579,CH6,"CH6 5LZ, CH6 5QL, CH6 5TJ, CH6 5TN, CH6 5TQ, CH6 5TW",304,266,38
W00001640,CH6,"CH6 6JS, CH8 7BE, CH8 7BG, CH8 7BH, CH8 7BS, CH8 7BT, CH8 7BU, CH8 7EZ, CH8 7HL",275,236,39
W00001563,CH6,"CH6 5EY, CH6 5EZ, CH6 5HD, CH6 5RR, CH6 5TT",289,251,38
W00001578,CH6,"CH6 5LU, CH6 5LW, CH6 5LX, CH6 5NB, CH6 5ND",276,240,36
W00001547,CH6,"CH6 5DS, CH6 5JD, CH6 5JF, CH6 5JT",317,276,41
W00001548,CH6,"CH6 5PD, CH6 5PE, CH6 5PH, CH6 5PJ, CH6 5PS, CH6 5PT, CH6 5XA",246,225,21
W00001549,CH6,"CH6 5AD, CH6 5AH, CH6 5AJ, CH6 5AY, CH6 5BB, CH6 5BD, CH6 5BE, CH6 5BJ, CH6 5BL, CH6 5BP, CH6 5DA, CH6 5DD, CH6 5DH, CH6 5DT, CH6 5GE, CH6 5LA, CH6 5NN, CH6 5NQ, CH6 5NW, CH6 5PP, CH6 5PR, CH6 5SQ",323,297,26
W00001550,CH6,"CH6 5ET, CH6 5HE, CH6 5HF, CH6 5HL, CH6 5TS",412,362,50
W00001551,CH6,"CH6 5QZ, CH6 5RE, CH6 5RG, CH6 5XP",232,206,26
W00001552,CH6,"CH6 5AA, CH6 5AE, CH6 5AF, CH6 5AG, CH6 5AL, CH6 5AP, CH6 5AR, CH6 5AT, CH6 5BA, CH6 5BG, CH6 5BH, CH6 5BQ, CH6 5BW, CH6 5BY, CH6 5HB, CH6 5HG, CH6 5HJ, CH6 5HQ, CH6 5HX, CH6 5WE, CH6 5WS, CH6 5WW, CH6 5XB, CH6 5XD, CH6 5YJ, CH6 5YL, CH6 5YN, CH6 5ZP, CH6 5ZQ, CH6 5ZR, CH6 5ZW, CH6 6ZA, CH6 6ZD, CH6 6ZN, CH6 9AD, CH6 9AE, CH6 9AF, CH6 9AG, CH6 9AJ, CH6 9AL, CH6 9AN, CH6 9AP, CH6 9AQ, CH6 9AR, CH6 9AS, CH6 9AT, CH6 9AU, CH6 9AW, CH6 9AX, CH6 9AY, CH6 9AZ, CH6 9BA, CH6 9BB, CH6 9BD, CH6 9BE, CH6 9BF, CH6 9BG, CH6 9BH, CH6 9BJ, CH6 9BL, CH6 9BN, CH6 9BP, CH6 9BQ, CH6 9BR, CH6 9BS, CH6 9BT, CH6 9BU, CH6 9BW, CH6 9BX, CH6 9BY, CH6 9BZ, CH6 9DA, CH6 9DB, CH6 9DD, CH6 9DE, CH6 9DF, CH6 9DG, CH6 9DH, CH6 9DJ, CH6 9DL, CH6 9DN, CH6 9DP, CH6 9DQ, CH6 9DR, CH6 9DS, CH6 9DT, CH6 9DU, CH6 9DW, CH6 9DX, CH6 9DY, CH6 9DZ, CH6 9EA, CH6 9EB, CH6 9ED, CH6 9EE, CH6 9EF, CH6 9EG, CH6 9EH, CH6 9EJ, CH6 9EL, CH6 9EN, CH6 9EP, CH6 9EQ, CH6 9ER, CH6 9ES, CH6 9ET, CH6 9EU, CH6 9EW, CH6 9EX, CH6 9EY, CH8 7WA, CH8 7WB, CH8 7WE, CH8 7WH, CH8 7WJ, CH8 7WN, CH8 7WP, CH8 7WR, CH8 7WS, CH8 7WT, CH8 7WU, CH8 7WX, CH8 7WZ, CH8 7ZJ, CH8 7ZS, CH8 7ZW, CH8 8AB, CH8 8WA, CH8 8WD, CH8 8WE, CH8 8WF, CH8 8WG, CH8 8WH, CH8 8WJ, CH8 8WL, CH8 8WP, CH8 8WQ, CH8 8WR, CH8 8WS, CH8 8YA, CH8 8YR, CH8 8ZR, CH8 9ZA, CH8 9ZB, CH8 9ZE, CH8 9ZH, CH8 9ZJ, CH8 9ZL, CH8 9ZQ, CH8 9ZW",283,261,22
W00001553,CH6,"CH6 5HH, CH6 5HN, CH6 5HP, CH6 5HR, CH6 5HS, CH6 5HW",299,267,32
W00001546,CH6,"CH6 5AU, CH6 5DE, CH6 5DF, CH6 5DN, CH6 5DR, CH6 5DW",286,254,32
W00001554,CH6,"CH6 5GZ, CH6 5RF, CH6 5TX, CH6 5TZ",218,193,25
W00001556,CH6,"CH6 5AB, CH6 5HT, CH6 5HU, CH6 5HY, CH6 5HZ",314,280,34
W00001557,CH6,"CH6 5RN, CH6 5RW, CH6 5SW, CH6 5TR, CH6 5TY, CH6 5UA, CH6 5YH, CH6 5YP, CH6 5YW",254,228,26
W00001558,CH6,"CH6 5YG, CH6 5YS, CH6 5YT, CH6 5YU, CH6 5ZJ",239,215,24
W00001559,CH6,"CH6 5GW, CH6 5QX, CH6 5RB, CH6 5RQ, CH6 5RZ, CH6 5UJ, CH6 5UW",322,292,30
W00001560,CH6,"CH6 5UF, CH6 5UG, CH6 5UH, CH6 5UQ, CH6 5XW",254,211,43
W00001561,CH6,"CH6 5BR, CH6 5BS, CH6 5BU, CH6 5EP, CH6 5ER, CH6 5ES, CH6 5EX, CH6 5FA, CH6 5GB, CH6 5GD, CH6 5GQ, CH6 5NS",211,199,12
W00001562,CH6,"CH6 5AN, CH6 5AQ, CH6 5AW, CH6 5BT, CH6 5BZ",131,126,5
W00001555,CH6,"CH6 5RA, CH6 5RD, CH6 5RH, CH6 5RJ, CH6 5RP, CH6 5TU, CH6 5YA, CH6 5YB, CH6 5YE, CH6 5YR",345,302,43
W00001545,CH6,"CH6 5AS, CH6 5AZ, CH6 5DJ, CH6 5DL, CH6 5DP, CH6 5DQ, CH6 5JE, CH6 5NY, CH6 5UZ",303,277,26
W00010482,CH6,"CH6 5WB, CH6 5WT, CH6 5WU, CH6 5WX, CH6 5WY, CH6 5XF",368,318,50
W00010487,CH6,"CH6 5EA, CH6 5HA, CH6 5NP, CH6 5SP, CH6 5WR",208,179,29
W00001577,CH6,"CH6 5LH, CH6 5LJ, CH6 5LN, CH6 5LP, CH6 5LR, CH6 5LS, CH6 5LT",452,401,51
W00001576,CH6,"CH6 5LG, CH6 5NE, CH6 5NF, CH6 5NH, CH6 5QF",348,313,35
W00001575,CH6,"CH6 5JJ, CH6 5LQ",123,106,17
W00001574,CH6,"CH6 5NZ, CH6 5QR, CH6 5QS, CH6 5QW, CH6 5SL, CH6 5SN, CH6 5UN, CH6 5UR, CH6 5UU, CH6 5UX, CH7 6DL, CH7 6DN",243,210,33
W00001572,CH6,"CH6 5BF, CH6 5PU, CH6 5ST, CH6 5SU, CH6 5SX, CH6 5SY, CH6 5SZ, CH6 5TD, CH7 6DG",195,170,25
W00010463,CH6,"CH6 5FH, CH6 5GF, CH6 5GG, CH6 5GH, CH6 5GJ, CH6 5JB, CH6 5JL",139,126,13
W00010464,CH6,"CH6 5WD, CH6 5WF, CH6 5WG",141,121,20
W00010467,CH6,"CH6 5FJ, CH6 5FL, CH6 5FN, CH6 5FP, CH6 5FQ, CH6 5FR, CH6 5FS, CH6 5FT, CH6 5FW, CH6 5FX, CH6 5GL, CH6 5GN, CH6 5GP, CH6 5WH, CH6 5WJ, CH6 5WL, CH6 5WN, CH6 5WP, CH6 5WQ",576,495,81
W00001570,CH6,"CH6 5EG, CH6 5EN, CH6 5EQ, CH6 5EW, CH6 5SB",312,281,31
W00001569,CH6,"CH6 5EJ, CH6 5EL, CH6 5FY, CH6 5GY, CH6 5JA, CH6 5JX, CH6 5JY, CH6 5JZ",312,289,23
W00001568,CH6,"CH6 5JP, CH6 5JQ, CH6 5UB, CH6 5UD, CH6 5UE, CH6 5XE, CH6 5XN, CH6 5XQ, CH6 5XR, CH6 5XS, CH6 5XT",340,302,38
W00001566,CH6,"CH6 5DX, CH6 5JN, CH6 5JR, CH6 5JS, CH6 5JW",329,283,46
W00001565,CH6,"CH6 5DU, CH6 5DY, CH6 5DZ, CH6 5EB, CH6 5EH, CH6 5GA, CH6 5JG, CH6 5JH",315,280,35
W00001542,CH6,"CH6 5AX, CH6 5FB, CH6 5NT, CH6 5NU, CH6 5NX, CH6 5PF, CH6 5PG, CH6 5PQ",311,282,29
W00001543,CH6,"CH6 5DB, CH6 5DG, CH6 5FD, CH6 5FF, CH6 5FG, CH6 5LD, CH6 5LE, CH6 5LF, CH6 5NJ, CH6 5NR",173,152,21
W00001544,CH6,"CH6 5BX, CH6 5FE, CH6 5LB, CH6 5NA, CH6 5NG, CH6 5NL",151,136,15
W00010488,CH6,"CH6 5ED, CH6 5EU, CH6 5SD, CH6 5SE, CH6 5SF, CH6 5SR, CH6 5SS",304,262,42
W00001391,CH6,"CH6 5RL, CH6 6DU, CH6 6DX, CH8 8BA, CH8 8BD, CH8 8BS, CH8 8HA, CH8 8HJ, CH8 8HL, CH8 8HN, CH8 8HP, CH8 8HR, CH8 8HT, CH8 8HU, CH8 8HX, CH8 8HY, CH8 8JD, CH8 8LN",431,361,70
W00001573,CH6,"CH6 5PX, CH6 5PZ, CH6 5QA, CH6 5QB, CH6 5QE, CH6 5TG, CH6 5TL, CH6 5XG, CH6 5XH",536,466,70
W00001567,CH6,"CH6 5EE, CH6 5EF, CH6 5JU",440,396,44
W00001360,CH6,"CH6 6AP, CH6 6AR, CH6 6AS, CH6 6AT, CH6 6AU, CH6 6AX, CH6 6BB, CH6 6BD, CH6 6BE, CH6 6BJ, CH6 6BR, CH6 6BT, CH6 6DD",359,321,38
W00001356,CH6,"CH6 6BY, CH6 6BZ, CH6 6DA, CH6 6DN, CH6 6DP, CH6 6DR, CH6 6DS, CH6 6DT, CH6 6EA",419,382,37
W00001357,CH6,"CH6 6BS, CH6 6BU, CH6 6BX",298,269,29
W00001358,CH6,"CH6 6DB, CH6 6DE, CH6 6DF, CH6 6EE, CH6 6LS, CH6 6LT",284,253,31
W00001359,CH6,"CH6 5RS, CH6 5RT, CH6 5RU, CH6 5RX, CH6 5RY, CH6 5UY, CH6 6DH",184,153,31
W00001364,CH6,"CH6 6ER, CH6 6ET, CH6 6HG, CH6 6HZ, CH6 6JA, CH6 6JH, CH6 6LD, CH6 6LE, CH6 6LF, CH6 6LG, CH6 6LH, CH6 6LJ, CH6 6LL, CH6 6LN, CH6 6LP, CH6 6LQ, CH6 6LR, CH6 6LU, CH6 6LY",268,239,29
W00001368,CH6,"CH6 6JN, CH6 6JQ, CH6 6JR, CH6 6JU, CH6 6JW, CH8 7FA",304,267,37
W00001614,CH6,"CH6 5QY, CH7 6PR, CH7 6PU, CH8 8BT, CH8 8BU, CH8 8BX, CH8 8BY, CH8 8BZ, CH8 8DD, CH8 8DE, CH8 8DF, CH8 8DH, CH8 8DJ, CH8 8DL, CH8 8DP, CH8 8DT, CH8 8DY, CH8 8EH, CH8 8EQ",284,264,20
W00001363,CH6,"CH6 6JP, CH6 6JT, CH6 6JY, CH6 6JZ, CH6 6LW",270,233,37
W00001362,CH6,"CH6 6HD, CH6 6HE, CH6 6HJ, CH6 6HL, CH6 6HN, CH6 6HP, CH6 6HR, CH6 6HS, CH6 6HT, CH6 6HW, CH6 6JB, CH6 6JD, CH6 6JE, CH6 6JF, CH6 6JG, CH6 6JJ, CH6 6JL, CH6 6JX, CH6 6LA",406,364,42
W00001366,CH6,"CH6 6BN, CH6 6EH, CH6 6EJ, CH6 6EL, CH6 6EN, CH6 6EP, CH6 6ES, CH6 6EU, CH6 6EW, CH6 6EX, CH6 6FB",285,256,29
W00001367,CH6,"CH6 6AF, CH6 6AN, CH6 6AY, CH6 6BG, CH6 6BH, CH6 6BL, CH6 6BP, CH6 6BQ, CH6 6BW, CH6 6ED, CH6 6EF, CH6 6EG, CH6 6HF, CH6 6HH, CH6 6HQ",260,243,17
W00001365,CH6,"CH6 6EQ, CH6 6EY, CH6 6EZ, CH6 6HA, CH6 6HB, CH6 6HU, CH6 6HX, CH6 6HY",256,225,31
W00001361,CH6,"CH6 6BA, CH6 6DG, CH6 6DJ, CH6 6DL, CH6 6DQ, CH6 6DW, CH6 6DY, CH6 6DZ, CH6 6EB",244,213,31
W00001339,CH7,"CH7 6UF, CH7 6UH, CH7 6UP, CH7 6UR, CH7 6UY, CH7 6WG, CH7 6WQ",262,223,39
W00001338,CH7,"CH7 6UU, CH7 6UX, CH7 6XU, CH7 6XX, CH7 6XZ, CH7 6YB",297,253,44
W00001466,CH7,"CH7 5QR, CH7 5QT, CH7 5QU, CH7 5QX, CH7 5RA, CH7 5RB, CH7 5RD, CH7 5RE, CH7 5RF, CH7 5RG, CH7 5RJ, CH7 5RX",209,186,23
W00001465,CH7,"CH7 5QS, CH7 5RN, CH7 5RP, CH7 5RR, CH7 5RS, CH7 5RT, CH7 5RU, CH7 5RW, CH7 5UP",233,200,33
W00001464,CH7,"CH7 5HL, CH7 5HN, CH7 5HW, CH7 5QE",222,185,37
W00001461,CH7,"CH7 5HB, CH7 5HE, CH7 5HF, CH7 5HG, CH7 5HJ, CH7 5HQ, CH7 5HX, CH7 5HZ, CH7 5JH, CH7 5JJ, CH7 5JL, CH7 5QB, CH7 5QZ, CH7 5XD, CH7 5XZ, CH7 5ZT, CH7 6PD",287,237,50
W00001462,CH7,"CH7 5HA, CH7 5HD, CH7 5HH, CH7 5HP, CH7 5HR, CH7 5NE, CH7 5NH, CH7 5NN, CH7 5NP, CH7 5NU, CH7 5NW, CH7 5NX, CH7 5NY, CH7 5NZ, CH7 5PA, CH7 5PB, CH7 5QD, CH7 5QF, CH7 5QG, CH7 5QH, CH7 5QJ, CH7 5QL, CH7 5QN, CH7 5QQ, CH7 5QW, CH7 5ZE",415,341,74
W00001459,CH7,"CH7 5RQ, CH8 8BF, CH8 8JS, CH8 8LX, CH8 8LY, CH8 8LZ, CH8 8ND, CH8 8NF, CH8 8NQ, CH8 8PF, CH8 8PG, CH8 8PQ",339,259,80
W00001458,CH7,"CH7 5AB, CH7 5RH, CH7 5RL, CH7 5UW, CH8 8NA, CH8 8NB, CH8 8NE, CH8 8NJ, CH8 8NL, CH8 8NR, CH8 8PY, CH8 8QB, CH8 8TA",282,244,38
W00001337,CH7,"CH7 6TD, CH7 6TE, CH7 6UG, CH7 6UQ",307,261,46
W00001683,CH7,"CH7 1EP, CH7 1HP, CH7 1HT, CH7 1JA, CH7 1JD, CH7 1JP, CH7 1JZ, CH7 1PW, CH7 1YU, CH7 4GZ, CH7 4HD",240,193,47
W00001463,CH7,"CH7 5FF, CH7 5NF, CH7 5NL, CH7 5NR, CH7 5NS, CH7 5NT, CH7 5PD, CH7 5PE, CH7 5PF, CH7 5PG, CH7 5PH, CH7 5PJ, CH7 5PL, CH7 5PN, CH7 5PP, CH7 5PQ, CH7 5PR",389,311,78
W00001336,CH7,"CH7 6UJ, CH7 6UL, CH7 6XR, CH7 6XS",282,239,43
W00001081,CH7,"CH7 4BR, CH7 4BS, CH7 4BT, CH7 4BU, CH7 4BX, CH7 4BZ, CH7 4DB, CH7 4DD, CH7 4DE, CH7 4QB, CH7 4QS, CH7 4QT, CH7 4TD, CH7 5TD, CH7 5TG",268,206,62
W00001685,CH7,"CH7 1EU, CH7 1EZ, CH7 1HN, CH7 1HS, CH7 1HZ, CH7 1JB, CH7 1PL, CH7 1PQ, CH7 1WP, CH7 1WR",266,222,44
W00001701,CH7,"CH7 1GX, CH7 1QN, CH7 1QP, CH7 1QT, CH7 1QU",318,237,81
W00001700,CH7,"CH7 1SX, CH7 1TH, CH7 1TT, CH7 1TW",271,213,58
W00001699,CH7,"CH7 1EH, CH7 1GH, CH7 1NG, CH7 1NS, CH7 1PE, CH7 1PU, CH7 1PX",280,217,63
W00001698,CH7,"CH7 1UH, CH7 1UJ, CH7 1UN, CH7 1UQ, CH7 1UW, CH7 1UY, CH7 1WG, CH7 1WJ, CH7 1WN",299,250,49
W00001697,CH7,"CH7 1FH, CH7 1LB, CH7 1LD, CH7 1LJ, CH7 1LP, CH7 1LW, CH7 1LX, CH7 1NA, CH7 1NB",198,167,31
W00001696,CH7,"CH7 1LE, CH7 1LH, CH7 1LL, CH7 1LY, CH7 1UE, CH7 1UF, CH7 1UG",253,217,36
W00001695,CH7,"CH7 1SN, CH7 1US, CH7 1UT, CH7 1UU, CH7 1UX",284,238,46
W00001694,CH7,"CH7 1EW, CH7 1FW, CH7 1GS, CH7 1GT, CH7 1HG, CH7 1HJ, CH7 1HL, CH7 1HQ",328,280,48
W00001693,CH7,"CH7 1AU, CH7 1DB, CH7 1DU, CH7 1DX, CH7 1EA, CH7 1EB, CH7 1ED, CH7 1EE, CH7 1EF, CH7 1EG, CH7 1EJ, CH7 1EL, CH7 1EN, CH7 1ER, CH7 1ES, CH7 1GA, CH7 1HB, CH7 1HH, CH7 1JS, CH7 1LQ, CH7 1UB, CH7 1UD, CH7 1XA, CH7 1XE",241,213,28
W00001710,CH7,"CH7 1AD, CH7 1BJ, CH7 1BL, CH7 1BQ, CH7 1BW, CH7 1DG, CH7 1NQ, CH7 1NT, CH7 1RA, CH7 1RB, CH7 1RH, CH7 1RY, CH7 1SL, CH7 1XG, CH7 1YL, CH7 1YR",270,223,47
W00001692,CH7,"CH7 1AE, CH7 1LF, CH7 1LG, CH7 1LN, CH7 1LR, CH7 1LT, CH7 1LU, CH7 1YA, CH7 6GS, CH7 6GT, CH7 6GW, CH7 6NA, CH7 6NB, CH7 6ND, CH7 6NF, CH7 6NG, CH7 6NN, CH7 6NR, CH7 6NT, CH7 6NW, CH7 6QG, CH7 6QZ, CH7 6ZG, CH7 9XA, CH7 9ZD, CH7 9ZQ, CH7 9ZT, CH7 9ZY, CH7 9ZZ",298,252,46
W00010462,CH7,"CH7 6JH, CH7 6NS, CH7 6NU",176,145,31
W00010466,CH7,"CH7 6GN, CH7 6HE, CH7 6HF, CH7 6HJ, CH7 6HQ, CH7 6HR, CH7 6HS, CH7 6HY, CH7 6LA, CH7 6LL, CH7 6LN, CH7 6LP, CH7 6LW, CH7 6NP",453,422,31
W00001334,CH7,"CH7 5BL, CH8 8RL, LL17 0BA, LL17 0TE, LL17 0TF, LL17 0TH, LL17 0TL, LL17 0TS, LL17 0TU, LL17 0UB, LL17 0UE, LL17 0UF, LL17 0UG, LL17 0UH, LL17 0UL, LL17 0UR, LL17 0US, LL17 0UT",325,240,85
W00001819,CH7,"CH7 4NA, CH7 4NB, CH7 4ND, CH7 4NY, CH7 4PA",276,208,68
W00001820,CH7,"CH7 4AL, CH7 4BG, CH7 4BQ, CH7 4LW, CH7 4NE, CH7 4NF, CH7 4NG, CH7 4NH, CH7 4NJ, CH7 4NL, CH7 4NN, CH7 4NQ, CH7 4NZ, CH7 4PB, CH7 4PD",369,299,70
W00001821,CH7,"CH7 4JX, CH7 4LP, CH7 4LT, CH7 4LU, CH7 4LY, CH7 4NW",280,220,60
W00001822,CH7,"CH7 4BB, CH7 4BD, CH7 4BE, CH7 4BJ, CH7 4BL, CH7 4BP, CH7 4BW, CH7 4DG, CH7 4FA, CH7 4JN, CH7 4LD, CH7 4LE, CH7 4LF, CH7 4LG, CH7 4LH, CH7 4LJ, CH7 4LL, CH7 4LQ, CH7 4LR, CH7 4NP, CH7 4NR, CH7 4NS, CH7 4NT, CH7 4NU, CH7 4PE",441,352,89
W00001823,CH7,"CH7 4LN, CH7 4LS, CH7 4LX, CH7 4LZ, CH7 4NX, CH7 4TN, CH7 4TP, CH7 4TS, CH7 4TT, CH7 4TW, CH7 4UA, CH7 4UB",270,218,52
W00001711,CH7,"CH7 1BU, CH7 1BX, CH7 1BY, CH7 1DA, CH7 1DE, CH7 1DF, CH7 1FT, CH7 1RD, CH7 1XF, CH7 1YT, CH7 1YY",239,221,18
W00010460,CH7,"CH7 1PY, CH7 1QA, CH7 1XH, CH7 1XJ, CH7 1XL, CH7 1XS, CH7 1XX",162,119,43
W00001684,CH7,"CH7 1BA, CH7 1BB, CH7 1BD, CH7 1BE, CH7 1BH, CH7 1BN, CH7 1BR, CH7 1DJ, CH7 1DR, CH7 1GD, CH7 1GN, CH7 1QF, CH7 1SP, CH7 1SR, CH7 1TA",295,254,41
W00001709,CH7,"CH7 1RE, CH7 1RG, CH7 1RL, CH7 1RN, CH7 1RQ, CH7 1RT, CH7 1SH, CH7 1SQ, CH7 1YS, CH7 5DA",265,212,53
W00001708,CH7,"CH7 1GJ, CH7 1SS, CH7 1ST, CH7 1SU, CH7 1SY, CH7 1SZ, CH7 1TB, CH7 1TP, CH7 1UA, CH7 1WT",251,229,22
W00001686,CH7,"CH7 1LS, CH7 1NU, CH7 1PT, CH7 1QG, CH7 1QJ, CH7 1QL, CH7 1QQ, CH7 1UP, CH7 1UZ, CH7 1YG",258,202,56
W00001687,CH7,"CH7 1GL, CH7 1HD, CH7 1HF, CH7 1HW, CH7 1JL, CH7 1JN, CH7 1JR, CH7 1JU, CH7 1JW, CH7 1JY, CH7 1UR, CH7 1XD",277,219,58
W00001688,CH7,"CH7 1PA, CH7 1PB, CH7 1PD, CH7 1PF, CH7 1PG, CH7 1PH, CH7 1PJ, CH7 1PN, CH7 1PP, CH7 1PR, CH7 1PS, CH7 1RJ",263,228,35
W00001689,CH7,"CH7 1EQ, CH7 1EX, CH7 1HA, CH7 1HE, CH7 1HR, CH7 1HU, CH7 1HX, CH7 1HY, CH7 1JT, CH7 1JX, CH7 1NJ, CH7 1XB, CH7 1XP, CH7 1XY, CH7 1XZ",303,251,52
W00001690,CH7,"CH7 1FB, CH7 1FD, CH7 1FQ, CH7 1FR, CH7 1FS, CH7 1JE, CH7 1JF, CH7 1JG, CH7 1JH, CH7 1JJ, CH7 1JQ, CH7 4DH, CH7 4EE",473,398,75
W00001691,CH7,"CH7 1AA, CH7 1AB, CH7 1AF, CH7 1AG, CH7 1AH, CH7 1AJ, CH7 1AL, CH7 1AN, CH7 1AP, CH7 1AQ, CH7 1AR, CH7 1AS, CH7 1AT, CH7 1AW, CH7 1AX, CH7 1AY, CH7 1AZ, CH7 1BZ, CH7 1DD, CH7 1DL, CH7 1DN, CH7 1DP, CH7 1DQ, CH7 1DS, CH7 1DT, CH7 1DW, CH7 1DY, CH7 1DZ, CH7 1ET, CH7 1EY, CH7 1FE, CH7 1FF, CH7 1FG, CH7 1LZ, CH7 1NH, CH7 1NL, CH7 1NP, CH7 1NR, CH7 1NY, CH7 1NZ, CH7 1UL, CH7 1WA, CH7 1WB, CH7 1WD, CH7 1WE, CH7 1WF, CH7 1WH, CH7 1WL, CH7 1WQ, CH7 1WS, CH7 1WU, CH7 1WW, CH7 1WX, CH7 1WY, CH7 1WZ, CH7 1XU, CH7 1YB, CH7 1YD, CH7 1YE, CH7 1YF, CH7 1YP, CH7 1ZA, CH7 1ZB, CH7 1ZD, CH7 1ZE, CH7 1ZF, CH7 1ZG, CH7 1ZH, CH7 1ZJ, CH7 1ZL, CH7 1ZN, CH7 1ZP, CH7 1ZQ, CH7 1ZR, CH7 1ZS, CH7 1ZT, CH7 1ZU, CH7 1ZY, CH7 2YB, CH7 2ZA, CH7 2ZD, CH7 2ZE, CH7 2ZG, CH7 2ZH, CH7 2ZJ, CH7 2ZN, CH7 2ZP, CH7 2ZU, CH7 3ZA, CH7 3ZB, CH7 3ZD, CH7 3ZE, CH7 3ZF, CH7 3ZG, CH7 3ZH, CH7 3ZJ, CH7 3ZL, CH7 3ZT, CH7 4XU, CH7 4YB, CH7 4YF, CH7 4YR, CH7 4ZA, CH7 4ZB, CH7 4ZD, CH7 4ZE, CH7 4ZF, CH7 4ZG, CH7 4ZH, CH7 4ZJ, CH7 4ZL, CH7 4ZN, CH7 4ZP, CH7 4ZQ, CH7 4ZR, CH7 4ZS, CH7 4ZU, CH7 4ZW, CH7 5PS, CH7 5WB, CH7 5YB, CH7 5YP, CH7 5YQ, CH7 5YR, CH7 5YS, CH7 5YT, CH7 5YU, CH7 5YW, CH7 5YX, CH7 5YY, CH7 5ZA, CH7 5ZB, CH7 5ZD, CH7 5ZF, CH7 5ZG, CH7 5ZH, CH7 5ZJ, CH7 5ZL, CH7 5ZN, CH7 5ZP, CH7 5ZQ, CH7 5ZR, CH7 5ZS, CH7 5ZU, CH7 5ZW, CH7 5ZY, CH7 6FE, CH7 6FL, CH7 6FN, CH7 6FR, CH7 6ZF, CH7 6ZH, CH7 6ZL, CH7 6ZN, CH7 6ZP, CH7 6ZQ, CH7 6ZR, CH7 6ZS, CH7 6ZT, CH7 6ZU, CH7 6ZW, CH7 9AA, CH7 9AB, CH7 9AD, CH7 9AE, CH7 9AF, CH7 9AG, CH7 9AH, CH7 9AJ, CH7 9AL, CH7 9AN, CH7 9AP, CH7 9AQ, CH7 9AS, CH7 9AT, CH7 9AU, CH7 9AW, CH7 9AX, CH7 9AY, CH7 9AZ, CH7 9BA, CH7 9BB, CH7 9BD, CH7 9BE, CH7 9BF, CH7 9BG, CH7 9BH, CH7 9BJ, CH7 9BL, CH7 9BN, CH7 9BP, CH7 9BQ, CH7 9BR, CH7 9BS, CH7 9BT, CH7 9BU, CH7 9BW, CH7 9BX, CH7 9BY, CH7 9BZ, CH7 9DA, CH7 9DB, CH7 9DD, CH7 9DE, CH7 9DF, CH7 9DG, CH7 9DH, CH7 9DJ, CH7 9DL, CH7 9DN, CH7 9DP, CH7 9DQ, CH7 9DR, CH7 9DS, CH7 9DT, CH7 9DU, CH7 9DW, CH7 9DX, CH7 9DY, CH7 9DZ, CH7 9EA, CH7 9EB, CH7 9ED, CH7 9EE, CH7 9EF, CH7 9EG, CH7 9EH, CH7 9EJ, CH7 9EL, CH7 9EN, CH7 9EP, CH7 9EQ, CH7 9ER, CH7 9ES, CH7 9ET, CH7 9EU, CH7 9EW, CH7 9EX, CH7 9EY, CH7 9EZ, CH7 9FA, CH7 9FB, CH7 9FD, CH7 9FE, CH7 9FF, CH7 9FG, CH7 9FH, CH7 9FJ, CH7 9FP, CH7 9FQ, CH7 9FR, CH7 9FS, CH7 9FT, CH7 9FU, CH7 9FW, CH7 9FX, CH7 9FY, CH7 9HR, CH7 9WN, CH7 9WP, CH7 9WS, CH7 9ZR, CH7 9ZS",284,233,51
W00001086,CH7,"CH7 5FD, CH7 5SF, CH7 5SG, CH7 5SH, CH7 5SJ, CH7 5SL, CH7 5SP, CH7 5SR, CH7 5SS, CH7 5ST, CH7 5SW, CH7 5SX",368,298,70
W00001085,CH7,"CH7 5JX, CH7 5LB, CH7 5LD, CH7 5LE, CH7 5LF, CH7 5LH, CH7 5LJ, CH7 5LR, CH7 5LS, CH7 5LT, CH7 5LU, CH7 5LX, CH7 5LY, CH7 5LZ, CH7 5SA, CH7 5SB, CH7 5SE, CH7 5SN, CH7 5SQ, CH7 5SY",367,308,59
W00001082,CH7,"CH7 4BF, CH7 4BY, CH7 4DA, CH7 4DJ",120,76,44
W00001702,CH7,"CH7 1PZ, CH7 1QS, CH7 1QW, CH7 1TL, CH7 1TN, CH7 1TR, CH7 1TS, CH7 1XQ",369,275,94
W00001340,CH7,"CH7 4JL, CH7 4JP, CH7 4JW, CH7 6RE, CH7 6SA, CH7 6SD, CH7 6TA, CH7 6TB, CH7 6US, CH7 6WB, CH7 6WY, CH7 6WZ",298,264,34
W00001079,CH7,"CH7 4DN, CH7 4DQ, CH7 4PY, CH7 4QA, CH7 4QG, CH7 4QJ, CH7 4QL, CH7 4QP, CH7 4QQ, CH7 4QR, CH7 4QU, CH7 4QW, CH7 4QX, CH7 4QZ",318,243,75
W00010484,CH7,"CH7 3FB, CH7 3FD, CH7 3GH, CH7 3GJ, CH7 3GN, CH7 3GP",242,203,39
W00010479,CH7,"CH7 3AD, CH7 3AE, CH7 3DA, CH7 3DB, CH7 3DL, CH7 3DP, CH7 3DQ, CH7 3FE, CH7 3GA, CH7 3GB, CH7 3GE",257,228,29
W00010478,CH7,"CH7 3GL, CH7 3JE, CH7 3JF, CH7 3JG, CH7 3JQ",253,216,37
W00010472,CH7,"CH7 1FA, CH7 1FJ, CH7 1FL, CH7 1FN, CH7 1FP, CH7 1FX, CH7 1FY, CH7 1FZ, CH7 1GU, CH7 1GY, CH7 1QB, CH7 1QD, CH7 1XN, CH7 1XW, CH7 4AE",461,330,131
W00001704,CH7,"CH7 1NN, CH7 1QE, CH7 1QR, CH7 1QX, CH7 1QY, CH7 1QZ",276,190,86
W00001703,CH7,"CH7 1GE, CH7 1GF, CH7 1GG, CH7 1TJ, CH7 1TU, CH7 1TX, CH7 1TY, CH7 1TZ",286,232,54
W00001706,CH7,"CH7 1GB, CH7 1GQ, CH7 1GR, CH7 1GW, CH7 1GZ, CH7 1NX, CH7 1QH, CH7 1YX",342,220,122
W00001707,CH7,"CH7 1RX, CH7 1RZ, CH7 1SA, CH7 1SB, CH7 1SE",302,267,35
W00001080,CH7,"CH7 4PR, CH7 4PU, CH7 4PX, CH7 4PZ, CH7 4QD, CH7 4QE, CH7 4QF, CH7 4QH, CH7 4QN, CH7 4QY, CH7 4TB, CH7 5TA, CH7 5TB, CH7 5TE, CH7 5TF, CH7 5TQ",354,278,76
W00001341,CH7,"CH7 6TF, CH7 6TH, CH7 6TT, CH7 6UA, CH7 6UT",234,196,38
W00001427,CH7,"CH7 3NE, CH7 3NF, CH7 3NN, CH7 3NR, CH7 3NU, CH7 3NW, CH7 3NX, CH7 3NY, CH7 3NZ, CH7 3PA, CH7 3PB, CH7 3PF, CH7 3PH, CH7 3PR, CH7 3PT, CH7 3PX, CH7 3PY",465,414,51
W00001343,CH7,"CH7 6RZ, CH7 6SH, CH7 6SN, CH7 6SP, CH7 6SW, CH7 6TR",267,234,33
W00001437,CH7,"CH7 3DN, CH7 3EH, CH7 3EJ, CH7 3EL, CH7 3ER, CH7 3ES",210,194,16
W00001411,CH7,"CH7 2BE, CH7 2LT, CH7 2LU, CH7 2LX, CH7 2LZ, CH7 2NA",153,148,5
W00001438,CH7,"CH7 3LL, CH7 3QA, CH7 3QB, CH7 3QD, CH7 3QG, CH7 3QJ",438,369,69
W00001410,CH7,"CH7 2NG, CH7 2PB, CH7 2PD, CH7 2QH, CH7 2QQ",297,255,42
W00001712,CH7,"CH7 1BF, CH7 1BP, CH7 1BS, CH7 1BT, CH7 1RP, CH7 1RR, CH7 1RS, CH7 1RU, CH7 1SJ, CH7 1SW, CH7 1XR",184,156,28
W00001713,CH7,"CH7 1BG, CH7 1DH, CH7 1GP, CH7 1LA, CH7 1ND, CH7 1NE, CH7 1NF, CH7 1NW, CH7 1RF, CH7 1RW",438,378,60
W00001714,CH7,"CH7 1SD, CH7 1SF, CH7 1SG, CH7 1TG",292,252,40
W00001715,CH7,"CH7 1TD, CH7 1TE, CH7 1TF, CH7 1TQ",315,272,43
W00001723,CH7,"CH7 6XB, CH7 6XD, CH7 6XH, CH7 6XP, CH7 6YD, CH7 6ZB, CH7 6ZD, CH7 6ZE",307,275,32
W00001724,CH7,"CH7 6UB, CH7 6UD, CH7 6UE, CH7 6UZ, CH7 6XA, CH7 6YR, CH7 6YW",323,289,34
W00001725,CH7,"CH7 6FW, CH7 6QH, CH7 6QJ, CH7 6QL, CH7 6QQ, CH7 6QR, CH7 6QS, CH7 6QT, CH7 6QW, CH7 6RB, CH7 6WE, CH7 6ZA",261,229,32
W00001726,CH7,"CH7 6QA, CH7 6QU, CH7 6QX, CH7 6QY",166,131,35
W00001727,CH7,"CH7 6FX, CH7 6FY, CH7 6FZ, CH7 6GX, CH7 6NH, CH7 6NL, CH7 6RA, CH7 6RY, CH7 6SE, CH7 6SF, CH7 6SG, CH7 6SJ, CH7 6SL, CH7 6UN, CH7 6UW, CH7 6WL, CH7 6WP, CH7 6WR, CH7 6WS, CH7 6WT, CH7 6WX, CH7 6XW",571,499,72
W00001728,CH7,"CH7 6FQ, CH7 6SQ, CH7 6YL, CH7 6YN, CH7 6YP, CH7 6YQ",320,287,33
W00001729,CH7,"CH7 6TG, CH7 6TS, CH7 6TX, CH7 6XJ, CH7 6XL, CH7 6XN, CH7 6YF, CH7 6YG, CH7 6YH, CH7 6YZ",277,232,45
W00001730,CH7,"CH7 6LQ, CH7 6RF, CH7 6RU, CH7 6RX",233,208,25
W00001731,CH7,"CH7 6QN, CH7 6QP, CH7 6RD, CH7 6RG",203,173,30
W00001732,CH7,"CH7 6XE, CH7 6XF, CH7 6XG, CH7 6XQ, CH7 6YE, CH7 6YS",283,239,44
W00001733,CH7,"CH7 6AN, CH7 6AP, CH7 6AW, CH7 6BA, CH7 6BB, CH7 6BD, CH7 6BL, CH7 6BN, CH7 6BR, CH7 6BW, CH7 6DJ, CH7 6EH, CH7 6YU",304,247,57
W00001734,CH7,"CH7 6EA, CH7 6ED, CH7 6EN, CH7 6LR, CH7 6LS, CH7 6LT, CH7 6RP, CH7 6SR",270,237,33
W00001735,CH7,"CH7 6BJ, CH7 6EF, CH7 6EW, CH7 6SS, CH7 6ST, CH7 6WH, CH7 6WN",435,359,76
W00001439,CH7,"CH7 3DR, CH7 3DU, CH7 3DZ, CH7 3FJ, CH7 3GQ, CH7 3GR, CH7 3JD, CH7 3JX, CH7 3LA, CH7 3LB, CH7 3LD, CH7 3LE, CH7 3LF",405,368,37
W00001440,CH7,"CH7 3DS, CH7 3DY, CH7 3EB, CH7 3ED, CH7 3EE, CH7 3EF, CH7 3EX, CH7 3EY, CH7 3EZ, CH7 3FA, CH7 3JS, CH7 3JT, CH7 3JW, CH7 3JZ",512,468,44
W00001412,CH7,"CH7 2DF, CH7 2DY, CH7 2LY, CH7 2NY",191,165,26
W00001436,CH7,"CH7 3FG, CH7 3FH, CH7 3JL, CH7 3JN, CH7 3JP, CH7 3JY, CH7 3LG, CH7 3LJ, CH7 3NB, CH7 3ND, CH7 3QE, CH7 3QF, CH7 3QH, CH7 3QL, CH7 3QP",379,333,46
W00001413,CH7,"CH7 2PQ, CH7 2PU, CH7 2QA, CH7 2QB, CH7 2RD",326,282,44
W00001414,CH7,"CH7 2BP, CH7 2DG, CH7 2JS, CH7 2JY, CH7 2JZ, CH7 2LP, CH7 2LR, CH7 2LS",301,279,22
W00001426,CH7,"CH7 3LH, CH7 3NJ, CH7 3NL, CH7 3NP, CH7 3PL, CH7 3PP, CH7 3PS, CH7 3PU",327,298,29
W00001605,CH7,"CH7 4AF, CH7 4AN, CH7 4AR, CH7 4AT, CH7 4EQ, CH7 5JS, CH7 5JT, CH7 5JW, CH7 5JZ, CH7 5LA, CH7 5LG, CH7 5LN, CH7 5LP, CH7 5LW, CH7 5NA, CH7 5NB, CH7 5ND, CH7 5NG, CH7 5NQ",509,432,77
W00001424,CH7,"CH7 2JG, CH7 2JQ, CH7 2JR, CH7 2NE, CH7 2NP, CH7 2QZ",251,232,19
W00001608,CH7,"CH7 5FA, CH7 5JY, CH7 5LL, CH7 5LQ",158,137,21
W00001609,CH7,"CH7 4AU, CH7 4AX, CH7 4AY, CH7 4AZ, CH7 4BA, CH7 4DF, CH7 4DL, CH7 4DU, CH7 4DW, CH7 4DX, CH7 4DY, CH7 4EA, CH7 4EG, CH7 4EH, CH7 4EJ, CH7 4EL, CH7 4ER",308,234,74
W00001610,CH7,"CH7 4DZ, CH7 4EB, CH7 4ED, CH7 4EF, CH7 4EN, CH7 4EP, CH7 4ES, CH7 4ET, CH7 4EU, CH7 4EW, CH7 4EX, CH7 4EY, CH7 4EZ, CH7 4HE",223,179,44
W00001429,CH7,"CH7 2GB, CH7 2GW, CH7 2GX, CH7 2GY, CH7 2GZ, CH7 3DD, CH7 3DJ, CH7 3HH, CH7 3HQ, CH7 3HU, CH7 3HZ, CH7 3PG, CH7 3PJ, CH7 3PQ, CH7 6RS, CH7 6RT, CH7 6WU",501,429,72
W00001430,CH7,"CH7 2JH, CH7 2NF, CH7 2NS, CH7 2NT, CH7 2NX, CH7 2NZ, CH7 2PA, CH7 2TA",226,202,24
W00001612,CH7,"CH7 5QA, CH7 6AG, CH7 6AL, CH7 6AQ, CH7 6GY, CH7 6LU, CH7 6LX, CH7 6LY, CH7 6LZ, CH7 6PA, CH7 6PB, CH7 6PE, CH7 6PF, CH7 6PG, CH7 6PJ, CH7 6PL, CH7 6PS, CH7 6PZ, CH7 6WF, CH7 6WJ",335,279,56
W00001615,CH7,"CH7 5QP, CH7 6PP, CH7 6PT, CH7 6PX, CH7 6PY, CH8 8BP, CH8 8ET, CH8 8JN, CH8 8JW",270,200,70
W00001616,CH7,"CH7 6PH, CH7 6PN, CH7 6PQ, CH7 6PW, CH7 6QB, CH7 6QD, CH7 6QE",202,165,37
W00001442,CH7,"CH7 2EE, CH7 2EH, CH7 2EL, CH7 2EN, CH7 2EW, CH7 2HE, CH7 2HF, CH7 2HL, CH7 2HQ, CH7 2HR, CH7 3HN, CH7 3HW",356,318,38
W00001431,CH7,"CH7 3HE, CH7 3HX, CH7 3LQ, CH7 3NG, CH7 3NH, CH7 3NQ, CH7 3PN",232,212,20
W00001433,CH7,"CH7 3DT, CH7 3DW, CH7 3DX, CH7 3EA, CH7 3EG",272,240,32
W00001434,CH7,"CH7 2ES, CH7 2ET, CH7 2HN, CH7 2TB, CH7 3HG, CH7 3HJ, CH7 3HL, CH7 3HT",213,197,16
W00001423,CH7,"CH7 2GA, CH7 2GD, CH7 2GE, CH7 2HZ, CH7 2JB, CH7 2JD, CH7 2JF, CH7 2NJ, CH7 2NL, CH7 3BF, CH7 3HA",447,399,48
W00001422,CH7,"CH7 2NB, CH7 2ND, CH7 2NN, CH7 2NR, CH7 2NW",261,235,26
W00001421,CH7,"CH7 2NU, CH7 2PJ, CH7 2PL, CH7 2PN",229,210,19
W00001420,CH7,"CH7 2PH, CH7 2PP, CH7 2PR, CH7 2PW",246,223,23
W00001419,CH7,"CH7 2NH, CH7 2PE, CH7 2PF, CH7 2PT, CH7 2PX, CH7 2QW",281,260,21
W00001418,CH7,"CH7 2HY, CH7 2JL, CH7 2JN, CH7 2JT, CH7 2JU, CH7 2JX, CH7 2LA, CH7 2LN, CH7 2RF",300,273,27
W00001417,CH7,"CH7 2EA, CH7 2HU, CH7 2JA, CH7 2JE, CH7 2LB, CH7 2LD, CH7 2LF, CH7 2NQ, CH7 2RA",332,301,31
W00001416,CH7,"CH7 2BH, CH7 2BL, CH7 2BS, CH7 2BY, CH7 2BZ, CH7 2DB, CH7 2DD, CH7 2PS, CH7 4JH",285,263,22
W00001415,CH7,"CH7 2PG, CH7 2PY, CH7 2PZ",226,210,16
W00001432,CH7,"CH7 3HF, CH7 3HR, CH7 3HS, CH7 3JA, CH7 3JB, CH7 3JH, CH7 3JJ, CH7 3JR, CH7 3JU, CH7 3NA, CH7 3PW",323,293,30
W00001342,CH7,"CH7 6SZ, CH7 6TN, CH7 6TQ, CH7 6TW, CH7 6XY, CH7 6YA",321,282,39
W00001443,CH7,"CH7 3AA, CH7 3AB, CH7 3AF, CH7 3AJ, CH7 3AQ, CH7 3AR, CH7 3AU, CH7 3AX, CH7 3AZ, CH7 3FN, CH7 3GD, CH7 3GF",581,502,79
W00001444,CH7,"CH7 3DH, CH7 3EN, CH7 3EP, CH7 3EQ, CH7 3ET, CH7 3EU, CH7 3EW, CH7 3FF, CH7 3FP, CH7 3LY",245,234,11
W00001599,CH7,"CH7 5EF, CH7 5EG, CH7 5EQ, CH7 5JA, CH7 5JB, CH7 5JD, CH7 5JF, CH7 5JG, CH7 5JN",250,210,40
W00001652,CH7,"CH7 4HN, CH7 4TY, LL12 9HA, LL12 9HB, LL12 9HD, LL12 9HE, LL12 9HF, LL12 9HG, LL12 9HH, LL12 9RD",212,190,22
W00001658,CH7,"CH7 4AJ, CH7 4RA, CH7 4RB, CH7 4RD, CH7 4RF, CH7 4RG, CH7 4RH, CH7 4RX, CH7 4RY, CH7 4SA, CH7 4SB, CH7 4SD, CH7 4SE, CH7 4SU, CH7 4TA",298,267,31
W00001659,CH7,"CH7 4RZ, CH7 4SF, CH7 4UD, CH7 4UJ, CH7 4UQ, CH7 4YQ, CH7 4YU, CH7 4YY",259,225,34
W00001736,CH7,"CH7 6AT, CH7 6AU, CH7 6AX, CH7 6AY, CH7 6BF, CH7 6BH, CH7 6BQ, CH7 6EU, CH7 6QF",297,258,39
W00001737,CH7,"CH7 6AA, CH7 6AB, CH7 6AD, CH7 6AE, CH7 6AF, CH7 6AH, CH7 6AR, CH7 6AS, CH7 6AZ, CH7 6BE, CH7 6BG, CH7 6BT, CH7 6DH, CH7 6ES, CH7 6ET, CH7 6FA, CH7 6FG, CH7 6FJ, CH7 6FP, CH7 6RH, CH7 6RQ, CH7 6WA, CH7 6WD",327,295,32
W00001738,CH7,"CH7 6DX, CH7 6DY, CH7 6EJ, CH7 6ER, CH7 6EY, CH7 6EZ, CH7 6FD",199,158,41
W00001739,CH7,"CH7 6EB, CH7 6EL, CH7 6EX, CH7 6FB, CH7 6FF, CH7 6GH, CH7 6SU, CH7 6SX, CH7 6SY, CH7 6YT",273,236,37
W00001740,CH7,"CH7 6AJ, CH7 6DU, CH7 6DZ, CH7 6FH, CH7 6RR",210,186,24
W00001741,CH7,"CH7 6DA, CH7 6EE, CH7 6EG, CH7 6EQ, CH7 6GG, CH7 6HA, CH7 6TU, CH7 6YY",282,241,41
W00001742,CH7,"CH7 6BP, CH7 6BS, CH7 6BU, CH7 6DB, CH7 6DD, CH7 6DP, CH7 6DR, CH7 6DS, CH7 6DT, CH7 6GP, CH7 6GQ, CH7 6GR",410,362,48
W00001743,CH7,"CH7 6GF, CH7 6GJ, CH7 6GL, CH7 6GU, CH7 6HT, CH7 6JG, CH7 6JL, CH7 6JN, CH7 6JP, CH7 6JQ, CH7 6JS, CH7 6JU, CH7 6JW, CH7 6LB, CH7 6LD, CH7 6LE, CH7 6LF, CH7 6LJ, CH7 6NX",395,360,35
W00001745,CH7,"CH7 6HH, CH7 6HL, CH7 6HN, CH7 6HP, CH7 6HU, CH7 6HW, CH7 6JB, CH7 6JD, CH7 6JE, CH7 6JF, CH7 6JJ, CH7 6JY, CH7 6JZ, CH7 6NQ",380,333,47
W00001746,CH7,"CH7 6GA, CH7 6GB, CH7 6GD, CH7 6GE, CH7 6JT",173,149,24
W00001747,CH7,"CH7 6DE, CH7 6HX, CH7 6HZ, CH7 6JA, CH7 6JR, CH7 6JX, CH7 6YJ, CH7 6YX",183,164,19
W00001660,CH7,"CH7 4SR, CH7 4SX, CH7 4SY, CH7 4UE, CH7 4UF, CH7 4UG, CH7 4UH",273,242,31
W00001428,CH7,"CH7 2QR, CH7 2QS, CH7 2QT, CH7 2QU, CH7 2QX, CH7 2QY, CH7 2RE, CH7 3DE, CH7 3DF, CH7 3DG, CH7 3GG, CH7 3PD, CH7 3PE",394,351,43
W00001661,CH7,"CH7 4AG, CH7 4SG, CH7 4SH, CH7 4SJ, CH7 4SL, CH7 4SN, CH7 4SP, CH7 4SQ, CH7 4SS, CH7 4ST, CH7 4SW, CH7 4UL, CH7 4XD",324,273,51
W00001662,CH7,"CH7 4AQ, CH7 4BH, CH7 4BN, CH7 4RJ, CH7 4RN, CH7 4RR, CH7 4RS, CH7 4RT, CH7 4RW",255,236,19
W00001663,CH7,"CH7 4DP, CH7 4RE, CH7 4RL, CH7 4RP, CH7 4RQ, CH7 4RU, CH7 4SZ",282,250,32
W00001664,CH7,"CH7 4GA, CH7 4HA, CH7 4HF, CH7 4HG, CH7 4HH, CH7 4HJ, CH7 4HL, CH7 4HP, CH7 4HQ, CH7 4HR, CH7 4HS, CH7 4HT, CH7 4HU, CH7 4HW, CH7 4HX, CH7 4HY, CH7 4HZ, CH7 4JA, CH7 4JB, CH7 4JD, CH7 4JE, CH7 4JJ, CH7 4JR, CH7 4LA, CH7 4LB",366,324,42
W00001665,CH7,"CH7 4TE, CH7 4TF, CH7 4TG, CH7 4TH, CH7 4TJ, CH7 4TL, CH7 4TQ, CH7 4TR, CH7 4TU, CH7 4TX, CH7 4TZ",201,168,33
W00001344,CH7,"CH7 6NE, CH7 6NJ, CH7 6TJ, CH7 6TL, CH7 6TP, CH7 6TY, CH7 6TZ, CH7 6XT",298,268,30
W00010023,CH7,"CH7 4AB, CH7 4AD, CH7 4AH, CH7 4AP, CH7 4AS, CH7 4AW, CH7 4DR, CH7 4DS, CH7 4DT, CH7 5JP, CH7 5JR",391,325,66
W00001600,CH7,"CH7 5EL, CH7 5EN, CH7 5EP, CH7 5EZ",230,199,31
W00001395,CH7,"CH7 2AF, CH7 3BH, CH7 3BJ, CH7 3BP, CH7 3BU, CH7 3BW",292,257,35
W00001396,CH7,"CH7 2BD, CH7 2DP, CH7 2DR, CH7 2EY, CH7 2HH, CH7 2JJ, CH7 2JP, CH7 2JW",284,267,17
W00001451,CH7,"CH7 5UB, CH7 5UD, CH7 5UE, CH7 5UF, CH7 5UG, CH7 5UH, CH7 5UJ, CH7 5UL, CH7 5UQ, CH7 5UY",164,133,31
W00001408,CH7,"CH7 2QD, CH7 2QE, CH7 2QF, CH7 2QG, CH7 2RB",332,313,19
W00001598,CH7,"CH7 5EA, CH7 5EH, CH7 5EX, CH7 5NJ",288,256,32
W00001452,CH7,"CH7 5AF, CH7 5AG, CH7 5AQ, CH7 5BA, CH7 5BH, CH7 5PW, CH7 5PX, CH7 5PY, CH7 5PZ",242,200,42
W00001407,CH7,"CH7 2BJ, CH7 2BN, CH7 2BR, CH7 2BT, CH7 2BU, CH7 2BW, CH7 2BX, CH7 2SA",252,224,28
W00001406,CH7,"CH7 2AP, CH7 2AS, CH7 2AU, CH7 2AW, CH7 2AX, CH7 2QJ",307,267,40
W00001405,CH7,"CH7 3AG, CH7 3AH, CH7 3AN, CH7 3AY, CH7 3BA, CH7 3BB, CH7 3BX, CH7 3BY, CH7 3BZ",286,257,29
W00001404,CH7,"CH7 2DA, CH7 2DJ, CH7 2DL, CH7 2EF, CH7 2EG, CH7 2EJ, CH7 2HP, CH7 2HS",200,177,23
W00001453,CH7,"CH7 5AD, CH7 5AE, CH7 5AH, CH7 5AJ, CH7 5AL, CH7 5AN, CH7 5AT, CH7 5AU, CH7 5AX, CH7 5AY, CH7 5AZ, CH7 5BB, CH7 5BD, CH7 5BJ, CH7 5BX, CH7 5BZ",256,201,55
W00001403,CH7,"CH7 2DH, CH7 3AL, CH7 3AP, CH7 3AS, CH7 3AT, CH7 3AW, CH7 3BE, CH7 3BG, CH7 3BN, CH7 3BQ, CH7 4HB, CH7 4JF, CH7 4JG, CH7 4JQ, CH7 4JS, CH7 4JT",299,265,34
W00001402,CH7,"CH7 2AB, CH7 2AD, CH7 3BS, CH7 3BT",300,274,26
W00001409,CH7,"CH7 2LE, CH7 2LG, CH7 2LH, CH7 2LJ, CH7 2LL, CH7 2LQ, CH7 2LW, CH7 2ZB, CH7 2ZF",302,274,28
W00001454,CH7,"CH7 5BG, CH7 5BN, CH7 5BP, CH7 5BQ, CH7 5BW, CH8 8RX",124,96,28
W00001401,CH7,"CH7 2AQ, CH7 2DN, CH7 2HX, CH7 2QN, CH7 2QP",327,296,31
W00001400,CH7,"CH7 2AA, CH7 2AH, CH7 2BF, CH7 2EP, CH7 2ER, CH7 2EU, CH7 2HW",258,219,39
W00001604,CH7,"CH7 5DJ, CH7 5DL, CH7 5DN, CH7 5DQ, CH7 5DT, CH7 5DW, CH7 5DX, CH7 5DY, CH7 5EB, CH7 5EJ, CH7 5EU, CH7 5GA, CH7 5JE",317,276,41
W00001456,CH7,"CH7 5AA, CH7 5AP, CH7 5AW, CH7 5BE, CH7 5BR, CH7 5BS, CH7 5BT, CH7 5FB, CH7 5FE, CH7 5XA",253,214,39
W00001457,CH7,"CH7 5UN, CH7 5UR, CH7 5US, CH7 5UT, CH7 5UU, CH7 5UX, CH7 5WA, CH8 8PP, CH8 8PR, CH8 8PS, CH8 8PZ, CH8 8QD, CH8 8QH, CH8 8QJ, CH8 8QL",334,273,61
W00001603,CH7,"CH7 5DB, CH7 5DD, CH7 5DE, CH7 5DG, CH7 5ES, CH7 5ET, CH7 5HS, CH7 5HT, CH7 5HU",203,171,32
W00001399,CH7,"CH7 2AG, CH7 2AJ, CH7 2AL, CH7 2AR, CH7 2AT, CH7 2AY, CH7 2DQ, CH7 2QL",265,238,27
W00001398,CH7,"CH7 2AZ, CH7 2BA, CH7 2BB, CH7 2BG, CH7 2BQ, CH7 2EQ",206,196,10
W00001397,CH7,"CH7 2AE, CH7 2AN, CH7 3BL, CH7 3BR",275,251,24
W00001602,CH7,"CH7 5DF, CH7 5DH, CH7 5DP, CH7 5DR, CH7 5DS, CH7 5DU, CH7 5EY, CH7 5GB",250,215,35
W00001601,CH7,"CH7 5DZ, CH7 5ED, CH7 5EE, CH7 5ER, CH7 5EW, CH7 5HY",321,280,41
W00001455,CH7,"CH7 5AR, CH7 5AS, CH7 5BU, CH7 5BY",183,148,35
W00001435,CH7,"CH7 2EB, CH7 2ED, CH7 2EX, CH7 2HA, CH7 2HB, CH7 2HD, CH7 2HG, CH7 2HJ, CH7 3HB, CH7 3HD, CH7 3HP, CH7 3HY",277,249,28
W00001536,CH8,"CH8 9JN, CH8 9JW, CH8 9NH, CH8 9NP, CH8 9RB, CH8 9RD, CH8 9RE, CH8 9RF, CH8 9RG, CH8 9RH, CH8 9RJ, CH8 9RL, CH8 9RN, CH8 9RQ, CH8 9RU, CH8 9RX, CH8 9SA, LL19 9TT",235,217,18
W00001629,CH8,"CH8 7AD, CH8 7AF, CH8 7AG, CH8 7AN, CH8 7AW, CH8 7BF, CH8 7EN, CH8 7PD, CH8 7PF",397,347,50
W00001643,CH8,"CH8 7SB, CH8 7SE, CH8 7SF, CH8 7SH, CH8 7SN, CH8 7SW, CH8 7SX, CH8 7SY",428,366,62
W00001644,CH8,"CH8 7DA, CH8 7DB, CH8 7DN, CH8 7PG, CH8 7XB, CH8 7XE",302,265,37
W00001645,CH8,"CH8 7DY, CH8 7DZ, CH8 7EE, CH8 7EF, CH8 7FB, CH8 7PX",327,278,49
W00001613,CH8,"CH8 8EU, CH8 8EX, CH8 8JG, CH8 8JH, CH8 8JJ, CH8 8JL, CH8 8JQ, CH8 8JR",352,276,76
W00001611,CH8,"CH8 8DR, CH8 8DU, CH8 8DX, CH8 8DZ, CH8 8EA, CH8 8EE, CH8 8EF, CH8 8EG, CH8 8EJ, CH8 8EN, CH8 8ES, CH8 8EW",246,203,43
W00001646,CH8,"CH8 7DX, CH8 7EH, CH8 7NN, CH8 7NP, CH8 7NQ, CH8 7NS, CH8 7NT, CH8 7NW, CH8 7NY, CH8 7XD",293,241,52
W00001647,CH8,"CH8 7NZ, CH8 7SD, CH8 7UJ, CH8 7UQ, CH8 7UT, CH8 8SZ",337,282,55
W00001648,CH8,"CH8 7RG, CH8 7RH, CH8 7RJ, CH8 7RL, CH8 7RN, CH8 7RP, CH8 7RW, CH8 7RX, CH8 7RY, CH8 7RZ, CH8 7SA, CH8 7SG, CH8 7SJ, CH8 7SP, CH8 7SQ, CH8 8AE",370,303,67
W00010021,CH8,"CH8 9BA, CH8 9BD, CH8 9BH, CH8 9BP, CH8 9BY, CH8 9DE, CH8 9EA",309,263,46
W00010018,CH8,"CH8 9BB, CH8 9BN, CH8 9BR, CH8 9BS, CH8 9BT, CH8 9BU, CH8 9BW, CH8 9BZ",299,241,58
W00001716,CH8,"CH8 9DZ, CH8 9EZ, CH8 9GA, CH8 9HD, CH8 9HE, CH8 9HF, CH8 9HX, CH8 9JD, CH8 9PN, CH8 9PR",277,247,30
W00001717,CH8,"CH8 9EU, CH8 9HW, CH8 9NS, CH8 9PS, CH8 9PY, CH8 9PZ, CH8 9QA, CH8 9QD, CH8 9QE, CH8 9QF, CH8 9QH, CH8 9QL, CH8 9QP, CH8 9QR, CH8 9QU, CH8 9QW, CH8 9QX, CH8 9QY, CH8 9QZ",454,375,79
W00001718,CH8,"CH8 9AS, CH8 9AU, CH8 9AW, CH8 9AY, CH8 9AZ, CH8 9DP, CH8 9DQ, CH8 9DS, CH8 9DT, CH8 9DU, CH8 9DX, CH8 9EG, CH8 9EP, CH8 9EQ, CH8 9ES, CH8 9HN, CH8 9QB",247,209,38
W00001537,CH8,"CH8 9JH, CH8 9JP, CH8 9JY, CH8 9JZ, CH8 9UU, CH8 9UZ, CH8 9WA, CH8 9XR",170,148,22
W00001719,CH8,"CH8 9PD, CH8 9PF, CH8 9PJ",170,139,31
W00001720,CH8,"CH8 9NZ, CH8 9PG, CH8 9PQ",227,198,29
W00001721,CH8,"CH8 9NT, CH8 9NU, CH8 9NX, CH8 9NY, CH8 9PE, CH8 9PT",261,227,34
W00001722,CH8,"CH8 9ED, CH8 9EE, CH8 9EF, CH8 9EJ, CH8 9QS",193,164,29
W00001630,CH8,"CH8 7FG, CH8 7JL, CH8 7LR, CH8 7LU, CH8 7LW, CH8 7LZ, CH8 7NG, CH8 7NL, CH8 7QY, CH8 7TQ, CH8 7UG, CH8 7UX, CH8 7UY, CH8 7UZ, CH8 7WL",227,193,34
W00001813,CH8,"CH8 9DG, CH8 9DH, CH8 9DJ, CH8 9DL",138,106,32
W00001815,CH8,"CH8 9BE, CH8 9BG, CH8 9BJ, CH8 9BL, CH8 9BQ, CH8 9LY, CH8 9LZ, CH8 9NA, CH8 9NB, CH8 9ND, CH8 9NE, CH8 9NF, CH8 9NJ",213,178,35
W00001824,CH8,"CH8 8QA, CH8 8QU, CH8 8QX, CH8 8QY, CH8 8QZ, CH8 8RA, CH8 8RB, CH8 8RD, CH8 8RP",349,277,72
W00001825,CH8,"CH8 8SG, CH8 9AD, CH8 9AE, CH8 9AF, CH8 9AG, CH8 9AH, CH8 9AJ, CH8 9AN, CH8 9AP, CH8 9EN, CH8 9ER",212,178,34
W00001826,CH8,"CH8 8NS, CH8 8PB, CH8 8PE, CH8 8PH, CH8 8PJ, CH8 8PL, CH8 8PN, CH8 8PW, CH8 8QS, CH8 8RE, CH8 8RS",212,188,24
W00001827,CH8,"CH8 8RF, CH8 8RG, CH8 8RN, CH8 8RQ, CH8 8RT, CH8 8RU, CH8 8RW, CH8 8RY, CH8 8RZ, CH8 8SB, CH8 8SD, CH8 8SE, CH8 8SF, CH8 8SN, CH8 9AL, CH8 9AR, CH8 9DD, LL18 6ED",292,215,77
W00001828,CH8,"CH8 7DR, CH8 8NW, CH8 8QN, CH8 8QT, CH8 8SJ, CH8 8SP, CH8 8SQ, CH8 8SR, CH8 9ET",297,258,39
W00001829,CH8,"CH8 8SH, CH8 8SL",260,203,57
W00001830,CH8,"CH8 7DD, CH8 7DF, CH8 7DG, CH8 7DH, CH8 7DJ, CH8 7DL, CH8 7DQ, CH8 8NN",233,197,36
W00001831,CH8,"CH8 7DE, CH8 8AZ, CH8 8NH, CH8 8NT, CH8 8NU, CH8 8NX, CH8 8NY, CH8 8NZ, CH8 8PA, CH8 8PD, CH8 8QP, CH8 8QR, CH8 8QW, CH8 8RH, CH8 8RJ, CH8 8RR",337,289,48
W00001641,CH8,"CH8 7BB, CH8 7BL, CH8 7BN, CH8 7BW, CH8 7TL, CH8 7TS, CH8 7TT",344,289,55
W00001639,CH8,"CH8 7AQ, CH8 7AY, CH8 7AZ, CH8 7BP, CH8 7BQ, CH8 7BY",253,228,25
W00001642,CH8,"CH8 7DS, CH8 7DT, CH8 7DW, CH8 7LG, CH8 7LQ, CH8 7NA, CH8 7NH, CH8 7NR, CH8 7PA, CH8 8ST",304,262,42
W00001637,CH8,"CH8 7DP, CH8 7DU, CH8 7EA, CH8 7EB, CH8 7ED, CH8 7EG, CH8 7HB, CH8 7HX",267,220,47
W00001535,CH8,"CH8 9AB, CH8 9HH, CH8 9HP, CH8 9HR, CH8 9HS, CH8 9HT, CH8 9HU, CH8 9HY, CH8 9JE, CH8 9JF, CH8 9JG, CH8 9JJ, CH8 9JQ, CH8 9JR",470,362,108
W00001538,CH8,"CH8 9HA, CH8 9HB, CH8 9QT, CH8 9SD, CH8 9SH, CH8 9SP, CH8 9ST, CH8 9SU, CH8 9SW, CH8 9SX, CH8 9SZ, CH8 9TN, CH8 9TR, CH8 9TS, CH8 9TW, CH8 9UB, CH8 9UD, CH8 9UF, CH8 9UJ, CH8 9UL, CH8 9UN, CH8 9UP, CH8 9UR, CH8 9ZD, CH8 9ZF, CH8 9ZG",280,245,35
W00001539,CH8,"CH8 9SJ, CH8 9SL, CH8 9SN, CH8 9SR, CH8 9SY, CH8 9TD, CH8 9TE, CH8 9TF, CH8 9TG, CH8 9TJ, CH8 9TL, CH8 9TQ, CH8 9TT, CH8 9UE, CH8 9UG, CH8 9UQ, CH8 9US, CH8 9UT",199,159,40
W00001540,CH8,"CH8 9HG, CH8 9HJ, CH8 9HL, CH8 9HQ, CH8 9HZ, CH8 9JA, CH8 9JL, CH8 9LA",338,270,68
W00001541,CH8,"CH8 9RP, CH8 9RR, CH8 9RS, CH8 9RT, CH8 9RW, CH8 9RY, CH8 9RZ, CH8 9SB",125,109,16
W00001460,CH8,"CH8 8BG, CH8 8JT, CH8 8LT, CH8 8LU, CH8 8LW, CH8 8NG, CH8 8NP",262,215,47
W00001583,CH8,"CH8 7EJ, CH8 7EL, CH8 7EW, CH8 7FH, CH8 7FS, CH8 7GH, CH8 7GR, CH8 7JU, CH8 7JY, CH8 7NX, CH8 7PS, CH8 7QB, CH8 7QH, CH8 7QJ, CH8 7QL, CH8 7QP, CH8 7QU, CH8 7RF, CH8 8SW, CH8 9DN, CH8 9DW",420,382,38
W00001584,CH8,"CH8 7PY, CH8 7PZ, CH8 7QA, CH8 7QD, CH8 7QE, CH8 7QF, CH8 7QG, CH8 7QQ, CH8 7QW, CH8 7XL",354,311,43
W00001585,CH8,"CH8 7GD, CH8 7JZ, CH8 7QS, CH8 7QT, CH8 7QX, CH8 7XH, CH8 7XT, CH8 7XX, CH8 7XZ, CH8 7YA, CH8 7YJ, CH8 7YL, CH8 7YN, CH8 7YP, CH8 7YR, CH8 7YS, CH8 7YU, CH8 7YW, CH8 7ZR",183,160,23
W00001586,CH8,"CH8 7JJ, CH8 7JP, CH8 7JR, CH8 7JT, CH8 7JW, CH8 7JX",282,250,32
W00001587,CH8,"CH8 7HR, CH8 7HS, CH8 7JD, CH8 7JH, CH8 7QN, CH8 7QR, CH8 7RU",292,252,40
W00001588,CH8,"CH8 7ER, CH8 7HY, CH8 7HZ, CH8 7JB",305,271,34
W00001589,CH8,"CH8 7EP, CH8 7EQ, CH8 7ES, CH8 7ET, CH8 7EU, CH8 7EX, CH8 7EY, CH8 7FF, CH8 7FP, CH8 7GJ, CH8 7HD, CH8 7HE, CH8 7HF, CH8 7HJ, CH8 7HW",315,272,43
W00001638,CH8,"CH8 7BA, CH8 7BD, CH8 7BJ, CH8 7BR, CH8 7BX, CH8 7BZ",258,226,32
W00001591,CH8,"CH8 7HT, CH8 7JE, CH8 7JF, CH8 7JG, CH8 7JN, CH8 7JQ",287,265,22
W00001590,CH8,"CH8 7PR, CH8 7PT, CH8 7PU, CH8 7PW, CH8 7QZ, CH8 7XP, CH8 7XW",242,211,31
W00001595,CH8,"CH8 9JS, CH8 9LH, CH8 9LJ, CH8 9LS, CH8 9LT, CH8 9LW, LL19 9TB, LL19 9TD, LL19 9TE, LL19 9YP",299,251,48
W00001636,CH8,"CH8 7HA, CH8 7HG, CH8 7HH, CH8 7HP, CH8 7HQ, CH8 7HU, CH8 7JS, CH8 7LB, CH8 7LF, CH8 7PB",460,395,65
W00001635,CH8,"CH8 7JA, CH8 7LY, CH8 7NB, CH8 7ND, CH8 7NE, CH8 7NF, CH8 7NJ",178,158,20
W00001634,CH8,"CH8 7AH, CH8 7AJ, CH8 7AL, CH8 7AR, CH8 7AS, CH8 7AT, CH8 7AU, CH8 7AX, CH8 7NU, CH8 7PN, CH8 7WD, CH8 7WF, CH8 7WG, CH8 7WQ, CH8 7WW, CH8 7WY",310,284,26
W00001633,CH8,"CH8 7AP, CH8 7GB, CH8 7LS, CH8 7PE, CH8 7PH, CH8 7PJ, CH8 7PL, CH8 7PP, CH8 7PQ, CH8 7RQ, CH8 7TD",291,257,34
W00001632,CH8,"CH8 7AA, CH8 7AB, CH8 7AE, CH8 7FD, CH8 7FE, CH8 7FJ, CH8 7HN, CH8 7LA, CH8 7LD, CH8 7LE, CH8 7LH, CH8 7LJ, CH8 7LL, CH8 7LN, CH8 7LP, CH8 7LT, CH8 7RT, CH8 7SR, CH8 7SU, CH8 7TA, CH8 7TB, CH8 7TE, CH8 7TF, CH8 7TG, CH8 7TH, CH8 7TJ, CH8 7TN, CH8 7TP, CH8 7TR, CH8 7TW, CH8 7UB, CH8 7UE, CH8 7UH, CH8 7UL, CH8 7UR",295,273,22
W00001631,CH8,"CH8 7GA, CH8 7LX, CH8 7RA, CH8 7RB, CH8 7RD, CH8 7RE, CH8 7RR, CH8 7RS, CH8 7SL, CH8 7SS, CH8 7ST, CH8 7TU, CH8 7TX, CH8 7TY, CH8 7TZ, CH8 7UA, CH8 7UD, CH8 7UF, CH8 7UN, CH8 7UP, CH8 7US, CH8 7UU, CH8 7UW, CH8 7XA, CH8 7XF, CH8 7XG",310,265,45
W00001388,CH8,"CH8 8AA, CH8 8AD, CH8 8AF, CH8 8AG, CH8 8AQ, CH8 8AS, CH8 8LA, CH8 8LB, CH8 8LD, CH8 8LE, CH8 8LF, CH8 8LH, CH8 8LJ, CH8 8LQ, CH8 8SU, CH8 8SX, CH8 8SY",354,298,56
W00001593,CH8,"CH8 9JB, CH8 9JT, CH8 9JU, CH8 9JX, CH8 9LD, CH8 9LE, CH8 9LF, CH8 9LL, CH8 9LN",187,166,21
W00001389,CH8,"CH8 8AH, CH8 8AP, CH8 8AT, CH8 8AX, CH8 8BB, CH8 8BE, CH8 8HB, CH8 8HD, CH8 8HE, CH8 8HG, CH8 8LS, CH8 8WB, CH8 8WN, CH8 8WW",348,280,68
W00001392,CH8,"CH8 8HF, CH8 8HH, CH8 8HS, CH8 8HZ, CH8 8JA, CH8 8JX",264,228,36
W00001393,CH8,"CH8 8HW, CH8 8JB, CH8 8JE, CH8 8JF",154,130,24
W00001394,CH8,"CH8 8AN, CH8 8AR, CH8 8AU, CH8 8AW, CH8 8HQ, CH8 8JP, CH8 8JU, CH8 8JY, CH8 8JZ",208,194,14
W00001596,CH8,"CH8 9LU, LL19 9SP, LL19 9TH, LL19 9TL, LL19 9TN, LL19 9TR, LL19 9TS, LL19 9TU, LL19 9TZ, LL19 9UN",271,228,43
W00001390,CH8,"CH8 8AJ, CH8 8AL, CH8 8LG, CH8 8LL, CH8 8LP, CH8 8LR, CH8 8PT",299,246,53
W00008325,GL16,"GL16 8PB, NP25 3NH, NP25 3NJ, NP25 3NL, NP25 3SB, NP25 3SD, NP25 3SE, NP25 3SF, NP25 4LU, NP25 4LW, NP5 3NH, NP5 3NJ, NP5 3NL, NP5 3SB, NP5 3SD, NP5 3SE, NP5 3SF",168,154,14
W00002373,HR3,"HR3 5JY, HR3 5NH, HR3 5NP, HR3 5NR, HR3 5NS, HR3 5NT, HR3 5NU, HR3 5NX, HR3 5PD, HR3 5PE, HR3 5PF, HR3 5TJ, LD3 0SL, LD3 0SN, LD3 0SW",307,292,15
W00002376,HR3,"HR3 5PL, HR3 5PN, HR3 5PT, HR3 5PW, HR3 5PX, HR3 5PY, HR3 5QB, HR3 5QD, HR3 5QE, HR3 5QF, HR3 5QG, HR3 5QH, HR3 5QJ, HR3 5QL, HR3 5QN, HR3 5QP, HR3 5QQ, HR3 5QU, HR3 5QW, HR3 5RE, HR3 5RH, HR3 5RJ, HR3 5RL, NP7 7NP",227,223,4
W00002377,HR3,"HR3 5NY, HR3 5PP, HR3 5PQ, HR3 5PR, HR3 5PS, HR3 5PU, HR3 5PZ, HR3 5QA, HR3 5QT, HR3 5RP, HR3 5TQ, HR3 5TT",261,247,14
W00002378,HR3,"HR3 5AF, HR3 5AG, HR3 5AH, HR3 5AQ, HR3 5BN, HR3 5BS, HR3 5BT, HR3 5BX, HR3 5DA, HR3 5DF, HR3 5DG, HR3 5DL, HR3 5DP, HR3 5DQ, HR3 5DW, HR3 5EQ, HR3 5FD",189,179,10
W00002379,HR3,"HR3 5AA, HR3 5AE, HR3 5AY, HR3 5BA, HR3 5BG, HR3 5BJ, HR3 5BL, HR3 5BP, HR3 5BQ, HR3 5BU, HR3 5BY, HR3 5DB, HR3 5DD, HR3 5DE, HR3 5DH, HR3 5DJ, HR3 5TU, HR3 5WA, HR3 5WL, HR3 5WP, HR3 5WQ, HR3 5WR, HR3 5WS, HR3 5WT, HR3 5WW, HR3 5WY, HR3 5WZ, HR3 5XZ, HR3 5YB, HR3 5YH, HR3 5YL, HR3 5YP, HR3 5YU, HR3 5ZW, HR3 5ZZ, HR3 6YG",257,239,18
W00002380,HR3,"HR3 5DN, HR3 5DR, HR3 5DS, HR3 5DT, HR3 5DU, HR3 5DX, HR3 5DY, HR3 5EA, HR3 5EB, HR3 5ED, HR3 5EE, HR3 5EF, HR3 5EH, HR3 5EJ, HR3 5FA",217,206,11
W00002381,HR3,"HR3 5AB, HR3 5AD, HR3 5AJ, HR3 5AN, HR3 5AP, HR3 5AR, HR3 5AS, HR3 5AT, HR3 5AU, HR3 5AW, HR3 5AX, HR3 5AZ, HR3 5BH, HR3 5BW",224,207,17
W00002382,HR3,"HR3 5EG, HR3 5EL, HR3 5TL, HR3 5TN, HR3 5TS, HR3 5TX, HR3 5YE, HR3 5YG",455,429,26
W00002383,HR3,"HR3 5DZ, HR3 5LF, HR3 5PG, HR3 5PH, HR3 5PJ, HR3 5QR, HR3 5QS",304,282,22
W00002583,HR3,"HR3 6BW, HR3 6HL, HR3 6JJ, HR3 6JW, HR5 3EP, HR5 3ND, HR5 3NR, HR5 3NS, HR5 3NT, HR5 3NU, HR5 3NX, HR5 3NY, HR5 3NZ, HR5 3PA, HR5 3PD, HR5 3PE, HR5 3PJ, HR5 3PL, HR5 3PN, HR5 3PP, HR5 3PR, HR5 3PW, HR5 3QB, HR5 3QD, HR5 3QE, HR5 3QF, HR5 3QG, HR5 3QP, HR5 3QQ, HR5 3QR, HR5 3QS, HR5 3QT, HR5 3QU, HR5 3QX, HR5 3RA",428,394,34
W00002361,HR3,"HR3 5JA, HR3 5JB, HR3 5JD, HR3 5JE, HR3 5LG, HR3 5LH, HR3 5LJ, HR3 5LL, HR3 5LN, HR3 5LQ, HR3 5LU, HR3 5LW, HR3 5LY, HR3 5LZ, HR3 5NF, HR3 5NJ, HR3 5NL, HR3 5NN, HR3 5NW, HR3 5NZ, HR3 5PA, HR3 5TH",367,330,37
W00002360,HR3,"HR3 5HZ, HR3 5JZ, HR3 5LA, HR3 5NQ, HR3 5RS, HR3 5RT, HR3 5RU, HR3 5RX, HR3 5RY, HR3 5SA, HR3 5SD, HR3 5SE, HR3 5SF, HR3 5SH, HR3 5SP, HR3 5SZ, HR3 5TR, HR3 6EX, HR3 6EY, HR3 6HA, HR3 6HN, HR3 6JU, HR3 6JY",367,348,19
W00002362,HR3,"HR3 5JF, HR3 5JG, HR3 5LP, HR3 5LR, HR3 5LS, HR3 5LT, HR3 5LX, HR3 5NA, HR3 5NB, HR3 5ND, HR3 5NE, HR3 5NG, HR3 5PB, LD2 3UQ, LD3 0AJ, LD3 0AX, LD3 0AZ, LD3 0BJ, LD3 0BQ, LD3 0BX, LD3 0BZ, LD3 0LQ, LD3 0YL, LD3 0YR, LD3 0YS, LD3 0YY",333,297,36
W00002359,HR3,"HR3 5FB, HR3 5JH, HR3 5JJ, HR3 5JL, HR3 5JN, HR3 5JP, HR3 5JQ, HR3 5JR, HR3 5JS, HR3 5JT, HR3 5JU, HR3 5JW, HR3 5JX, HR3 5LB, HR3 5LD, HR3 5LE, HR3 5RR, HR3 5RZ, HR3 5SB, HR3 5SG, HR3 5SJ, HR3 5SL, HR3 5SN, HR3 5SQ, HR3 5SR, HR3 5SS, HR3 5SW, HR3 5TP, HR3 6JX, LD2 3JP, LD2 3JR, LD2 3JW",371,345,26
W00002364,HR5,"HR5 3QH, HR5 3QJ, HR5 3QL, HR5 3QN, HR5 3QW, HR5 3QZ, LD2 3JB, LD2 3JD, LD2 3JE, LD2 3JF, LD2 3JG, LD2 3JH, LD2 3JJ, LD2 3JL, LD2 3JN, LD2 3JQ, LD2 3JS, LD2 3JT, LD2 3JU, LD2 3JX, LD2 3JY, LD2 3JZ, LD2 3SJ, LD2 3SX, LD2 3TZ, LD2 3UJ, LD2 3UX, LD2 3UZ, LD2 3YJ, LD2 3YQ, LD2 3YX",515,474,41
W00002587,HR5,"HR5 3NP, LD8 2NU, LD8 2PE, LD8 2PH, LD8 2PL, LD8 2PN, LD8 2RA, LD8 2RB, LD8 2RE, LD8 2RL, LD8 2RN, LD8 2RW, LD8 2SB",222,208,14
W00002588,HR5,"HR5 3NW, LD8 2PP, LD8 2PT, LD8 2PU, LD8 2PW, LD8 2PY, LD8 2RF, LD8 2RG, LD8 2RH, LD8 2RP, LD8 2RR, LD8 2UN",297,280,17
W00002541,LD1,"LD1 6EG, LD1 6EH, LD1 6EL, LD1 6EN, LD1 6EW, LD1 6RF, LD1 6RG, LD1 6RH, LD1 6RL, LD1 6RN, LD1 6RQ, LD1 6RW, LD6 5PE",381,343,38
W00002542,LD1,"LD1 6HF, LD1 6HH, LD1 6NN, LD1 6NW, LD1 6PA, LD1 6PB, LD1 6PD, LD6 5BL, LD6 5NL, LD6 5NT, LD6 5NU, LD6 5NY, LD6 5PA, LD6 5PB, LD6 5PD",267,244,23
W00002540,LD1,"LD1 6PG, LD1 6PH, LD1 6PL, LD1 6PN, LD1 6PP, LD1 6PR, LD1 6PS, LD1 6PT, LD1 6PU, LD1 6PW, LD6 5NB, LD6 5ND, LD6 5NE, LD6 5NF",246,227,19
W00002515,LD1,"LD1 6HT, LD1 6HU, LD1 6HW, LD1 6LB, LD1 6LD, LD1 6LE, LD1 6LL, LD1 6LP, LD1 6LR, LD1 6LS, LD1 6LT, LD1 6LW",287,260,27
W00002433,LD1,"LD1 5LP, LD1 5LQ, LD1 5LR, LD1 5LS, LD1 5LT, LD1 5LW, LD1 5NF, LD1 5NG, LD1 5NH, LD1 5NN, LD1 5NR, LD1 6AE",235,206,29
W00010318,LD1,"LD1 5AB, LD1 5BA, LD1 5BL, LD1 5BP, LD1 5BS, LD1 5BT, LD1 5BU, LD1 5BW, LD1 5BX, LD1 5BZ",265,240,25
W00002514,LD1,"LD1 6DT, LD1 6EA, LD1 6EB, LD1 6ED, LD1 6EE, LD1 6EF, LD1 6NF, LD1 6NG",276,237,39
W00009781,LD1,"LD1 5AL, LD1 5HB, LD1 5ND, LD1 5NJ, LD1 5NL, LD1 5NW",337,296,41
W00009780,LD1,"LD1 5NA, LD1 5NT",169,148,21
W00009779,LD1,"LD1 5EW, LD1 5EX, LD1 5NB, LD1 5NE, LD1 5NQ, LD1 5NS, LD1 5NX, LD1 5TS",305,274,31
W00010355,LD1,"LD1 5AF, LD1 5AG, LD1 5AJ, LD1 5BF, LD1 5BH, LD1 5BN, LD1 5BY, LD1 5DF, LD1 5EP, LD1 5PE, LD1 5PF, LD1 5YD, LD1 5YE, LD1 5YF",392,347,45
W00002279,LD1,"LD1 5UP, LD1 5UW, LD1 6SH, LD1 6SR, LD1 6SS, LD1 6ST, LD1 6SY, LD1 6TD, LD1 6TG, LD1 6TH, LD1 6TL, LD1 6TN, LD1 6TP, LD1 6TW, LD1 6TY, LD1 6UD, LD1 6UE, LD1 6UF, LD1 6UG, LD1 6UH, LD1 6UL, LD1 6UN, LD1 6YG",362,326,36
W00002513,LD1,"LD1 6DX, LD1 6DY, LD1 6ET, LD1 6EU, LD1 6EY, LD1 6HA, LD1 6HB, LD1 6HD, LD1 6HG, LD1 6HL, LD1 6HP, LD1 6HR, LD1 6HS, LD1 6LU, LD1 6NA, LD2 3SB, LD2 3SD",286,254,32
W00002278,LD1,"LD1 6TR, LD1 6TS, LD1 6TT, LD1 6TU, LD1 6UA, LD1 6UB, LD1 6YA, LD1 6YB, LD1 6YD, LD1 6YE, LD1 6YF, LD1 6YH, LD1 6YL, LD1 6YN, LD1 6YP, LD1 6YR, LD1 6YS, LD1 6YT, LD1 6YW, LD1 6ZB",271,247,24
W00002473,LD1,"LD1 5UR, LD1 5UT, LD1 5XZ, LD7 1NS, LD7 1NT, LD7 1NU, LD7 1NY, LD7 1PA, LD7 1PB, LD7 1RA, LD7 1SG, LD7 1SH, LD7 1SL, LD7 1SN, LD7 1SP, LD7 1SR, LD7 1SS, LD7 1ST, LD7 1SU, LD7 1SW, LD7 1SY, LD7 1TA, LD7 1TB, LD7 1TD",341,332,9
W00002432,LD1,"LD1 5HG, LD1 5HN, LD1 5HW, LD1 5LL, LD1 5LN",246,231,15
W00002431,LD1,"LD1 5DE, LD1 5HA, LD1 5HH, LD1 5HJ, LD1 5HT, LD1 5LD, LD1 5LG, LD1 5NU, LD1 5NY, LD1 5NZ, LD1 5PD, LD1 5WA, LD1 5ZG, LD1 5ZR, LD1 9SA, LD1 9SB, LD1 9XF, LD1 9ZX, LD1 9ZY, LD1 9ZZ",383,359,24
W00002430,LD1,"LD1 5ES, LD1 5HL, LD1 5HP, LD1 5HR, LD1 5HU, LD1 5LU, LD1 5LY",156,136,20
W00002429,LD1,"LD1 5AE, LD1 5LE, LD1 5LF, LD1 5LJ, LD1 5LX, LD1 5NP, LD1 5SH, LD1 5WE, LD1 5WW",291,260,31
W00002427,LD1,"LD1 5BE, LD1 5BG, LD1 5DA, LD1 5DB, LD1 5EB, LD1 6BL, LD1 6BS, LD1 6BT, LD1 6BU, LD1 6DB, LD1 6DD, LD1 6DE, LD1 6DZ, LD1 6PE, LD1 6PF",295,250,45
W00002426,LD1,"LD1 5AN, LD1 5BJ, LD1 6BD, LD1 6BN, LD1 6BW, LD1 6BY, LD1 6DF, LD1 6DG, LD1 6DH, LD1 6DS, LD1 6EP",315,269,46
W00002425,LD1,"LD1 6BB, LD1 6BE, LD1 6BP, LD1 6BX, LD1 6DJ, LD1 6DQ, LD1 6ER, LD1 6ES",300,268,32
W00002424,LD1,"LD1 6DA, LD1 6DL, LD1 6DN, LD1 6DP, LD1 6DR, LD1 6DW, LD1 6EJ",199,183,16
W00002422,LD1,"LD1 5AD, LD1 5BQ, LD1 5LB, LD1 5LH, LD1 5YA, LD1 5YB",361,341,20
W00002421,LD1,"LD1 5EF, LD1 5EG, LD1 5EH, LD1 5EL, LD1 5HY, LD1 5LA",246,219,27
W00002420,LD1,"LD1 5AA, LD1 5AP, LD1 5BB, LD1 5ET, LD1 5EU, LD1 5UL, LD1 5WB, LD1 5WD, LD1 5WF, LD1 5WG, LD1 5WH, LD1 5WJ, LD1 5WL, LD1 5WN, LD1 5WP, LD1 5WQ, LD1 5WR, LD1 5WS, LD1 5WT, LD1 5WU, LD1 5WX, LD1 5WY, LD1 5WZ, LD1 5XY, LD1 5YG, LD1 5ZY, LD1 6AD, LD1 6AG, LD1 6AH, LD1 6AL, LD1 6AN, LD1 6AQ, LD1 6AW, LD1 6AZ, LD1 6BF, LD1 6BG, LD1 6BH, LD1 6BJ, LD1 6BZ, LD1 6DU, LD1 6UY, LD1 6WA, LD1 6WB, LD1 6WD, LD1 6WE, LD1 6WF, LD1 6WG, LD1 6WH, LD1 6WJ, LD1 6WL, LD1 6WN, LD1 6WP, LD1 6WQ, LD1 6WR, LD1 6WU, LD1 6WY, LD1 6WZ, LD1 6XP, LD1 6ZY, LD1 9AA, LD1 9AB, LD1 9AD, LD1 9AE, LD1 9AF, LD1 9AG, LD1 9AH, LD1 9AJ, LD1 9AL, LD1 9AN, LD1 9AP, LD1 9AQ, LD1 9AR, LD1 9AS, LD1 9AT, LD1 9AU, LD1 9AW, LD1 9AX, LD1 9AY, LD1 9AZ, LD1 9BA, LD1 9BB, LD1 9BD, LD1 9BE, LD1 9BF, LD1 9BG, LD1 9BH, LD1 9BJ, LD1 9BL, LD1 9BN, LD1 9BP, LD1 9BQ, LD1 9BS, LD1 9BT, LD1 9BU, LD1 9BW, LD1 9BX, LD1 9BY, LD1 9BZ, LD2 3NZ, LD2 3XA, LD2 9AG, LD2 9AN, LD2 9AP, LD2 9AQ, LD7 1WT, LD7 9AD, LD7 9AF, LD7 9AP, LD7 9AQ, LD8 2WA, LD8 2WB, LD8 2WF, LD8 2ZE",332,279,53
W00002449,LD1,"LD1 5RL, LD1 5RS, LD1 5RT, LD1 5RU, LD1 5RW, LD1 5SA, LD1 5SB, LD2 3TE",234,209,25
W00002512,LD1,"LD1 6HY, LD1 6LA, LD1 6LF, LD1 6LG, LD1 6LH, LD1 6LN, LD1 6LQ, LD1 6LX, LD1 6LY, LD1 6LZ, LD1 6NE",308,270,38
W00002418,LD1,"LD1 6AA, LD1 6AF, LD1 6AJ, LD1 6AP, LD1 6AR, LD1 6AS, LD1 6AT, LD1 6AX, LD1 6BA",226,200,26
W00002408,LD1,"LD1 5DD, LD1 5SP, LD1 5SR, LD1 5SW, LD1 5TA, LD1 5TB, LD1 5TT, LD1 5TY, LD1 5UA, LD1 5UB, LD1 5UD, LD1 5UE, LD1 5UF, LD1 5UH, LD1 5US",440,407,33
W00002407,LD1,"LD1 5ST, LD1 6RA, LD1 6RP, LD1 6RX, LD1 6RY, LD1 6SA, LD1 6TA, LD1 6TB, LD1 6TJ",330,289,41
W00002406,LD1,"LD1 5SL, LD1 5SN, LD1 5SQ, LD1 5SS, LD1 5SU, LD1 5SY, LD1 5TU, LD1 6HN, LD1 6RB, LD1 6RD, LD1 6RE, LD1 6RJ, LD1 6RR, LD1 6RS, LD1 6RT, LD1 6RU, LD1 6SB, LD1 6UR, LD1 6UT",391,359,32
W00002405,LD1,"LD1 6HE, LD1 6NP, LD1 6NR, LD1 6NS, LD1 6NT, LD1 6NU, LD1 6NY, LD6 5HU",175,153,22
W00002404,LD1,"LD1 6NB, LD1 6ND, LD2 3LN, LD2 3LP, LD2 3LR, LD2 3LS, LD2 3LT, LD2 3LU, LD2 3LW, LD2 3LY, LD2 3NA, LD2 3NB, LD2 3ND, LD2 3NE, LD2 3PD, LD2 3PE, LD2 3PF, LD2 3PG, LD2 3PH, LD2 3PL, LD2 3PN, LD2 3PP, LD2 3PR, LD2 3PS, LD2 3PW, LD2 3SE, LD2 3SF, LD2 3SG, LD2 3SH, LD2 3SL, LD2 3YG, LD4 4BE, LD5 4UE, LD5 4YG, SA11 5NG",419,369,50
W00002338,LD1,"LD1 5PG, LD1 5PJ, LD1 5PY, LD1 5TP",199,171,28
W00002337,LD1,"LD1 5ED, LD1 5PL, LD1 5PN, LD1 5PP, LD1 5PR, LD1 5PT, LD1 5PW, LD1 5RA, LD1 5RB, LD1 5RJ, LD1 6NL",312,282,30
W00002335,LD1,"LD1 5PA, LD1 5PB, LD1 5PH, LD1 5PS, LD1 5PU, LD1 5RD, LD1 5RE, LD1 5RF, LD1 5RG, LD1 5RH, LD1 5RN, LD1 5SJ, LD2 3TG, LD2 3TL, LD2 3TW",363,343,20
W00002585,LD1,"LD1 5UG, LD8 2AZ, LD8 2RD, LD8 2SR, LD8 2SS, LD8 2SX, LD8 2TB, LD8 2TE, LD8 2TF, LD8 2TL, LD8 2TN, LD8 2TP, LD8 2TR, LD8 2TW",251,231,20
W00002471,LD1,"LD1 6SD, LD1 6SE, LD1 6SF, LD1 6SG, LD1 6SJ, LD1 6SL, LD1 6SN, LD1 6SP, LD1 6SQ, LD1 6SW, LD1 6TE, LD1 6TF",278,257,21
W00002448,LD1,"LD1 5RP, LD1 5RR, LD1 5RY, LD1 5SD, LD1 5SE, LD1 5SF, LD1 5SG, LD2 3YB",308,278,30
W00002472,LD1,"LD1 5TD, LD1 5TE, LD1 5TF, LD1 5TG, LD1 5TH, LD1 5TL, LD1 5TN, LD1 5TW, LD1 5UN, LD1 6UP",201,174,27
W00002417,LD1,"LD1 5BD, LD1 5DG, LD1 5DH, LD1 5DL, LD1 5DN, LD1 5DR, LD1 5DS, LD1 5DT, LD1 5DU, LD1 5DY, LD1 5EE, LD1 5HF, LD1 5HS",240,228,12
W00002419,LD1,"LD1 5DP, LD1 5DW, LD1 5EA, LD1 5EQ, LD1 5ER, LD1 5EY, LD1 5HD, LD1 5HE, LD1 6AB, LD1 6AU, LD1 6AY",200,188,12
W00002298,LD2,"LD2 3AL, LD2 3AP, LD2 3AS, LD2 3AU, LD2 3AY, LD2 3BA, LD2 3BG, LD2 3BH, LD2 3BS, LD2 3BT, LD2 3BU, LD2 3BW, LD2 3DB, LD2 3DD, LD2 3DZ",271,226,45
W00002299,LD2,"LD2 3AA, LD2 3AB, LD2 3AD, LD2 3AE, LD2 3AG, LD2 3BB, LD2 3BD, LD2 3BL, LD2 3DL, LD2 3DN, LD2 3DP, LD2 3DR, LD2 3DS, LD2 3DT, LD2 3DU, LD2 3DW, LD2 3EF, LD2 3EG, LD2 3JA, LD2 3WA, LD2 3WB, LD2 3WP, LD2 3WQ, LD2 3WR, LD2 3WS, LD2 3WT, LD2 3WX, LD2 3WZ, LD2 9AA, LD2 9AB, LD2 9AE, LD2 9AF, LD2 9AH, LD2 9AJ, LD2 9AL, LD5 4WA, LD5 4WB, LD5 4WE",244,215,29
W00002345,LD2,"LD2 3AX, LD2 3AZ, LD3 0NT, LD3 0PA, LD3 0PT, LD3 0PU, LD3 0RB, LD3 0RD, LD3 0RE, LD3 0RF, LD3 0RG, LD3 0RH, LD3 0RL, LD3 0RN, LD3 0RW, LD3 0TS, LD3 0TT, LD3 0TU, LD3 0TY, LD3 0UF, LD3 0UG, LD3 0UH, LD3 0UL, LD3 9TB, LD3 9TH",341,293,48
W00002336,LD2,"LD2 3RA, LD2 3RB, LD2 3RP, LD2 3RR, LD2 3RS, LD2 3RT, LD2 3RU, LD2 3RW, LD2 3RY, LD2 3SA, LD2 3SN, LD2 3SP, LD2 3SW, LD2 3TH, LD2 3TN, LD2 3TS, LD2 3TT, LD2 3YE, LD2 3YF",329,314,15
W00002302,LD2,"LD2 3AN, LD2 3AR, LD2 3AT, LD2 3BE, LD2 3FD, LD2 3HA, LD2 3LB, LD2 3LF, LD2 3LZ",356,299,57
W00002301,LD2,"LD2 3AF, LD2 3AH, LD2 3AW, LD2 3DY, LD2 3EA, LD2 3EB, LD2 3ED, LD2 3EE, LD2 3FB, LD2 3GB, LD2 3GG",330,290,40
W00002300,LD2,"LD2 3DH, LD2 3DX, LD2 3EH, LD2 3EP, LD2 3FE, LD2 3GF",362,307,55
W00002292,LD2,"LD2 3TJ, LD2 3TQ, LD3 0LJ, LD3 0LN, LD3 0LW, LD3 0NP, LD3 0NW, LD3 0RY, LD3 0UP, LD3 0UR, LD3 0US, LD3 0UT, LD3 0UU, LD3 0UY, LD3 0YA, LD3 0YB, LD3 0YE, LD3 0YN, LD3 0YP, LD3 0YW",354,315,39
W00002401,LD2,"LD2 3NF, LD2 3NG, LD2 3NN",148,126,22
W00002294,LD2,"LD2 3AJ, LD2 3AQ, LD2 3BJ, LD2 3BQ, LD2 3BX, LD2 3BZ, LD2 3EJ, LD2 3EQ, LD2 3EX, LD2 3EZ, LD2 3HJ, LD2 3HQ, LD2 3HX, LD2 3HY, LD2 3HZ, LD2 3LJ, LD2 3LQ, LD2 3PJ, LD2 3PQ, LD2 3PX, LD2 3PZ, LD2 3SZ, LD2 3TX, LD2 3YR, LD2 3YS, LD2 3YT, LD2 3YU, LD2 3YY",399,346,53
W00002295,LD2,"LD2 3GA, LD2 3HE, LD2 3HF, LD2 3LD, LD2 3LE, LD2 3NH, LD2 3NL, LD2 3NX, LD2 3RE, LD2 3US",321,289,32
W00002296,LD2,"LD2 3BY, LD2 3DA, LD2 3DE, LD2 3DF, LD2 3DG",228,209,19
W00002402,LD2,"LD2 3FA, LD2 3FL, LD2 3GD, LD2 3GE, LD2 3LG, LD2 3LH, LD2 3NP, LD2 3NR, LD2 3NS, LD2 3NT, LD2 3NU, LD2 3NW, LD2 3NY, LD2 3PA, LD2 3PB, LD2 3PT, LD2 3PU, LD4 4BA, LD4 4BB, LD4 4BD",308,270,38
W00002403,LD2,"LD2 3DQ, LD2 3HD, LD2 3HG, LD2 3HH, LD2 3HL, LD2 3HN, LD2 3HP, LD2 3HR, LD2 3HS, LD2 3HT, LD2 3HU, LD2 3HW, LD2 3LA, LD2 3LX, LD2 3NQ, LD2 3RJ, LD2 3RQ, LD2 3RX, LD2 3RZ, LD2 3WD, LD2 3WE, LD2 3WF, LD2 3WG, LD2 3WH, LD2 3WJ, LD2 3WL, LD2 3WN, LD2 3YN, LD2 3YP, LD2 3YW",316,264,52
W00002447,LD2,"LD2 3FF, LD2 3SQ, LD2 3UH, LD2 3UL, LD2 3UN, LD2 3UP, LD2 3UR, LD2 3UT, LD2 3UU, LD2 3UW, LD2 3UY, LD2 3YA, LD2 3YD",239,214,25
W00002450,LD2,"LD2 3PY, LD2 3RD, LD2 3RF, LD2 3RG, LD2 3RH, LD2 3RL, LD2 3RN, LD2 3TB, LD2 3TD, LD2 3TF, LD2 3TP, LD2 3UD, LD2 3UE, LD2 3UF, LD2 3UG",277,241,36
W00002451,LD2,"LD2 3NJ, LD2 3SR, LD2 3SS, LD2 3ST, LD2 3SU, LD2 3SY, LD2 3TA, LD2 3TR, LD2 3TU, LD2 3TY, LD2 3UA, LD2 3UB, LD2 3WY",129,116,13
W00002297,LD2,"LD2 3BF, LD2 3BN, LD2 3BP, LD2 3DJ, LD2 3EL, LD2 3EN, LD2 3ER, LD2 3ES, LD2 3ET, LD2 3EU, LD2 3EW, LD2 3EY, LD2 3HB, LD2 3YL",291,243,48
W00002511,LD2,"LD2 3LL, LD4 4AE, LD4 4AF, LD4 4AJ, LD4 4AP, LD4 4AR, LD4 4AT, LD4 4AY, LD4 4BG, LD5 4UP, LD5 4UR, LD5 4UT, LD5 4YA, LD5 4YB, LD5 4YD, LD5 4YH",211,188,23
W00002648,LD3,"LD3 7JA, LD3 7UJ, LD3 7UQ, LD3 7UX, LD3 7UZ, LD3 7WX, LD3 7XD, LD3 7XL, LD3 7YJ, LD3 7YL, LD3 7YN, LD3 7YQ, LD3 7YX, LD3 7YZ",210,182,28
W00002634,LD3,"LD3 7AD, LD3 7AE, LD3 7AF, LD3 7AG, LD3 7AH, LD3 7AY, LD3 7BH, LD3 7BT, LD3 7BW, LD3 7DD, LD3 7DL, LD3 7DP, LD3 7DS, LD3 7DT, LD3 7DU, LD3 7DW, LD3 7EF, LD3 7EG, LD3 7EH, LD3 7ER, LD3 7ES, LD3 7EU, LD3 7EW, LD3 7EY, LD3 7FD, LD3 7HS, LD3 9AA",224,206,18
W00002636,LD3,"LD3 7BE, LD3 7DE, LD3 7DN, LD3 7DX, LD3 7DY, LD3 7EA, LD3 7EB, LD3 7EE, LD3 7EN, LD3 7HB, LD3 7HD, LD3 7HF, LD3 7HG, LD3 7HH, LD3 7HL, LD3 7HU, LD3 7HW",275,248,27
W00002637,LD3,"LD3 0AP, LD3 0BE, LD3 0BF, LD3 0BH, LD3 0BL, LD3 0BN, LD3 0BS, LD3 0BT, LD3 0BU, LD3 0BY, LD3 0DA, LD3 0DB, LD3 0DD, LD3 0DE, LD3 0DR, LD3 0DW, LD3 0PH, LD3 0PL",270,230,40
W00009775,LD3,"LD3 0AA, LD3 0AB, LD3 0AD, LD3 0AE, LD3 0AF, LD3 0AG, LD3 0AH, LD3 0AL, LD3 0BB, LD3 0BG, LD3 0BP, LD3 0BW, LD3 0PB, LD3 0PD, LD3 0PE, LD3 0PF, LD3 0PG",234,216,18
W00002638,LD3,"LD3 0AN, LD3 0AR, LD3 0AS, LD3 0AT, LD3 0AW, LD3 0DQ, LD3 0DX, LD3 0HF, LD3 0HG, LD3 0HH",361,335,26
W00009774,LD3,"LD3 0AU, LD3 0AY, LD3 0BA, LD3 0BD, LD3 0DF, LD3 0DG, LD3 0DH",354,315,39
W00002641,LD3,"LD3 0DP, LD3 0DT, LD3 0DU, LD3 0DY, LD3 0EA, LD3 0EB, LD3 0ED, LD3 0EE, LD3 0EF, LD3 0EG, LD3 0EH, LD3 0EJ, LD3 0EL, LD3 0EN, LD3 0EP, LD3 0ER, LD3 0ES, LD3 0ET, LD3 0EU, LD3 0EW, LD3 0EY, LD3 0HA, LD3 0PN, LD3 0PP, LD3 0PQ, LD3 0PR, LD3 0PW, LD3 0PY, LD3 0RA",439,391,48
W00002642,LD3,"LD3 8EF, LD3 8EH, LD3 8EW, LD3 8NA, LD3 8NB, LD3 8ND, LD3 8NS, LD3 8PB, LD3 8PD, LD3 8PE, LD3 8PF, LD3 8PJ",239,213,26
W00002530,LD3,"LD3 8TU, LD3 8UA, LD3 8UB, LD3 8UD",117,79,38
W00002529,LD3,"LD3 8PH, LD3 8PP, LD3 8PS, LD3 8PW, LD3 8RR, LD3 8RT, LD3 8RU, LD3 8RY, LD3 8TN",212,164,48
W00002528,LD3,"LD3 8HA, LD3 8HD, LD3 8HE, LD3 8HH, LD3 8HL, LD3 8RP, LD3 8SA, LD3 8SB, LD3 8SD, LD3 8SE, LD3 8SF, LD3 8SG, LD3 8SH, LD3 8SL, LD3 8SN, LD3 8SP, LD3 8SR, LD3 8SS, LD3 8ST, LD3 8SU, LD3 8SW, LD3 8TA, LD3 8TB, LD3 8TD, LD3 8TG, LD3 8YH",311,230,81
W00009791,LD3,"LD3 7SB, LD3 7SJ, NP7 7LP, NP7 7LY, NP8 1RP, NP8 1RR, NP8 1RS, NP8 1RT, NP8 1RU, NP8 1RW, NP8 1SP, NP8 1SY",372,332,40
W00009778,LD3,"LD3 9BA, LD3 9HA, LD3 9HB, LD3 9HD, LD3 9LG, LD3 9LH, LD3 9LL, LD3 9WL",180,147,33
W00002643,LD3,"LD3 8EJ, LD3 8EL, LD3 8EN, LD3 8EP, LD3 8ER, LD3 8FB, LD3 8HT, LD3 8HU, LD3 8LB, LD3 8LD, LD3 8LE, LD3 8LF, LD3 8LG, LD3 8NE, LD3 8NF, LD3 8NG, LD3 8NH, LD3 8NL, LD3 8NN, LD3 8NP, LD3 8NR, LD3 8NW",375,316,59
W00002644,LD3,"LD3 7SF, LD3 7SL, LD3 7SN, LD3 7SP, LD3 7SU, LD3 7SW, LD3 7UY, LD3 7WT, LD3 7XZ, LD3 7YA, LD3 7YB, LD3 7YD",238,216,22
W00002646,LD3,"LD3 7DQ, LD3 7DR, LD3 7EQ, LD3 7JE, LD3 7JH, LD3 7JJ, LD3 7JQ, LD3 7LJ, LD3 7LX, LD3 7LZ, LD3 7NU, LD3 7UT, LD3 7YE, LD3 7YF, LD3 7YG, LD3 7YH",239,203,36
W00002527,LD3,"LD3 7RF, LD3 8BH, LD3 8PG, LD3 8PL, LD3 8PN, LD3 8PR, LD3 8RL, LD3 8RS, LD3 8TP, LD3 8TR, LD3 8TS, LD3 8TT, LD3 8TW",290,247,43
W00002526,LD3,"LD3 8RB, LD3 8RD, LD3 8RE, LD3 8RG, LD3 8RH, LD3 8TY, LD3 8UT, LD3 8UU, LD3 8UY, LD3 8YD, LD3 8YE, LD3 8YF, LD3 8YG, SA9 1GP, SA9 1GR, SA9 1GS, SA9 1GT",279,211,68
W00002525,LD3,"LD3 8RF, LD3 8UE, LD3 8UF, LD3 8UG, LD3 8UH, LD3 8UL, LD3 8UN, LD3 8UP, LD3 8UQ, LD3 8UR, LD3 8UW, LD3 8YQ",272,218,54
W00002524,LD3,"LD3 8AJ, LD3 8PT, LD3 8PU, LD3 8PY, LD3 8RA, LD3 8SY, LD3 8TL, LD3 8YA, LD3 8YB, LD3 8YJ, LD3 8YL, LD3 8YN, LD3 8YP, LD3 8YR, LD3 8YS, LD3 8YT, LD3 8YU, LD3 8YW, LD3 8YY",224,151,73
W00002633,LD3,"LD3 7PN, LD3 7PP, LD3 7PU, LD3 7PW, LD3 7RN, LD3 7RU, LD3 7RW",262,235,27
W00002470,LD3,"LD3 0RP, LD3 0TL, LD3 0TN, LD3 0TW, LD3 7SY, LD3 7TF, LD3 7TG, LD3 7TH, LD3 7TJ, LD3 7TL, LD3 7TN, LD3 7TP, LD3 7TW, LD3 7TX, LD3 7UP, LD3 7UW",377,341,36
W00002469,LD3,"LD3 7FF, LD3 7PJ, LD3 7PX, LD3 7SZ, LD3 7TQ, LD3 7TU, LD3 7TY, LD3 7UA, LD3 7UB, LD3 7UD, LD3 7UE, LD3 7UF, LD3 7UG, LD3 7UH, LD3 7UL, LD3 7UN, LD3 7UR, LD3 7US, LD3 7UU",417,341,76
W00002468,LD3,"LD3 0PS, LD3 7EJ, LD3 7EX, LD3 7EZ, LD3 7PQ, LD3 7TA, LD3 7TB, LD3 7TD, LD3 7TE, LD3 7TR, LD3 7TS, LD3 7TT",304,277,27
W00002694,LD3,"LD3 9LP, LD3 9LR, LD3 9LS, LD3 9LW, LD3 9ND, LD3 9NE, LD3 9NF, LD3 9NN, LD3 9NP, LD3 9NR, LD3 9NS, LD3 9NT, LD3 9NU, LD3 9NW, LD3 9NY, LD3 9PA, LD3 9PB, LD3 9PD, LD3 9PE, LD3 9PH, LD3 9QA, LD3 9RN, LD3 9RP, LD3 9RR, LD3 9RW",439,381,58
W00002693,LD3,"LD3 8ES, LD3 8ET, LD3 8EU, LD3 8EY, LD3 8HB, LD3 8HF, LD3 8HG, LD3 8HN, LD3 8HP, LD3 8HR, LD3 8HS, LD3 8HW, LD3 8TE, LD3 8TF, LD3 8WF, LD3 8WG, LD3 8WH, LD3 9LT, LD3 9LU, LD3 9LY, LD3 9NA, LD3 9NB, LD3 9NG, LD3 9NH, LD3 9NL",353,301,52
W00002692,LD3,"LD3 9RD, LD3 9RG, LD3 9RS, LD3 9RT, LD3 9RU, LD3 9RY, LD3 9SA, LD3 9SB, LD3 9SD, LD3 9SE, LD3 9SF, LD3 9SG, LD3 9SH",242,205,37
W00002632,LD3,"LD3 7BG, LD3 7BL, LD3 7BN, LD3 7BP, LD3 7BU, LD3 7DZ, LD3 7ED, LD3 7EL, LD3 7ET, LD3 7FE, LD3 7HA, LD3 7HE",245,214,31
W00002375,LD3,"LD3 0RT, LD3 0SA, LD3 0SB, LD3 0SD, LD3 0SE, LD3 0SH, LD3 0SQ, LD3 0SX",302,280,22
W00009776,LD3,"LD3 9HF, LD3 9HH, LD3 9HL, LD3 9HN, LD3 9HP, LD3 9HR, LD3 9HW",460,424,36
W00002610,LD3,"LD3 0WA, LD3 0WB, LD3 0WD, LD3 0WE, LD3 0WF, LD3 0WG, LD3 0WL, LD3 0WN, LD3 0WW, LD3 0XR, LD3 3AA, LD3 3AD, LD3 3AE, LD3 3AF, LD3 3AG, LD3 3AH, LD3 3AL, LD3 3AN, LD3 3AP, LD3 3AQ, LD3 3AR, LD3 3AS, LD3 3AT, LD3 3AU, LD3 3AW, LD3 3AX, LD3 3AY, LD3 3AZ, LD3 3BA, LD3 3BB, LD3 3BD, LD3 3BE, LD3 3BF, LD3 3BG, LD3 3BH, LD3 3BJ, LD3 3BL, LD3 3BN, LD3 3BP, LD3 3BQ, LD3 3BR, LD3 3BS, LD3 3BT, LD3 3BX, LD3 3BY, LD3 3BZ, LD3 3DA, LD3 3DB, LD3 3DD, LD3 3DE, LD3 3DF, LD3 3DG, LD3 3DH, LD3 3DJ, LD3 3DL, LD3 3DN, LD3 7WB, LD3 7WD, LD3 7WE, LD3 7WF, LD3 7WG, LD3 7WH, LD3 7WJ, LD3 7WL, LD3 7WN, LD3 7WP, LD3 7WQ, LD3 7WR, LD3 7WS, LD3 7WU, LD3 7WW, LD3 7WY, LD3 7WZ, LD3 7XB, LD3 7XE, LD3 7XF, LD3 7XG, LD3 7XH, LD3 7XJ, LD3 7XN, LD3 7XQ, LD3 7XY, LD3 7ZD, LD3 7ZH, LD3 7ZR, LD3 7ZY, LD3 7ZZ, LD3 8BT, LD3 8DP, LD3 8DR, LD3 8DW, LD3 8ED, LD3 8EG, LD3 8EX, LD3 8LA, LD3 8LJ, LD3 8LQ, LD3 8NU, LD3 8PA, LD3 8WA, LD3 8WB, LD3 8WD, LD3 8WE, LD3 8WJ, LD3 8WL, LD3 8WN, LD3 8WP, LD3 8WQ, LD3 8YX, LD3 9AG, LD3 9WD, LD3 9WH, LD3 9WJ, LD3 9WQ, LD3 9WU, LD3 9YA",271,238,33
W00002611,LD3,"LD3 8BG, LD3 8DA, LD3 8DB, LD3 8DF",242,221,21
W00002612,LD3,"LD3 8DD, LD3 8DE, LD3 8DG, LD3 8DH, LD3 8DJ, LD3 8DL, LD3 8DN, LD3 8DQ, LD3 8DX",363,318,45
W00002613,LD3,"LD3 8AR, LD3 8AS, LD3 8AT, LD3 8AU, LD3 8AW, LD3 8AY, LD3 8BB, LD3 8BU, LD3 8BY, LD3 8EB",206,193,13
W00002614,LD3,"LD3 8DS, LD3 8DT, LD3 8DU, LD3 8DY, LD3 8EA, LD3 8EE",201,184,17
W00002615,LD3,"LD3 8AA, LD3 8AB, LD3 8AD, LD3 8AE, LD3 8AF, LD3 8AG, LD3 8AH, LD3 8AL, LD3 8AN, LD3 8AP, LD3 8AQ, LD3 8BA, LD3 8BD, LD3 8BE, LD3 8BL, LD3 8BN, LD3 8EQ, LD3 8LU",457,384,73
W00002616,LD3,"LD3 9EA, LD3 9EH, LD3 9EN, LD3 9EP, LD3 9EW, LD3 9HJ",263,226,37
W00002619,LD3,"LD3 9BP, LD3 9BQ, LD3 9BR",294,257,37
W00002620,LD3,"LD3 9PF, LD3 9PG, LD3 9UA, LD3 9UF, LD3 9UZ, LD3 9WA, LD3 9WB, LD3 9WE, LD3 9WF, LD3 9WG, LD3 9WN, LD3 9WP, LD3 9WR, LD3 9YF",252,225,27
W00002631,LD3,"LD3 9AP, LD3 9AR, LD3 9AS, LD3 9AT, LD3 9AU, LD3 9AY, LD3 9BB, LD3 9BD, LD3 9BE, LD3 9BG, LD3 9BH, LD3 9BL, LD3 9BN, LD3 9BW, LD3 9DE, LD3 9DJ, LD3 9DT, LD3 9DU, LD3 9LA, LD3 9LB",209,170,39
W00010339,LD3,"LD3 7BF, LD3 7EP, LD3 7JU, LD3 7PF, LD3 7PL, LD3 7PS, LD3 7PT, LD3 7PY, LD3 7RA, LD3 7RB, LD3 7RH, LD3 7RL, LD3 7RP, LD3 7SG, LD3 7SH, LD3 7ST",531,494,37
W00002621,LD3,"LD3 9EQ, LD3 9ES, LD3 9ET, LD3 9EY",186,168,18
W00002622,LD3,"LD3 9BS, LD3 9BT, LD3 9EL, LD3 9ER",216,195,21
W00002623,LD3,"LD3 9LD, LD3 9PL, LD3 9PN",275,261,14
W00002624,LD3,"LD3 9AX, LD3 9LE, LD3 9LF, LD3 9UB, LD3 9UD, LD3 9YB, LD3 9YD",320,300,20
W00010342,LD3,"LD3 7PR, LD3 7RD, LD3 7RE",138,123,15
W00002627,LD3,"LD3 7BY, LD3 7DA, LD3 7DB, LD3 7FB, LD3 7HP, LD3 7HR, LD3 7RR, LD3 7RS, LD3 7RT, LD3 7RY, LD3 7SA, LD3 9AQ, LD3 9SX, LD3 9SZ",479,422,57
W00002374,LD3,"LD3 0DL, LD3 0DN, LD3 0HB, LD3 0RS, LD3 0SF, LD3 0SG, LD3 0SJ, LD3 0SP, LD3 0SR, LD3 0SS, LD3 0ST, LD3 0SU, LD3 0SY, LD3 0SZ, LD3 0TA, LD3 0TB, LD3 0TD, LD3 0TE, LD3 0TF, LD3 0TG",358,332,26
W00002363,LD3,"LD3 0AQ, LD3 0DJ, LD3 0TH, LD3 0YD, LD3 0YF, LD3 0YG, LD3 0YH, LD3 0YJ, LD3 0YQ, LD3 0YT, LD3 0YU, LD3 0YX, LD3 0YZ",284,253,31
W00002347,LD3,"LD3 0TP, LD3 0TR, LD3 7SS, LD3 9AJ, LD3 9RL, LD3 9SN, LD3 9SP, LD3 9SS, LD3 9ST, LD3 9SU, LD3 9SW, LD3 9SY, LD3 9TA, LD3 9TD",224,185,39
W00002346,LD3,"LD3 9LN, LD3 9PP, LD3 9PR, LD3 9PS, LD3 9PT, LD3 9PU, LD3 9PW, LD3 9PY, LD3 9RA, LD3 9RB, LD3 9RE, LD3 9RF, LD3 9RH, LD3 9TE, LD3 9TF, LD3 9TG, LD3 9TL, LD3 9TN, LD3 9TP, LD3 9TR, LD3 9TS, LD3 9TT, LD3 9TW",421,365,56
W00002344,LD3,"LD3 0NA, LD3 0NB, LD3 0ND, LD3 0NE, LD3 0NF, LD3 0NG, LD3 0NH, LD3 0NL, LD3 0NN, LD3 0NR, LD3 0NS, LD3 0NU, LD3 0UA, LD3 0UB, LD3 0UD, LD3 0UE, LD3 0UJ, LD3 0UN, LD3 0UW",300,270,30
W00002305,LD3,"LD3 7HJ, LD3 7HN, LD3 7HQ, LD3 7HX, LD3 7HZ, LD3 7JL, LD3 7JR, LD3 7JS, LD3 7JT, LD3 7NQ, LD3 7PZ, LD3 7RJ, LD3 7RQ, LD3 7SX",338,310,28
W00002625,LD3,"LD3 9HS, LD3 9HT, LD3 9HU, LD3 9HY, LD3 9UE",319,285,34
W00002303,LD3,"LD3 7NJ, LD3 7NX, LD3 7NZ, LD3 7RX, LD3 7RZ, LD3 7SQ, NP8 1RD, NP8 1RE, NP8 1RF, NP8 1RG, NP8 1RH, NP8 1RJ, NP8 1RL, NP8 1RN, NP8 1RY, NP8 1SA, NP8 1SB, NP8 1SG, NP8 1SH",296,268,28
W00009777,LD3,"LD3 7JW, LD3 7LP, LD3 7LR, LD3 9DL, LD3 9DN, LD3 9DP, LD3 9DR, LD3 9DS, LD3 9DW, LD3 9DX, LD3 9DY, LD3 9EB, LD3 9ED, LD3 9EF, LD3 9EG, LD3 9EU, LD3 9HE, LD3 9HG",345,299,46
W00002629,LD3,"LD3 7LL, LD3 7LN, LD3 7LS, LD3 7LU, LD3 7LW, LD3 7LY, LD3 7NB, LD3 7PD, LD3 9DF, LD3 9DG, LD3 9DH",236,206,30
W00002628,LD3,"LD3 7AA, LD3 7AB, LD3 7AL, LD3 7AN, LD3 7AP, LD3 7AR, LD3 7AS, LD3 7AT, LD3 7AU, LD3 7AW, LD3 7BA, LD3 7BB, LD3 7DF, LD3 7DG, LD3 7DH, LD3 7DJ, LD3 7GA, LD3 7HY, LD3 7JP, LD3 7JZ, LD3 7LA, LD3 7LB, LD3 7LD, LD3 7LE, LD3 7LF, LD3 7LG, LD3 7LH, LD3 7LT, LD3 7PE, LD3 7QA, LD3 7SE, LD3 9AB, LD3 9AD, LD3 9AE, LD3 9AF, LD3 9AH, LD3 9AL, LD3 9AN, LD3 9AW, LD3 9BU, LD3 9BY, LD3 9DA, LD3 9DB, LD3 9DD, LD3 9EE",303,282,21
W00002293,LD3,"LD3 0HP, LD3 0HT, LD3 0HU, LD3 0HW, LD3 0HX, LD3 0LA, LD3 0LB, LD3 0LR, LD3 0LT",205,189,16
W00002291,LD3,"LD3 0BR, LD3 0DS, LD3 0DZ, LD3 0HL, LD3 0HN, LD3 0HR, LD3 0HS, LD3 0HY, LD3 0LD, LD3 0LE, LD3 0LF, LD3 0LG, LD3 0LH, LD3 0LL, LD3 0LP, LD3 0LS, LD3 0LU, LD3 0LX, LD3 0LY, LD3 0NY, LD3 0RU, LD3 0WH, LD3 0WJ",333,299,34
W00002630,LD3,"LD3 7NA, LD3 7ND, LD3 7NE, LD3 7NF, LD3 7NG, LD3 7NH, LD3 7NL, LD3 7NN, LD3 7NP, LD3 7NR, LD3 7NS, LD3 7NT, LD3 7NW, LD3 7NY, LD3 7PA, LD3 7PB, LD3 7PG, LD3 7SR, LD3 9SR",282,238,44
W00002505,LD4,"LD4 4BT, LD4 4BU, LD4 4BY, LD4 4DH, LD4 4DL, LD4 4DN, LD4 4DP, LD4 4DQ, LD4 4DR, LD4 4DS, LD4 4DT, LD4 4EF, LD4 4EG, LD4 4EH, LD4 4EP, LD4 4ER, LD4 4WA, LD4 4WB",257,218,39
W00002506,LD4,"LD4 4AA, LD4 4BF, LD4 4BH, LD4 4BL, LD4 4BN, LD4 4BP, LD4 4BS, LD4 4BW, LD4 4DG, LD4 4DU, LD4 4DW, LD4 4EA, LD4 4EB, LD4 4ED, LD4 4EE, LD4 4EL, LD4 4EN, LD4 4ES, LD4 4EW",240,197,43
W00002510,LD4,"LD4 4AB, LD4 4AD, LD4 4AG, LD4 4AH, LD4 4AL, LD4 4AN, LD4 4AS, LD4 4AU, LD4 4AW, LD4 4DA, LD4 4DB, LD4 4DD, LD4 4DE, LD4 4DF, LD4 4DJ, LD5 4AB, LD5 4SB, LD5 4SF, LD5 4SG, LD5 4SH, LD5 4TS, LD5 4TT, LD5 4TU, LD5 4TY, LD5 4UA, LD5 4UB, LD5 4UD, LD5 4UF, LD5 4UG, LD5 4UH, LD5 4UL, LD5 4UN, LD5 4UU, LD5 4UY, LD5 4YE, LD5 4YF",241,198,43
W00002509,LD5,"LD5 4RA, LD5 4RB, LD5 4RE, LD5 4RH, LD5 4RN, LD5 4RW, LD5 4RY, LD5 4SP, LD5 4SR, LD5 4SS, LD5 4ST",239,194,45
W00002507,LD5,"LD5 4AF, LD5 4AG, LD5 4AH, LD5 4BA, LD5 4RF, LD5 4RG, LD5 4RJ, LD5 4RL, LD5 4RP, LD5 4RQ, LD5 4RR, LD5 4RS, LD5 4RT, LD5 4RU, LD5 4RX, LD5 4SA, LD5 4SD, LD5 4SE, LD5 4TB",307,275,32
W00002508,LD5,"LD5 4AD, LD5 4AE, LD5 4RD, LD5 4SL, LD5 4SN, LD5 4SU, LD5 4SY, LD5 4TA, LD5 4TD, LD5 4TE, LD5 4TH, LD5 4TL, LD5 4TN, LD5 4TP, LD5 4TR, LD5 4TW, LD5 4WD",229,189,40
W00002544,LD6,"LD6 5LJ, LD6 5LL, LD6 5LN, LD6 5LP, LD6 5LR, LD6 5LW, LD6 5NA, SY18 6JN, SY18 6JW, SY18 6QU",265,246,19
W00002599,LD6,"LD6 5AE, LD6 5AF, LD6 5AR, LD6 5BH, LD6 5BN, LD6 5BP, LD6 5DN, LD6 5DS, LD6 5DT, LD6 5DU, LD6 5DY, LD6 5DZ, LD6 5EN, LD6 5ER, LD6 5EW",402,342,60
W00002598,LD6,"LD6 5EU, LD6 5EY, LD6 5HA, LD6 5HB, LD6 5HD, LD6 5HE, LD6 5HF, LD6 5HG, LD6 5HH, LD6 5HL, LD6 5HN, LD6 5HP, LD6 5HR, LD6 5HS, LD6 5HT, LD6 5HW, LD6 5HY, SY18 6RY, SY23 4AQ",244,208,36
W00002604,LD6,"LD6 5AW, LD6 5AY, LD6 5BA, LD6 5BB, LD6 5BD, LD6 5BG, LD6 5BW, LD6 5BY, LD6 5LA, LD6 5LB, LD6 5PL, LD6 5PP",260,240,20
W00002603,LD6,"LD6 5AA, LD6 5AB, LD6 5AD, LD6 5AG, LD6 5AH, LD6 5AL, LD6 5AN, LD6 5AP, LD6 5AS, LD6 5AT, LD6 5AU, LD6 5BE, LD6 5BT, LD6 5BU, LD6 5DD, LD6 5DL",302,255,47
W00002602,LD6,"LD6 5DF, LD6 5DG, LD6 5EL, LD6 5NN, LD6 5PW",222,202,20
W00002601,LD6,"LD6 5DA, LD6 5DB, LD6 5DE, LD6 5DH, LD6 5DJ, LD6 5DP, LD6 5DR, LD6 5DW, LD6 5EA, LD6 5EB, LD6 5ED, LD6 5EE, LD6 5EH, LD6 5ES, LD6 5LS, LD6 5NP, LD6 5PN, LD6 5UZ, LD6 5WA, LD6 5WB, LD6 5WD, LD6 5WF, LD6 5WG, LD6 5WH, LD6 5WJ, LD6 5WL, LD6 5WY, LD6 5WZ, LD6 5ZB",310,278,32
W00002600,LD6,"LD6 5EF, LD6 5EG, LD6 5EP",286,246,40
W00002543,LD6,"LD6 5LD, LD6 5LE, LD6 5LF, LD6 5LG, LD6 5LH, LD6 5LQ, LD6 5LT, LD6 5LU, LD6 5LX, LD6 5LY, LD6 5LZ, LD6 5NG, LD6 5NH, LD6 5NR, LD6 5NS, LD6 5WE",327,279,48
W00002392,LD7,"LD7 1BA, LD7 1DE, LD7 1DL, LD7 1DQ, LD7 1EF, LD7 1HF, LD7 1HQ, LD7 1RS",240,226,14
W00002393,LD7,"LD7 1DJ, LD7 1DS, LD7 1DU, LD7 1HP, LD7 1HX, LD7 1HY, LD7 1HZ, LD7 1LF, LD7 1LJ",297,275,22
W00002396,LD7,"LD7 1BT, LD7 1DB, LD7 1DG, LD7 1DH, LD7 1DN, LD7 1DR, LD7 1DW, LD7 1HG, LD7 1HL, LD7 1HU",210,201,9
W00002397,LD7,"LD7 1LD, LD7 1LE, LD7 1LW",265,245,20
W00002398,LD7,"LD7 1HJ, LD7 1HR, LD7 1HS, LD7 1HT, LD7 1HW, LD7 1LA, LD7 1LB, LD7 1LH, LD7 1LP, LD7 1LR, LD7 1LS, LD7 1LT, LD7 1LU, LD7 1LY, LD7 1NA",375,334,41
W00002399,LD7,"LD7 1DD, LD7 1DF, LD7 1EG, LD7 1EP, LD7 1HH, LD7 1LG, LD7 1LL, LD7 1LN, LD7 1NG, LD7 1NH, LD7 1PG, LD7 1PH, LD7 1SA, LD7 1SB, LD7 1SD, LD7 1UP, LD7 1UR, LD7 1UT, LD7 1WL, LD7 1WP, LD7 1WQ, LD7 1WU, LD7 1WW",302,273,29
W00002400,LD7,"LD7 1AL, LD7 1AN, LD7 1AS, LD7 1BD, LD7 1EN, LD7 1ER, LD7 1ES, LD7 1ET, LD7 1EU, LD7 1EW",192,178,14
W00002391,LD7,"LD7 1AG, LD7 1AJ, LD7 1AP, LD7 1AR, LD7 1AW, LD7 1BE, LD7 1DA, LD7 1DT, LD7 1EB, LD7 1ED, LD7 1EE, LD7 1WA, LD7 1WB, LD7 1WD, LD7 1WE, LD7 1WF, LD7 1WG, LD7 1WH, LD7 1WJ, LD7 1WN, LD7 1WR, LD7 1WS, LD7 1WX, LD7 1WY, LD7 1WZ, LD7 1ZY, LD7 9AA, LD7 9AB, LD7 9AE, LD7 9AG, LD7 9AH, LD7 9AJ, LD7 9AL, LD7 9AN, LD8 2WE, LD8 2WG, LD8 2WH, LD8 2WL, LD8 2WP, LD8 2ZU",197,188,9
W00002390,LD7,"LD7 1EH, LD7 1HB, LD7 1HN",294,283,11
W00002474,LD7,"LD7 1NJ, LD7 1NL, LD7 1NN, LD7 1NP, LD7 1NQ, LD7 1NR, LD7 1NW, LD7 1PD, LD7 1PE, LD7 1SE, LD7 1SF, LD8 2NN, LD8 2NP, LD8 2NR, LD8 2NS, LD8 2NW, LD8 2PB",335,308,27
W00002276,LD7,"LD7 1PF, LD7 1PL, LD7 1PN, LD7 1PP, LD7 1PR, LD7 1PS, LD7 1PW, LD7 1PZ, LD7 1RB, LD7 1RD, LD7 1RE, LD7 1RF, LD7 1RG, LD7 1RR, LD7 1RU, LD7 1TE, LD7 1TT, LD7 1UU, LD7 1UY",335,306,29
W00002395,LD7,"LD7 1HD, LD7 1HE, LD7 1RT, LD7 1RY",252,238,14
W00002394,LD7,"LD7 1AA, LD7 1AB, LD7 1AD, LD7 1AE, LD7 1AF, LD7 1AH, LD7 1AQ, LD7 1AT, LD7 1AU, LD7 1AY, LD7 1BB, LD7 1BG, LD7 1BL, LD7 1BP, LD7 1BS, LD7 1BU, LD7 1BW, LD7 1BY, LD7 1DP, LD7 1EY, LD7 1HA",226,214,12
W00002277,LD7,"LD7 1PT, LD7 1PU, LD7 1PY, LD7 1RH, LD7 1RL, LD7 1RN, LD7 1RP, LD7 1RW, LD7 1UG, LD7 1UH, LD7 1YA, LD7 1YB, LD7 1YD, LD7 1YE, LD7 1YF, LD7 1YG, LD7 1YH, LD7 1YL, LD7 1YN, LD7 1YP, LD7 1YR, LD7 1YT, LD7 1YW",340,318,22
W00002586,LD8,"LD8 2NG, LD8 2NT, LD8 2PA, LD8 2PD, LD8 2PF, LD8 2PG, LD8 2RY, LD8 2SA, LD8 2SD, LD8 2SE, LD8 2SF, LD8 2SG, LD8 2SH, LD8 2SJ, LD8 2SQ, LD8 2SZ",276,256,20
W00002596,LD8,"LD8 2DX, LD8 2EH, LD8 2EL, LD8 2EN, LD8 2EP, LD8 2EQ, LD8 2ER, LD8 2EW, LD8 2EY, LD8 2GA, LD8 2HA, LD8 2HB, LD8 2HD, LD8 2NX, LD8 2UB",371,354,17
W00002595,LD8,"LD8 2AT, LD8 2AU, LD8 2DE, LD8 2DN, LD8 2DU, LD8 2DW, LD8 2UF, LD8 2WN",218,202,16
W00002593,LD8,"LD8 2AJ, LD8 2AY, LD8 2HG, LD8 2HX, LD8 2LA, LD8 2LB, LD8 2LD, LD8 2LF, LD8 2RT, LD8 2UH, LD8 2YT, LD8 2ZY",357,328,29
W00002597,LD8,"LD8 2AX, LD8 2ED, LD8 2EE, LD8 2EF, LD8 2EG, LD8 2ET, LD8 2EU, LD8 2NF, LD8 2NL, LD8 2NQ, LD8 2RS, LD8 2UA",335,329,6
W00002584,LD8,"LD8 2SL, LD8 2SN, LD8 2SP, LD8 2ST, LD8 2SU, LD8 2SW, LD8 2SY, LD8 2TA, LD8 2TD, LD8 2TG, LD8 2TH, LD8 2TS, LD8 2TU",175,166,9
W00002594,LD8,"LD8 2BB, LD8 2BD, LD8 2BE, LD8 2BH, LD8 2BL, LD8 2BN, LD8 2DD, LD8 2DP, LD8 2DR, LD8 2DT, LD8 2DY, LD8 2EA, LD8 2EB",292,260,32
W00002592,LD8,"LD8 2AF, LD8 2AH, LD8 2AN, LD8 2AQ, LD8 2DG, LD8 2RJ, LD8 2RU",236,218,18
W00002589,LD8,"LD8 2BA, LD8 2BG, LD8 2BP, LD8 2BW, LD8 2DA, LD8 2DB, LD8 2DH, LD8 2ES",256,239,17
W00002590,LD8,"LD8 2DL, LD8 2DS, LD8 2NE, LD8 2NH, LD8 2NJ, LD8 2NY, LD8 2UG, LD8 2WD, LD8 2WJ",295,278,17
W00002591,LD8,"LD8 2AA, LD8 2AB, LD8 2AD, LD8 2AE, LD8 2AG, LD8 2AL, LD8 2AP, LD8 2AR, LD8 2AS, LD8 2AW, LD8 2BS, LD8 2BT, LD8 2BU, LD8 2BY, LD8 2HE, LD8 2HF",228,218,10
W00002125,LL11,"LL11 6AE, LL11 6ND, LL11 6NG, LL11 6NH, LL11 6NQ, LL11 6NS, LL11 6NT, LL11 6PA, LL11 6PB, LL11 6PD, LL11 6PE, LL11 6PF",312,276,36
W00002126,LL11,"LL11 6HJ, LL11 6HP, LL11 6HR, LL11 6HS, LL11 6HT, LL11 6HU, LL11 6LA, LL11 6LG, LL11 6LH, LL11 6LN, LL11 6NF, LL11 6NJ, LL11 6NN, LL11 6NP, LL11 6NR, LL11 6NU, LL11 6NW, LL11 6NY",315,287,28
W00002127,LL11,"LL11 6LT, LL11 6LU, LL11 6LW, LL11 6LY, LL11 6NE, LL11 6NL",309,279,30
W00002128,LL11,"LL11 6HY, LL11 6HZ, LL11 6LB, LL11 6LD, LL11 6LE, LL11 6LF, LL11 6LJ, LL11 6LL, LL11 6LQ, LL11 6LZ, LL11 6YW",203,175,28
W00001884,LL11,"LL11 5NF, LL11 6AQ, LL11 6LP, LL11 6LR, LL11 6LS, LL11 6NA, LL11 6NB",247,213,34
W00001885,LL11,"LL11 6BF, LL11 6DR, LL11 6DU, LL11 6DW, LL11 6EE, LL11 6EG, LL11 6EH, LL11 6EP, LL11 6ES, LL11 6ET, LL11 6EU",260,242,18
W00001886,LL11,"LL11 6BE, LL11 6BG, LL11 6BJ, LL11 6BL, LL11 6BP",233,206,27
W00001973,LL11,"LL11 2PN, LL11 2PW, LL11 2PX, LL11 2PY, LL11 2SH, LL11 2SR, LL11 2SW, LL12 8DP",289,255,34
W00001986,LL11,"LL11 0AA, LL11 0AB, LL11 0AD, LL11 0AE, LL11 0AF, LL11 0AG, LL11 0AH, LL11 0AJ, LL11 0AL, LL11 0AN, LL11 0AP, LL11 0AQ, LL11 0AR, LL11 0AS, LL11 0AT, LL11 0AU, LL11 0AW, LL11 0AX, LL11 0AY, LL11 0AZ, LL11 0BA, LL11 0BB, LL11 0BD, LL11 0BE, LL11 0BG, LL11 0BH, LL11 0BJ, LL11 0BL, LL11 0BP, LL11 0BQ, LL11 0BR, LL11 0BS, LL11 0BT, LL11 0BU, LL11 0BW, LL11 0BX, LL11 0BY, LL11 0BZ, LL11 0DA, LL11 0DB, LL11 0DD, LL11 0DE, LL11 0DF, LL11 0DG, LL11 0DH, LL11 0DJ, LL11 0DL, LL11 0DN, LL11 0DP, LL11 0DQ, LL11 0DR, LL11 0DS, LL11 0DT, LL11 0DU, LL11 0DW, LL11 0DX, LL11 0DY, LL11 0DZ, LL11 0EA, LL11 0EB, LL11 0ED, LL11 0EE, LL11 0EF, LL11 0EG, LL11 0EH, LL11 0EJ, LL11 0EL, LL11 0EN, LL11 0EP, LL11 0EQ, LL11 0ER, LL11 0ES, LL11 0ET, LL11 0EU, LL11 0EW, LL11 0EX, LL11 0EY, LL11 0EZ, LL11 0FA, LL11 0FB, LL11 0FD, LL11 0FE, LL11 0FF, LL11 0FG, LL11 0FH, LL11 0FJ, LL11 0FL, LL11 0FN, LL11 0FP, LL11 0FQ, LL11 0FR, LL11 0FS, LL11 0FT, LL11 0FU, LL11 0FW, LL11 0FX, LL11 0FY, LL11 0FZ, LL11 0GA, LL11 0GB, LL11 0GD, LL11 0GE, LL11 0GF, LL11 0GG, LL11 0GH, LL11 0GL, LL11 0GN, LL11 0GP, LL11 0GQ, LL11 0GR, LL11 0GS, LL11 0GT, LL11 0GU, LL11 0GW, LL11 0GX, LL11 0GY, LL11 0GZ, LL11 0HA, LL11 0HB, LL11 0HD, LL11 0HE, LL11 0HF, LL11 0HG, LL11 0HH, LL11 0HJ, LL11 0HL, LL11 0HN, LL11 0HP, LL11 0HQ, LL11 0HR, LL11 0HS, LL11 0HT, LL11 0HU, LL11 0HW, LL11 0HX, LL11 0HY, LL11 0HZ, LL11 0JA, LL11 0JB, LL11 0JD, LL11 0JE, LL11 0JF, LL11 0JG, LL11 0JH, LL11 0JJ, LL11 0JL, LL11 0JN, LL11 0JP, LL11 0JQ, LL11 0JR, LL11 0JS, LL11 0JT, LL11 0JU, LL11 0JW, LL11 0JX, LL11 0JZ, LL11 0LA, LL11 0LB, LL11 0LD, LL11 0LE, LL11 0LF, LL11 0LG, LL11 0LH, LL11 0LJ, LL11 0LL, LL11 0LN, LL11 0LP, LL11 0LQ, LL11 0LR, LL11 0LS, LL11 0LT, LL11 0LU, LL11 0LW, LL11 0LX, LL11 0LY, LL11 0LZ, LL11 0NA, LL11 0NB, LL11 0ND, LL11 0NE, LL11 0NF, LL11 0NG, LL11 0NH, LL11 0NJ, LL11 0NL, LL11 0NN, LL11 0NP, LL11 0NQ, LL11 0NR, LL11 0NS, LL11 0NT, LL11 0NU, LL11 0NW, LL11 0NX, LL11 0NY, LL11 0NZ, LL11 0PA, LL11 0PB, LL11 0PD, LL11 0PE, LL11 0PF, LL11 0PG, LL11 0PH, LL11 0PJ, LL11 0PL, LL11 0PN, LL11 0PP, LL11 0PQ, LL11 0PR, LL11 0PS, LL11 0PT, LL11 0PU, LL11 0PW, LL11 0PX, LL11 0PY, LL11 0PZ, LL11 0QA, LL11 0QB, LL11 0QD, LL11 0QE, LL11 0QF, LL11 0QG, LL11 0QJ, LL11 0QL, LL11 0QN, LL11 0QP, LL11 0QQ, LL11 0QR, LL11 0QT, LL11 0QU, LL11 0QW, LL11 0QX, LL11 0QY, LL11 0QZ, LL11 0RA, LL11 0RB, LL11 0RD, LL11 0RE, LL11 0RF, LL11 0RG, LL11 0RH, LL11 0SY, LL11 1AA, LL11 1BS, LL11 1BT, LL11 1BW, LL11 1BX, LL11 1BY, LL11 1DB, LL11 1DE, LL11 1DF, LL11 1DH, LL11 1DJ, LL11 1DQ, LL11 1DT, LL11 1EF, LL11 1EH, LL11 1PA, LL11 1PP, LL11 1PR, LL11 1QF, LL11 1QH, LL11 1QT, LL11 1QU, LL11 1QX, LL11 1TH, LL11 1WA, LL11 1WB, LL11 1WD, LL11 1WE, LL11 1WF, LL11 1WG, LL11 1WH, LL11 1WJ, LL11 1WL, LL11 1WN, LL11 1WP, LL11 1WQ, LL11 1WR, LL11 1WS, LL11 1WT, LL11 1WU, LL11 1WW, LL11 1WX, LL11 1WY, LL11 1WZ, LL11 1XG, LL11 1XH, LL11 1XU, LL11 1ZB, LL11 2LN, LL11 2LW, LL11 2WY, LL11 2WZ, LL11 2XX, LL11 2ZA, LL11 2ZB, LL11 2ZF, LL11 2ZG, LL11 2ZH, LL11 2ZJ, LL11 2ZL, LL11 2ZN, LL11 2ZU, LL11 2ZY, LL11 3FX, LL11 3FY, LL11 3FZ, LL11 3ZB, LL11 3ZE, LL11 3ZF, LL11 3ZG, LL11 3ZH, LL11 3ZJ, LL11 3ZL, LL11 3ZR, LL11 3ZY, LL11 4WA, LL11 4WB, LL11 4WD, LL11 4WR, LL11 4WZ, LL11 4ZB, LL11 4ZD, LL11 4ZE, LL11 4ZF, LL11 4ZG, LL11 4ZH, LL11 4ZJ, LL11 4ZN, LL11 4ZP, LL11 4ZQ, LL11 4ZR, LL11 4ZU, LL11 5WR, LL11 5ZA, LL11 5ZB, LL11 5ZD, LL11 5ZE, LL11 5ZJ, LL11 5ZN, LL11 5ZP, LL11 5ZQ, LL11 5ZR, LL11 5ZZ, LL11 6YQ, LL11 6ZA, LL11 6ZB, LL11 6ZD, LL11 6ZE, LL11 6ZG, LL11 6ZU, LL12 0YZ, LL12 0ZA, LL12 0ZB, LL12 0ZD, LL12 0ZF, LL12 0ZG, LL12 0ZN, LL12 0ZP, LL12 0ZQ, LL12 0ZS, LL12 0ZT, LL12 0ZU, LL12 0ZW, LL12 7WA, LL12 7WE, LL12 7WF, LL12 7WJ, LL12 7WL, LL12 7YZ, LL12 8WZ, LL12 8YS, LL12 8ZA, LL12 8ZB, LL12 8ZD, LL12 8ZE, LL12 8ZF, LL12 8ZG, LL12 8ZH, LL12 8ZJ, LL12 8ZL, LL12 8ZN, LL12 8ZP, LL12 8ZQ, LL12 8ZR, LL12 9WG, LL12 9WJ, LL12 9WQ, LL12 9XB, LL12 9ZA, LL12 9ZB, LL12 9ZD, LL12 9ZF, LL12 9ZH, LL12 9ZJ, LL12 9ZU, LL12 9ZY, LL13 0TZ, LL13 0WH, LL13 0WL, LL13 0WP, LL13 0WQ, LL13 0WR, LL13 0WS, LL13 0WT, LL13 0WU, LL13 0WW, LL13 0WX, LL13 0WY, LL13 0WZ, LL13 0XB, LL13 0XP, LL13 0XQ, LL13 0XR, LL13 0XT, LL13 0YQ, LL13 0YX, LL13 0ZA, LL13 0ZB, LL13 0ZD, LL13 0ZE, LL13 0ZF, LL13 0ZG, LL13 0ZH, LL13 0ZJ, LL13 0ZL, LL13 0ZN, LL13 0ZP, LL13 0ZR, LL13 0ZS, LL13 0ZT, LL13 7NS, LL13 7WL, LL13 7WR, LL13 7WT, LL13 7WU, LL13 7WW, LL13 7WX, LL13 7WY, LL13 7WZ, LL13 7XB, LL13 7ZA, LL13 7ZE, LL13 7ZF, LL13 7ZH, LL13 7ZJ, LL13 7ZL, LL13 7ZN, LL13 7ZU, LL13 7ZW, LL13 7ZY, LL13 8XR, LL13 8YW, LL13 8ZA, LL13 8ZD, LL13 8ZE, LL13 8ZG, LL13 8ZH, LL13 8ZR, LL13 9AA, LL13 9WA, LL13 9WH, LL13 9WL, LL13 9WN, LL13 9WP, LL13 9WQ, LL13 9WU, LL13 9WX, LL13 9XF, LL13 9ZA, LL13 9ZB, LL13 9ZD, LL13 9ZE, LL13 9ZF, LL13 9ZG, LL13 9ZH, LL13 9ZJ, LL13 9ZL, LL13 9ZN, LL13 9ZP, LL13 9ZQ, LL13 9ZR, LL13 9ZS, LL13 9ZT, LL13 9ZU, LL13 9ZW, LL14 1WA, LL14 1WB, LL14 1WD, LL14 1WE, LL14 1WF, LL14 2WA, LL14 2WB, LL14 2WE, LL14 2WF, LL14 2XF, LL14 3JR, LL14 3ZB, LL14 3ZD, LL14 3ZE, LL14 3ZG, LL14 3ZU, LL14 3ZW, LL14 3ZY, LL14 4ZA, LL14 4ZB, LL14 4ZE, LL14 4ZF, LL14 4ZG, LL14 4ZH, LL14 4ZT, LL14 5WY, LL14 5YG, LL14 6WE, LL14 6WF, LL14 6WH, LL14 6YH",401,369,32
W00001887,LL11,"LL11 6AL, LL11 6AP, LL11 6AT, LL11 6AX, LL11 6AZ, LL11 6BY, LL11 6DB, LL11 6DD, LL11 6DE, LL11 6DH, LL11 6DJ, LL11 6DN, LL11 6DQ, LL11 6DS, LL11 6DT",209,180,29
W00002130,LL11,"LL11 6HX, LL11 6JG, LL11 6QA, LL11 6QD, LL11 6QF, LL11 6QG, LL11 6SH, LL11 6TD, LL11 6TE, LL11 6YE, LL11 6YF, LL11 6YG, LL11 6YJ, LL11 6YL, LL11 6YN, LL11 6ZF",473,414,59
W00001871,LL11,"LL11 5AA, LL11 5AG, LL11 5AJ, LL11 5BE, LL11 5BQ, LL11 5DA, LL11 5DB, LL11 5DD, LL11 5DE, LL11 5DG, LL11 5EB",249,222,27
W00002129,LL11,"LL11 6FA, LL11 6FB, LL11 6FD, LL11 6JA, LL11 6JB, LL11 6JD, LL11 6JE, LL11 6JF, LL11 6UP, LL11 6UW",581,496,85
W00001875,LL11,"LL11 1PF, LL11 1PG, LL11 1PJ, LL11 2AD, LL11 2AE, LL11 2AJ, LL11 2AP, LL11 2AQ, LL11 2AR, LL11 2AT, LL11 2AY, LL11 2BY, LL11 2DB, LL11 2DW",313,277,36
W00001974,LL11,"LL11 2PS, LL11 2PT, LL11 2PU, LL11 2RA, LL11 2RS, LL11 2TE, LL11 2TJ, LL11 2TN",329,294,35
W00002124,LL11,"LL11 6AA, LL11 6AD, LL11 6AY, LL11 6DA, LL11 6DG, LL11 6DL, LL11 6HD, LL11 6HF, LL11 6HG, LL11 6HH, LL11 6HL, LL11 6HN, LL11 6HW",226,195,31
W00002131,LL11,"LL11 6SP, LL11 6SR, LL11 6SS, LL11 6ST, LL11 6SU, LL11 6SW, LL11 6SY, LL11 6TA, LL11 6UR, LL11 6US, LL11 6UT, LL11 6UU, LL11 6UY, LL11 6WA, LL11 6WB, LL11 6YB, LL11 6YD, LL11 6YT",258,232,26
W00001876,LL11,"LL11 2AF, LL11 2AX, LL11 2AZ, LL11 2BB",241,216,25
W00001980,LL11,"LL11 1YE, LL11 2UD, LL12 8LX, LL12 8NA, LL12 8PG, LL12 8PP, LL12 8PR, LL12 8PS, LL12 8PT, LL12 8PU, LL12 8PW, LL12 8RA, LL12 8RB, LL12 8RD, LL12 8RF, LL12 8RP, LL12 8RR, LL12 8RS, LL12 8RT, LL12 8RW, LL12 8TL, LL12 8TS, LL12 8TT, LL12 8TU",328,297,31
W00002019,LL11,"LL11 4AE, LL11 4AF, LL11 4AH, LL11 4AL, LL11 4AN, LL11 4AU, LL11 4AW, LL11 4EQ, LL11 4ER, LL11 4HD, LL11 4HF, LL11 4HH, LL11 4HL, LL11 4HN, LL11 4HQ, LL11 4HU, LL11 4HX, LL11 4HZ",467,410,57
W00002123,LL11,"LL11 6BZ, LL11 6DP, LL11 6DX, LL11 6DZ, LL11 6EQ, LL11 6ER, LL11 6EX, LL11 6SL, LL11 6TB, LL11 6TP, LL11 6TS, LL11 6TT, LL11 6TU, LL11 6TY, LL11 6UA, LL11 6UB, LL11 6UD, LL11 6UE, LL11 6YA, LL11 6YP, LL11 6YZ",581,516,65
W00002122,LL11,"LL11 3DR, LL11 3DS, LL11 3DT, LL11 3DU, LL11 3DY, LL11 3EA, LL11 3EB, LL11 3ED, LL11 3EE, LL11 5TT, LL11 5UL, LL11 5YU, LL14 4LR, LL14 4LS, LL14 4LT, LL14 4LU",231,187,44
W00002121,LL11,"LL11 3LX, LL11 3NZ, LL11 3RE, LL11 3UQ, LL11 3US, LL11 3YA, LL11 3YB",306,255,51
W00002120,LL11,"LL11 1YB, LL11 1YD, LL11 3BY, LL11 3PY, LL11 3RD, LL11 3RH, LL11 3UT, LL11 3UU, LL11 3YD, LL11 3YE, LL11 3YF, LL11 3YG, LL11 3YH, LL11 3YL, LL11 3YU, LL11 3YY, LL11 3ZA, LL11 3ZD",357,310,47
W00001985,LL11,"LL11 0BF, LL11 0BN, LL11 0ZX, LL11 0ZY, LL11 0ZZ, LL11 1AB, LL11 1AE, LL11 1AF, LL11 1AG, LL11 1AH, LL11 1AJ, LL11 1AL, LL11 1AP, LL11 1AR, LL11 1AS, LL11 1AT, LL11 1AU, LL11 1AY, LL11 1BA, LL11 1BB, LL11 1BE, LL11 1BL, LL11 1BN, LL11 1BU, LL11 1DD, LL11 1DG, LL11 1DN, LL11 1DP, LL11 1DR, LL11 1DS, LL11 1DU, LL11 1DW, LL11 1DY, LL11 1EA, LL11 1EB, LL11 1ED, LL11 1EE, LL11 1EG, LL11 1EJ, LL11 1EP, LL11 1EQ, LL11 1ER, LL11 1HE, LL11 1HF, LL11 1HG, LL11 1HH, LL11 1HN, LL11 1HP, LL11 1HR, LL11 1HT, LL11 1HU, LL11 1HY, LL11 1LA, LL11 1LB, LL11 1LD, LL11 1LE, LL11 1LF, LL11 1LG, LL11 1LH, LL11 1LJ, LL11 1LN, LL11 1LP, LL11 1LR, LL11 1LS, LL11 1LW, LL11 1LY, LL11 1NA, LL11 1NB, LL11 1ND, LL11 1NE, LL11 1NF, LL11 1NH, LL11 1NL, LL11 1NR, LL11 1NS, LL11 1NW, LL11 1PN, LL11 1QE, LL11 1QY, LL11 1RE, LL11 1RP, LL11 1RR, LL11 1RU, LL11 1SA, LL11 1SD, LL11 1SE, LL11 1SF, LL11 1SJ, LL11 1TL, LL11 1UX, LL11 1ZA, LL11 1ZN, LL11 1ZP, LL11 2LP, LL11 2LR, LL11 2SB, LL11 2SJ, LL12 7AA, LL12 7AB, LL12 7AX, LL13 8AA, LL13 8AB, LL13 8AD, LL13 8AE, LL13 8AU, LL13 8AW, LL13 8AY, LL13 8AZ, LL13 8BD, LL13 8BG, LL13 8BL, LL13 8BN, LL13 8BP, LL13 8BW, LL13 8HP, LL13 8HS, LL13 8HT, LL13 8LH, LL13 8TJ",413,371,42
W00002119,LL11,"LL11 3DA, LL11 3DB, LL11 3DP, LL11 3DW, LL11 3YJ, LL11 3YN, LL11 3YP, LL11 3YQ, LL11 3YR, LL11 3YT, LL11 3YW, LL11 3YZ",296,237,59
W00001883,LL11,"LL11 2AG, LL11 2BD, LL11 2BE, LL11 2BG, LL11 2BH, LL11 2BL, LL13 7YH, LL13 7YY",250,195,55
W00002132,LL11,"LL11 6SG, LL11 6SJ, LL11 6SN, LL11 6TF, LL11 6TG, LL11 6TH, LL11 6TJ, LL11 6TL, LL11 6TN, LL11 6YS, LL11 6YY",278,242,36
W00001891,LL11,"LL11 5DQ, LL11 5DR, LL11 5DT, LL11 5DX, LL11 6BH, LL11 6BN, LL11 6BS, LL11 6BU, LL11 6BW, LL12 9TG",186,170,16
W00002149,LL11,"LL11 1ET, LL13 0DT, LL13 0DY, LL13 0EA, LL13 0EB, LL13 0ED, LL13 0EE, LL13 0EJ, LL13 0EN, LL13 0FB, LL13 0FG, LL13 0HE, LL13 0HF",228,206,22
W00001942,LL11,"LL11 3DZ, LL11 3EG, LL11 3EH, LL11 3ES, LL11 3EU, LL11 3LH, LL11 3LU, LL11 3LY, LL11 3ND, LL11 3NE, LL11 3NF, LL11 3NQ",312,271,41
W00001943,LL11,"LL11 3SS, LL11 3ST, LL11 3SU, LL11 3SY, LL11 3TA, LL11 3TB, LL11 3TD, LL11 3TJ, LL11 3TN, LL11 3TP, LL11 3UA",214,182,32
W00001941,LL11,"LL11 3LS, LL11 3NA, LL11 3NB, LL11 3NG, LL11 3NH, LL11 3NL, LL11 3NS, LL11 3NT, LL11 3NX, LL11 3RU, LL11 3RY, LL11 3SA, LL11 3SB, LL11 3SD, LL11 3SE, LL11 3SF",272,210,62
W00002001,LL11,"LL11 1UA, LL11 4AD, LL11 4DE, LL11 4HT, LL11 4NR, LL11 4NS, LL11 4NT, LL11 4NU, LL11 4PA, LL11 4PG, LL11 4PH, LL11 4PL, LL11 4PN, LL11 4PP, LL11 4PR, LL11 4PS, LL11 4PT, LL11 4PW, LL11 4QN, LL11 4QS, LL11 4RA, LL11 4RF, LL11 4RG, LL11 4RH, LL11 4SD, LL11 4SE, LL11 4TH",449,396,53
W00001944,LL11,"LL11 3PH, LL11 3PJ, LL11 3PN, LL11 3PT, LL11 3PX, LL11 3PZ",256,207,49
W00001945,LL11,"LL11 3PQ, LL11 3PR, LL11 3PS, LL11 3QA, LL11 3QD, LL11 3UG, LL11 3UH, LL11 3UL, LL11 3UN, LL11 3UR",334,274,60
W00001946,LL11,"LL11 3EX, LL11 3NY, LL11 3PW, LL11 3QB, LL11 3SG, LL11 3UB, LL11 3UD, LL11 3UE, LL11 3UF, LL11 3UW, LL11 3WB",244,205,39
W00001947,LL11,"LL11 3FW, LL11 3SH, LL11 3SL, LL11 3SN, LL11 3SP, LL11 3SR, LL11 3SW",246,203,43
W00001940,LL11,"LL11 3BU, LL11 3LD, LL11 3LF, LL11 3PB, LL11 3PD, LL11 3PG, LL11 3PL, LL11 3PP, LL11 3RA, LL11 3RB",350,276,74
W00001948,LL11,"LL11 3HP, LL11 3HR, LL11 3HS, LL11 3HT, LL11 3HU, LL11 3HY, LL11 3LA, LL11 3LE",308,257,51
W00001949,LL11,"LL11 3DQ, LL11 3EL, LL11 3EP, LL11 3EQ, LL11 3ER, LL11 3ET, LL11 3EW, LL11 3HB, LL11 3HD, LL11 3HE, LL11 3HG, LL11 3HH, LL11 3LB, LL11 3LG, LL11 3LL, LL11 3NN",322,264,58
W00001950,LL11,"LL11 3HL, LL11 3HN, LL11 3HW",301,261,40
W00001951,LL11,"LL11 3EY, LL11 3HA, LL11 3HF, LL11 3HJ, LL11 3HX, LL11 3HZ, LL11 3LW",198,167,31
W00002002,LL11,"LL11 2UB, LL11 4BA, LL11 4BG, LL11 4BQ, LL11 4BX, LL11 4DG, LL11 4DH, LL11 4DQ, LL11 4FA",232,207,25
W00002017,LL11,"LL11 4TL, LL11 4TN, LL11 4TP, LL11 4TW, LL11 4TX, LL11 4YX",211,185,26
W00002003,LL11,"LL11 4AG, LL11 4BN, LL11 4BU, LL11 4BW, LL11 4BY, LL11 4DA, LL11 4DB",292,251,41
W00001870,LL11,"LL11 5AB, LL11 5AD, LL11 5AY, LL11 5BA, LL11 5BD, LL11 5BL, LL11 5BP, LL11 5BW, LL11 5BY, LL11 5EE, LL11 5EQ, LL11 5EX",340,294,46
W00001888,LL11,"LL11 6BD, LL11 6BQ, LL11 6BX, LL11 6DF, LL11 6DY, LL11 6EA, LL11 6EB, LL11 6ED, LL11 6EF, LL11 6EJ, LL11 6EL, LL11 6EN, LL11 6EW, LL11 6EY, LL11 6FZ",453,409,44
W00001972,LL11,"LL11 2SY, LL11 2TB, LL11 2TD, LL11 2TF, LL11 2TL",228,198,30
W00001889,LL11,"LL11 6AB, LL11 6AF, LL11 6AG, LL11 6AH, LL11 6AJ, LL11 6AN, LL11 6AR, LL11 6AS, LL11 6AU, LL11 6AW, LL11 6BA, LL11 6BB, LL11 6BT, LL11 6EZ",264,231,33
W00001890,LL11,"LL11 5NG, LL11 5NP, LL11 5NW",146,131,15
W00001971,LL11,"LL11 2UA, LL11 2UP, LL11 2UR, LL11 2US, LL11 2UW, LL11 2YA, LL11 2YD, LL11 2YE, LL11 2YF, LL12 8DU, LL12 8DY, LL12 8EA, LL12 8ED",280,251,29
W00001970,LL11,"LL11 2TA, LL11 2TG, LL11 2TH, LL11 2UL, LL11 2UN, LL11 2UT, LL11 2UU, LL11 2UY, LL11 2XG, LL11 2YG",274,242,32
W00002133,LL11,"LL11 6TQ, LL11 6TR, LL11 6TW, LL11 6TZ, LL11 6UF, LL11 6UG, LL11 6UH, LL11 6UL, LL11 6UN",184,162,22
W00001937,LL11,"LL11 3LJ, LL11 3NU, LL11 3PA, LL11 3PE, LL11 3PF",315,262,53
W00001939,LL11,"LL11 3RJ, LL11 3RN, LL11 3RP, LL11 3RR, LL11 3RS, LL11 3RT, LL11 3RW, LL11 3TE, LL11 3TF, LL11 3TG, LL11 3TH, LL11 3TL, LL11 3TR, LL11 3TS, LL11 3TT, LL11 3TU, LL11 3TW, LL11 3TY",303,233,70
W00001969,LL11,"LL11 2RD, LL11 2RE, LL11 2RF, LL11 2RG, LL11 2RH, LL11 2RN",261,230,31
W00002047,LL11,"LL11 3PU, LL13 8NE, LL13 9AD, LL13 9BZ, LL13 9JB, LL13 9PX, LL13 9SA, LL13 9SB, LL13 9SD, LL13 9SF, LL13 9SG, LL13 9SH, LL13 9SJ, LL13 9SL, LL13 9SN, LL13 9SP, LL13 9SR, LL13 9SS, LL13 9ST, LL13 9SU, LL13 9SW, LL13 9SY, LL13 9TA, LL13 9TB, LL13 9TD, LL13 9TF, LL13 9TR, LL13 9TW, LL13 9UB, LL13 9UF, LL13 9UR, LL13 9YA, LL13 9YB, LL13 9YD, LL13 9YE",441,419,22
W00001968,LL11,"LL11 2SP, LL11 2SS, LL11 2ST, LL11 2SU, LL11 2TP, LL11 2YB, LL12 8DR, LL12 8DW",273,234,39
W00002004,LL11,"LL11 4BL, LL11 4BP, LL11 4BS, LL11 4BT, LL11 4DX",255,215,40
W00002018,LL11,"LL11 4EN, LL11 4ES, LL11 4EU, LL11 4HG, LL11 4UB",287,261,26
W00001938,LL11,"LL11 3BP, LL11 3BS, LL11 3BT, LL11 3EN, LL11 3LN, LL11 3LP, LL11 3LQ, LL11 3LR, LL11 3LT, LL11 3LZ, LL11 3NJ, LL11 3NP, LL11 3NR, LL11 3NW, LL11 3RF, LL11 3RG, LL11 3RL, LL11 6PL, LL11 6PW, LL14 4LN",323,277,46
W00001869,LL11,"LL11 5AN, LL11 5AP, LL11 5AW",293,263,30
W00002009,LL11,"LL11 4AR, LL11 4AY, LL11 4AZ, LL11 4BB, LL11 4BD, LL11 4BE, LL11 4BH, LL11 4BZ, LL11 4DZ",231,202,29
W00002020,LL11,"LL11 4QD, LL11 4QE, LL11 4QH, LL11 4QJ, LL11 4SN, LL11 4SR, LL11 4SS, LL11 4ST, LL11 4SU, LL11 4TA, LL11 4TB, LL11 4TD, LL11 4TE, LL11 4TY, LL11 4TZ, LL11 4UA",384,311,73
W00001994,LL11,"LL11 6RD, LL11 6RH, LL11 6RL, LL11 6RN, LL11 6RS, LL11 6RU, LL11 6RW, LL11 6RY, LL11 6SA",322,284,38
W00001995,LL11,"LL11 6RP, LL11 6RR, LL11 6RT, LL11 6YH, LL11 6YR",262,233,29
W00002006,LL11,"LL11 4AJ, LL11 4RQ, LL11 4RY",280,240,40
W00001996,LL11,"LL11 5NT, LL11 5NU, LL11 5NY, LL11 5PA, LL11 5PB, LL11 5PD, LL11 5PE, LL11 5PF, LL11 5PG, LL11 5PJ, LL11 5PL, LL11 5PQ, LL11 5PT, LL11 5RS, LL11 5SZ",222,210,12
W00001997,LL11,"LL11 6PT, LL11 6RB, LL11 6RE, LL11 6SB, LL11 6SD, LL11 6SE, LL11 6SF",306,278,28
W00002079,LL11,"LL11 4DD, LL11 4DF, LL12 0NH, LL12 0PN, LL12 0RP, LL12 8RU, LL12 8RY, LL12 8SA",294,270,24
W00002100,LL11,"LL11 1UE, LL11 1UF, LL11 1UH, LL11 1UJ, LL11 1UL, LL11 1UQ, LL11 1UR, LL11 1US, LL11 1UT, LL11 1UU, LL11 1UY, LL11 1XB, LL11 1XD, LL11 1XE, LL11 1XF, LL11 1XJ, LL11 1XL, LL11 1XP, LL11 1XQ, LL11 1XS, LL11 1XW, LL11 1XX, LL11 1XY, LL11 1XZ, LL13 0DD, LL13 0DE, LL13 0DF, LL13 0DG, LL13 0DH, LL13 0DL, LL13 0DN, LL13 0DR, LL13 0DW, LL13 0SN, LL13 0SW, LL13 0YD, LL13 0YE, LL13 0YF, LL13 0YG",359,336,23
W00002030,LL11,"LL11 4SX, LL11 4SZ, LL11 4TJ, LL11 4TQ, LL11 4YU",328,271,57
W00002029,LL11,"LL11 4UN, LL11 4UW, LL11 4XB, LL11 4XD, LL11 4XE, LL11 4XF, LL11 4YR",275,229,46
W00001998,LL11,"LL11 5PH, LL11 5PN, LL11 5PP, LL11 5PR, LL11 5PS, LL11 5PU, LL11 5PW, LL11 5RD, LL11 5RE, LL11 5RF, LL11 5RG, LL11 5RL, LL11 5RN, LL11 5RP, LL11 5RW, LL11 6PN, LL11 6PP, LL11 6PR, LL11 6TX",304,259,45
W00001999,LL11,"LL11 4HJ, LL11 4HY, LL11 4NE, LL11 4NH, LL11 4NJ, LL11 4NL, LL11 4NN, LL11 4NP, LL11 4NW, LL11 4PB, LL11 4PD, LL11 4PE, LL11 4PF, LL11 4RX",336,307,29
W00002027,LL11,"LL11 4DP, LL11 4QT, LL11 4SG, LL11 4UJ, LL11 4UX, LL11 4XA",213,200,13
W00002026,LL11,"LL11 4QA, LL11 4QB, LL11 4SH, LL11 4SL, LL11 4SP, LL11 4SW, LL11 4TF, LL11 4UE, LL11 4UP, LL11 6HA, LL11 6HB",297,253,44
W00002025,LL11,"LL11 4AA, LL11 4AB, LL11 4DS, LL11 4DY, LL11 4EA",246,234,12
W00002016,LL11,"LL11 4EX, LL11 4HP, LL11 4HR, LL11 4HW, LL11 4UF, LL11 4UG",295,270,25
W00001667,LL11,"LL11 1YR, LL11 5EF, LL11 5EG, LL11 5EH, LL11 5EL, LL11 5EP, LL11 5ER, LL11 5HF, LL11 5LG, LL11 5LH, LL11 5LJ, LL11 5LL, LL11 5LN, LL11 5LW, LL12 0UP",371,312,59
W00001669,LL11,"LL11 5HG, LL11 5HH, LL11 5HL, LL11 5HN, LL11 5HR, LL11 5HS, LL11 5HT, LL11 5HU, LL11 5HY, LL11 5HZ, LL11 5LA, LL11 5LP, LL11 5TX, LL11 5YP, LL11 5YR, LL11 5YW",351,283,68
W00001993,LL11,"LL11 5PY, LL11 5RA, LL11 5RB, LL11 5RH, LL11 5RR, LL11 6PJ, LL11 6PS, LL11 6PU, LL11 6PY, LL11 6RA, LL11 6RF, LL11 6RG",282,258,24
W00001670,LL11,"LL11 5EN, LL11 5ES, LL11 5ET, LL11 5EU, LL11 5EW, LL11 5EY, LL11 5HA, LL11 5HB, LL11 5HD, LL11 5HE, LL11 5HP, LL11 5HW, LL11 5LB, LL11 5LE, LL12 9AX, LL12 9AZ, LL12 9HT, LL12 9TN, LL12 9TT",410,347,63
W00002010,LL11,"LL11 2UH, LL12 8EE, LL12 8EJ, LL12 8EQ, LL12 8EZ, LL12 8PJ, LL12 8PL, LL12 8PQ, LL12 8PZ",344,303,41
W00002007,LL11,"LL11 4BJ, LL11 4DL, LL11 4DN, LL11 4DW",273,217,56
W00010024,LL11,"LL11 3BN, LL11 3BQ, LL11 3BW, LL11 3BX, LL11 3BZ, LL13 7AG, LL13 7ZB",379,339,40
W00001989,LL11,"LL11 1EL, LL11 2AA, LL11 2AB, LL11 2AH, LL11 2AL, LL11 2AN, LL11 2HT, LL11 2JB, LL11 2NU, LL11 2NY, LL11 2PA",422,373,49
W00002008,LL11,"LL11 4LY, LL11 4NA, LL11 4NB, LL11 4ND, LL11 4RS, LL11 4RT",266,231,35
W00001991,LL11,"LL11 1AD, LL11 1NG, LL11 2JA, LL11 2NP, LL11 2NR, LL11 2NS, LL11 2NT, LL11 2NW, LL11 2NX",333,295,38
W00001084,LL11,"LL11 3AF, LL11 3AH, LL11 3AN, LL11 3AP, LL11 3AR, LL11 3AS, LL11 3AT, LL11 3AU, LL11 3AW, LL11 3AY, LL11 3BB, LL11 3BE, LL11 3BH, LL11 3BJ, LL11 3BL, LL11 3EJ",316,246,70
W00001988,LL11,"LL11 2LS, LL11 2LU, LL11 2LY, LL11 2NZ",254,220,34
W00001987,LL11,"LL11 2ND, LL11 2NE, LL11 2NF, LL11 2NG, LL11 2NH, LL11 2NJ, LL11 2NN, LL11 2NQ",224,199,25
W00001083,LL11,"LL11 3AA, LL11 3AB, LL11 3AD, LL11 3AE, LL11 3AG, LL11 3AL, LL11 3AQ, LL11 3AX, LL11 3AZ, LL11 3BA, LL11 3BF, LL11 3BG, LL20 8DR",284,220,64
W00002093,LL11,"LL11 1AN, LL12 7DU, LL12 7DW, LL12 7EF, LL12 7EH, LL12 7EL, LL12 7EN, LL12 7LN, LL12 7LP, LL12 7LT, LL12 7LW",252,226,26
W00002094,LL11,"LL11 1EU, LL12 7BS, LL12 7BT, LL12 7BU, LL12 7BY, LL12 7DA, LL12 7DB, LL12 7DD, LL12 7DF, LL12 7DJ, LL13 8HN",254,223,31
W00002031,LL11,"LL11 4DJ, LL11 4DT, LL11 4DU, LL11 4EB, LL11 4ED, LL11 4EE, LL11 4EZ, LL11 4FJ",235,208,27
W00001992,LL11,"LL11 1EW, LL11 2LT, LL11 2NA, LL11 2PB, LL11 2SE, LL11 2SF",218,188,30
W00002044,LL11,"LL11 1TR, LL13 9AL, LL13 9HJ, LL13 9JA, LL13 9JD, LL13 9JG, LL13 9JP, LL13 9JR, LL13 9JX, LL13 9JZ, LL13 9XY, LL13 9XZ, LL13 9YF, LL13 9YG, LL13 9YX",251,218,33
W00002115,LL11,"LL11 5BJ, LL11 5TY, LL11 5UE, LL11 5UH, LL11 5UR, LL11 5US, LL11 5UT, LL11 5UU, LL11 5UY, LL11 5YA, LL11 5YB, LL11 5YD, LL11 5YG, LL11 5YH, LL11 5YL, LL11 5YN, LL11 5YQ, LL11 5YS, LL11 5YT, LL11 5YX",540,454,86
W00002116,LL11,"LL11 5UD, LL11 5UJ, LL11 5YE, LL11 5YF",136,113,23
W00002117,LL11,"LL11 5UA, LL11 5UB, LL11 5UX, LL11 5YJ",103,88,15
W00002118,LL11,"LL11 3DD, LL11 3DE, LL11 3UY, LL11 3YS, LL11 5AQ, LL11 5TR, LL11 5TS, LL11 5UF, LL11 5UG, LL11 5UN, LL11 5UP, LL11 5UW, LL11 5YY, LL11 5YZ",282,222,60
W00010027,LL11,"LL11 5FF, LL11 5FL, LL11 5FP, LL11 5FS, LL11 5FT, LL11 5FW, LL11 5HQ, LL11 5HX",516,447,69
W00002099,LL11,"LL11 2SA, LL11 2SD, LL12 7AD, LL12 7AE, LL12 7AF, LL12 7AG, LL12 7AH, LL12 7AJ, LL12 7AL, LL12 7AP, LL12 7AQ, LL12 7AR, LL12 7AS, LL12 7AY, LL12 7AZ, LL12 7BP, LL12 7BQ, LL12 7BW, LL12 7DE, LL13 8AH, LL13 8AL, LL13 8AN, LL13 8AR, LL13 8AS, LL13 8AT, LL13 8DH, LL13 8HL",274,248,26
W00002065,LL11,"LL11 2SN, LL11 2SQ, LL12 7RB, LL12 8BY, LL12 8DA, LL12 8DG",258,226,32
W00001840,LL11,"LL11 1YF, LL12 7UP, LL12 7UR, LL12 7US, LL12 7WB, LL12 7WD, LL12 7WG, LL12 7WH, LL12 7YA",306,280,26
W00001990,LL11,"LL11 1TJ, LL11 1TQ, LL11 2AW, LL11 2BA, LL11 2BN, LL11 2BP, LL11 2BS, LL11 2BU, LL11 2BW, LL11 2BZ, LL11 2HR, LL11 2HS, LL11 2HU, LL11 2HY, LL11 2NL, LL11 2PD",248,226,22
W00001866,LL11,"LL11 5SR, LL11 5SS, LL11 5SW, LL11 5TJ, LL11 5TL, LL11 5TP, LL11 5TQ, LL11 5TU, LL11 5TW, LL11 5UQ",403,347,56
W00001867,LL11,"LL11 5BH, LL11 5BN, LL11 5BU, LL11 5DF, LL11 5DH, LL11 5DJ, LL11 5DL, LL11 5DN, LL11 5DP, LL11 5DS, LL11 5DU, LL11 5DW, LL11 5DY, LL11 5DZ, LL11 5EA, LL11 5ED, LL11 5EJ, LL11 5EZ, LL11 5LD, LL11 5LF, LL12 9TH, LL12 9TJ, LL12 9TL, LL12 9TP, LL12 9TW",474,406,68
W00002011,LL11,"LL11 2AS, LL11 2AU, LL11 2EZ, LL11 2HP, LL11 2UE, LL11 2UF, LL11 2UG, LL11 2UQ, LL11 2YH, LL11 4PX, LL11 4RB, LL11 4RE, LL11 4RJ, LL11 4RL, LL11 4RN, LL11 4RP, LL11 4RW, LL11 4RZ, LL11 4YY",529,474,55
W00010028,LL11,"LL11 4PJ, LL11 4PQ, LL11 4PU, LL11 4PY, LL11 4PZ, LL11 4RD, LL11 4YF, LL11 4YH, LL11 4YL, LL11 4YZ, LL11 4ZA",217,199,18
W00010029,LL11,"LL11 3AJ, LL11 5AX, LL11 5BT, LL11 5FN, LL11 5FQ, LL11 5LR, LL11 5LS, LL11 5LT, LL11 5LU, LL11 5LY, LL11 5NA, LL11 5NB, LL11 5ND, LL11 5TZ, LL11 5ZF, LL11 5ZG, LL11 5ZH, LL11 5ZL",314,271,43
W00010030,LL11,"LL11 5FE, LL11 5FJ, LL11 5HJ",203,170,33
W00001868,LL11,"LL11 5AH, LL11 5AL, LL11 5AR, LL11 5AS, LL11 5AU",232,218,14
W00010033,LL11,"LL11 5FB, LL11 5FD, LL11 5FG, LL11 5FH, LL11 5NH, LL11 5NR",288,241,47
W00010036,LL11,"LL11 4AQ, LL11 4AX, LL11 4FB, LL11 4FD, LL11 4FE, LL11 4FF, LL11 4FG, LL11 4FH, LL11 4FW, LL11 4GA",500,404,96
W00010040,LL11,"LL11 3DH, LL11 3DL, LL11 3DN, LL11 3DX, LL11 3EF, LL11 3EZ, LL13 7TA, LL13 7TQ, LL13 7TY, LL13 7UB, LL13 7UD, LL13 7YU",509,447,62
W00010042,LL11,"LL11 4SY, LL11 4TG, LL11 4TR, LL11 4TS, LL11 4TU, LL11 4UH, LL11 4UL, LL11 4YN, LL12 9ST, LL12 9SU, LL12 9SY, LL12 9TA, LL12 9TB, LL12 9TD, LL12 9TE, LL12 9TF",414,364,50
W00010456,LL11,"LL11 1BD, LL11 1BG, LL11 1DA, LL11 1DL, LL11 1HB, LL11 1LL, LL11 1LT, LL11 1LU, LL11 1NP, LL11 1NT, LL11 1NU, LL11 1NY, LL11 1PS, LL11 1PT, LL11 1PU, LL11 1PX, LL11 1PZ, LL11 1QA, LL11 1QB, LL11 1QD, LL11 1QG, LL11 1QJ, LL11 1QN, LL11 1QP, LL11 1QR, LL11 1QS, LL11 1QW, LL11 1QZ, LL11 1RA, LL11 1RB, LL11 1RF, LL11 1RH, LL11 1RJ, LL11 1RL, LL11 1RN, LL11 1RQ, LL11 1RS, LL11 1RW, LL11 1RX, LL11 1RY, LL11 1RZ, LL11 1SB, LL11 1SG, LL11 1SH, LL11 1SN, LL11 1SP, LL11 1SQ, LL11 1SR, LL11 1ST, LL11 1SU, LL11 1SW, LL11 1SX, LL11 1SY, LL11 1SZ, LL11 1TA, LL11 1TB, LL11 1TD, LL13 7HN, LL13 7HW, LL13 7LD, LL13 7LL, LL13 7LP, LL13 7LS, LL13 7LT, LL13 7LU, LL13 7LW, LL13 7NB, LL13 7NE, LL13 7NF, LL13 7NG, LL13 7NH, LL13 7NL, LL13 7NN, LL13 7NR, LL13 7NW, LL13 7SR, LL13 7ST, LL13 8NB",409,360,49
W00001102,LL11,"LL11 3BD, LL21 9AJ, LL21 9DA, LL21 9LE, LL21 9LF, LL21 9LG, LL21 9LH, LL21 9LL, LL21 9LN, LL21 9LP, LL21 9LQ, LL21 9LR, LL21 9LS, LL21 9LT, LL21 9LU, LL21 9LW, LL21 9LY, LL21 9NA, LL21 9NB, LL21 9ND, LL21 9NE, LL21 9NF, LL21 9NG, LL21 9NH, LL21 9NL, LL21 9NN, LL21 9NP, LL21 9NW",329,223,106
W00010470,LL11,"LL11 1PH, LL13 7NQ, LL13 7SZ, LL13 7TX, LL13 7TZ, LL13 7YL, LL13 7YP, LL13 7YT, LL13 7YW, LL13 7YX, LL13 7YZ",245,236,9
W00010476,LL11,"LL11 1PB, LL11 1PD, LL11 1PL, LL13 7NT, LL13 7NX, LL13 7NZ, LL13 7SU, LL13 7SX, LL13 7SY, LL13 7TB, LL13 7TD, LL13 7TE, LL13 7TF, LL13 7TJ, LL13 7TN, LL13 7TU",330,296,34
W00002000,LL11,"LL11 4AP, LL11 4AS, LL11 4AT, LL11 4LA, LL11 4LB, LL11 4LD, LL11 4LE, LL11 4LG, LL11 4LN, LL11 4LU, LL11 4LW, LL11 4SA, LL11 4ZL",239,221,18
W00001864,LL11,"LL11 5SA, LL11 5SB, LL11 5SD, LL11 5SE, LL11 5SF, LL11 5SP, LL11 5SX, LL11 5TA, LL11 5TB, LL11 5TD, LL11 5TE, LL11 5TH, LL11 5TN",263,222,41
W00002201,LL11,"LL11 1TP, LL11 1TT, LL11 1TU, LL11 1TW, LL11 1YH, LL11 1YL, LL13 8TG, LL13 8TU, LL13 8TY, LL13 8UU, LL13 8UY, LL13 8YB",299,279,20
W00002202,LL11,"LL11 1EY, LL13 9PA, LL13 9PB, LL13 9PD",294,278,16
W00002208,LL11,"LL11 1AW, LL11 3DF, LL11 3DG, LL13 9AF, LL13 9LJ, LL13 9LX, LL13 9LZ, LL13 9NZ, LL13 9QL, LL13 9QN, LL13 9QZ",217,198,19
W00001841,LL11,"LL11 2SL, LL12 7YE, LL12 7YL, LL12 7YP, LL12 7YS, LL12 7YW, LL12 7ZY",246,226,20
W00001845,LL11,"LL11 1TN, LL12 7PN, LL12 7SA, LL12 7SR, LL12 7SS, LL13 9SZ, LL13 9TQ",216,190,26
W00001862,LL11,"LL11 5NS, LL11 5SG, LL11 5SH, LL11 5SJ, LL11 5SL, LL11 5SN, LL11 5SQ, LL11 5ST, LL11 5SU, LL11 5SY, LL11 5TF, LL11 5TG",243,213,30
W00002024,LL11,"LL11 4QR, LL11 4QY, LL11 4QZ, LL11 4SB, LL11 4SJ, LL11 4SQ, LL11 4UZ",280,235,45
W00002023,LL11,"LL11 4DR, LL11 4EF, LL11 4EG, LL11 4EH, LL11 4EJ, LL11 4SF",289,255,34
W00001863,LL11,"LL11 5AE, LL11 5AF, LL11 5AT, LL11 5BB",263,244,19
W00002264,LL11,"LL11 1ES, LL13 8SN, LL13 8UH, LL13 9BE, LL13 9BG, LL13 9HB, LL13 9HD, LL13 9HF",267,246,21
W00002255,LL11,"LL11 1YS, LL11 1YT, LL13 0JL, LL13 0JX, LL13 8UW, LL13 8YD, LL13 8YG, LL13 8YL",403,362,41
W00002005,LL11,"LL11 4LS, LL11 4NF, LL11 4NG, LL11 4RR, LL11 4RU, LL12 9YH",229,208,21
W00002251,LL11,"LL11 2HH, LL11 2HL, LL11 2LA, LL11 2LB, LL11 2LD, LL11 2LE, LL11 2LF, LL11 2LG, LL11 2LH, LL11 2LL",239,220,19
W00002249,LL11,"LL11 2EA, LL11 2EB, LL11 2EE, LL11 2EF, LL11 2EL, LL11 2EP, LL11 2ER, LL11 2NB",290,260,30
W00002022,LL11,"LL11 1YN, LL11 4UR, LL11 4US, LL11 4UT, LL11 4UU, LL11 4UY, LL11 4YA, LL11 4YB, LL11 4YD, LL11 4YE, LL11 4YG, LL11 4YJ, LL11 4YP, LL11 4YQ, LL11 4YS, LL11 4YT, LL11 4YW",547,455,92
W00002021,LL11,"LL11 4EL, LL11 4EP, LL11 4ET, LL11 4EW, LL11 4EY, LL11 4HA, LL11 4HB, LL11 4HE, LL11 4HS, LL11 4TT, LL11 4UD",286,275,11
W00002248,LL11,"LL11 2BF, LL11 2BJ, LL11 2BQ, LL11 2BX, LL11 2DA, LL11 2DP",228,207,21
W00002247,LL11,"LL11 2EH, LL11 2EN, LL11 2EW, LL11 2PH, LL11 2PL, LL11 2PP, LL11 2PR, LL11 2RB, LL11 2SG",256,219,37
W00002246,LL11,"LL11 2EG, LL11 2ET, LL11 2EY, LL11 2HB, LL11 2RP, LL11 2RR, LL11 2RW, LL11 2ZD, LL11 2ZE, LL11 2ZP",233,217,16
W00002245,LL11,"LL11 2EU, LL11 2HA, LL11 2HE, LL11 2HG, LL11 2HX, LL11 2HZ, LL11 2RL",214,185,29
W00002244,LL11,"LL11 2HD, LL11 2HF, LL11 2HJ, LL11 2HN, LL11 2HQ, LL11 2HW, LL11 2TR, LL11 2TS, LL11 2TT",295,273,22
W00002250,LL11,"LL11 2BT, LL11 2DD, LL11 2DE, LL11 2DF, LL11 2DG, LL11 2DH, LL11 2DL, LL11 2DN, LL11 2ED, LL11 2ES, LL11 2JD, LL11 2JE",337,295,42
W00002028,LL11,"LL11 4QU, LL11 4QW, LL11 4QX, LL11 4UQ, LL11 4XG, LL11 4XQ",268,222,46
W00002098,LL12,"LL12 7AN, LL12 7AT, LL12 7AU, LL12 7AW, LL12 7BA, LL12 7BJ, LL12 7LJ, LL12 7LY, LL12 7NJ",310,260,50
W00001839,LL12,"LL12 7HL, LL12 7HS, LL12 7HW, LL12 7LA, LL12 7NR, LL12 7NS, LL12 7UT",280,256,24
W00002207,LL12,"LL12 7EP, LL12 7ER, LL13 8NG, LL13 9XA, LL13 9XB, LL13 9XD",232,211,21
W00002209,LL12,"LL12 7TH, LL12 7TL, LL13 9NJ, LL13 9NQ, LL13 9RQ, LL13 9RZ",256,233,23
W00002210,LL12,"LL12 7TG, LL12 7TN, LL12 7TR, LL12 7TT, LL13 9EG, LL13 9EL, LL13 9EP, LL13 9ER, LL13 9EW",248,219,29
W00002212,LL12,"LL12 7TP, LL12 7TS, LL12 7TW",258,230,28
W00002215,LL12,"LL12 0DJ, LL12 0HB, LL12 0HQ, LL12 0HX, LL12 0HZ",296,276,20
W00002216,LL12,"LL12 0AX, LL12 0BF, LL12 0DA, LL12 0DD, LL12 0DF, LL12 0DN, LL12 0DW, LL12 0EL, LL12 0GA",306,279,27
W00002217,LL12,"LL12 0AR, LL12 0HU, LL12 0LA, LL12 0LG, LL12 0LH",310,277,33
W00002219,LL12,"LL12 0DP, LL12 0DX, LL12 0DZ, LL12 0EA, LL12 0EB, LL12 0EJ, LL12 0EQ, LL12 0EX, LL12 0EZ",228,207,21
W00002220,LL12,"LL12 0AZ, LL12 0BA, LL12 0BB, LL12 0BJ, LL12 0DL, LL12 0EN, LL12 0EW, LL12 0FA, LL12 0FB, LL12 0FD",317,272,45
W00002221,LL12,"LL12 0DB, LL12 0DE, LL12 0GD, LL12 0GE, LL12 0HE, LL12 0HF, LL12 0HG, LL12 0HN, LL12 0HY, LL12 0JA",250,222,28
W00002222,LL12,"LL12 0AD, LL12 0AF, LL12 0AG, LL12 0AH, LL12 0AJ, LL12 0AL, LL12 0AN, LL12 0AP, LL12 0AS, LL12 0AT, LL12 0AU, LL12 0AW, LL12 0AY, LL12 0LD, LL12 0LE",300,271,29
W00002223,LL12,"LL12 0DH, LL12 0EF, LL12 0EG, LL12 0EH",293,268,25
W00002224,LL12,"LL12 0AA, LL12 0AQ, LL12 0BG, LL12 0GB, LL12 0HH, LL12 0HL, LL12 0HS, LL12 0HT, LL12 0LB, LL12 0LF",297,274,23
W00002225,LL12,"LL12 0BD, LL12 0BE, LL12 0BN, LL12 0BP, LL12 0BQ, LL12 0BS, LL12 0BT, LL12 0BU, LL12 0BW, LL12 0BY, LL12 0DQ, LL12 0DT, LL12 0DU, LL12 0DY, LL12 0EP, LL12 0ER, LL12 0ES, LL12 0ET, LL12 0EU, LL12 0HA, LL13 9TE, LL13 9TG",354,339,15
W00001975,LL12,"LL12 8EB, LL12 8EU, LL12 8EY, LL12 8HA, LL12 8HF, LL12 8HN, LL12 8HT, LL12 8HY, LL12 8NL, LL12 8PY, LL12 8RE",257,238,19
W00001976,LL12,"LL12 8TN, LL12 8TP, LL12 8TR, LL12 8TW, LL12 8TY, LL12 8TZ, LL12 8UA, LL12 8UB, LL12 8UD, LL12 8UE, LL12 8UF, LL12 8UG, LL12 8UH, LL12 8UL",360,307,53
W00001977,LL12,"LL12 8ET, LL12 8HG, LL12 8HH, LL12 8HL, LL12 8HR, LL12 8HS, LL12 8RG, LL12 8RH, LL12 8RJ, LL12 8RQ, LL12 8YH",256,226,30
W00001978,LL12,"LL12 8EG, LL12 8HB, LL12 8HD, LL12 8HP, LL12 8HU, LL12 8HW, LL12 8PD, LL12 8SG",260,231,29
W00001979,LL12,"LL12 8EH, LL12 8EN, LL12 8EP, LL12 8ER, LL12 8ES, LL12 8HE, LL12 8NU",241,213,28
W00001981,LL12,"LL12 8NE, LL12 8NF, LL12 8NH, LL12 8NP, LL12 8NR, LL12 8NS, LL12 8NT, LL12 8NW, LL12 8NY",260,227,33
W00001982,LL12,"LL12 8NQ, LL12 8NZ, LL12 8YU",277,259,18
W00001983,LL12,"LL12 8EL, LL12 8EW, LL12 8NB, LL12 8NG, LL12 8NN, LL12 8PF",221,217,4
W00001984,LL12,"LL12 8UN, LL12 8UP, LL12 8UR, LL12 8US, LL12 8UT, LL12 8UU, LL12 8UW, LL12 8UY, LL12 8WR, LL12 8YT, LL13 9TH, LL13 9TL, LL13 9TN, LL13 9TP",281,260,21
W00002112,LL12,"LL12 8LB, LL12 8LS, LL12 8LU, LL12 8PB, LL12 8PE, LL12 8PH, LL12 8XU",262,238,24
W00002111,LL12,"LL12 8SJ, LL12 8SL, LL12 8SN, LL12 8SP, LL12 8SS, LL12 8TA, LL12 8TB, LL12 8TD, LL12 8TF, LL12 8TG, LL12 8TJ, LL12 8TQ, LL12 8TX",330,299,31
W00002110,LL12,"LL12 8LD, LL12 8LW, LL12 8LY, LL12 8LZ, LL12 8XG, LL12 8XH, LL12 8XQ, LL12 8XT",279,247,32
W00002109,LL12,"LL12 8SR, LL12 8ST, LL12 8SU, LL12 8SW, LL12 8SX, LL12 8SY, LL12 8SZ, LL12 8TE, LL12 8YE",320,290,30
W00002114,LL12,"LL12 8PA, LL12 8XL, LL12 8XN, LL12 8XR, LL12 8XS, LL12 8XW, LL12 8XX, LL12 8XY, LL12 8XZ, LL12 8YJ, LL12 8YL, LL12 8YN, LL12 8YP, LL12 8YQ, LL12 8YR, LL12 8YX, LL12 8YY, LL12 8YZ",301,275,26
W00002113,LL12,"LL12 8LA, LL12 8LF, LL12 8LN, LL12 8LP, LL12 8LR, LL12 8LT, LL12 8ND, LL12 8PN, LL12 8SE, LL12 8SF, LL12 8SH",271,239,32
W00001851,LL12,"LL12 7PR, LL12 7PS, LL12 7PT, LL12 7RA",193,182,11
W00001850,LL12,"LL12 7PU, LL12 7PY, LL13 9TJ, LL13 9TX, LL13 9TZ, LL13 9UJ, LL13 9UN, LL13 9UQ, LL13 9UX",307,281,26
W00001445,LL12,"LL12 9AE, LL12 9AF, LL12 9AG, LL12 9AH, LL12 9LN, LL12 9LS, LL12 9LU, LL12 9LY",242,214,28
W00001446,LL12,"LL12 9AA, LL12 9EU, LL12 9EY, LL12 9HR, LL12 9LD, LL12 9LE, LL12 9LF, LL12 9LG, LL12 9LH, LL12 9LL, LL12 9LP, LL12 9LR, LL12 9LT, LL12 9LW",274,259,15
W00001447,LL12,"LL12 9AB, LL12 9AD, LL12 9AL, LL12 9AQ, LL12 9BX, LL12 9DP, LL12 9DR, LL12 9DS, LL12 9DW, LL12 9ES, LL12 9ET, LL12 9ZE, LL12 9ZG",210,190,20
W00001448,LL12,"LL12 9HP, LL12 9HS, LL12 9HU, LL12 9HW, LL12 9HY, LL12 9LA, LL12 9LB",252,218,34
W00001449,LL12,"LL12 9BQ, LL12 9BT, LL12 9BU, LL12 9BY, LL12 9DA, LL12 9DD, LL12 9DG",221,187,34
W00001450,LL12,"LL12 9BA, LL12 9BB, LL12 9BD, LL12 9BE, LL12 9BG, LL12 9BH, LL12 9BL, LL12 9BN, LL12 9BP, LL12 9BS, LL12 9BW, LL12 9DB, LL12 9DT, LL12 9DU, LL12 9DY, LL12 9HL, LL12 9HN",325,280,45
W00001649,LL12,"LL12 9AY, LL12 9DN, LL12 9EA, LL12 9EB, LL12 9ED, LL12 9EE, LL12 9EF, LL12 9EG, LL12 9EH, LL12 9EL, LL12 9EN, LL12 9EP, LL12 9ER, LL12 9EW, LL12 9RU, LL12 9RY, LL12 9SA, LL12 9SB",301,256,45
W00001650,LL12,"LL12 9AN, LL12 9AP, LL12 9AR, LL12 9AS, LL12 9AT, LL12 9AU, LL12 9AW, LL12 9NL, LL12 9NN, LL12 9NP, LL12 9NW, LL12 9PR",263,233,30
W00001651,LL12,"LL12 9AJ, LL12 9PD, LL12 9PE, LL12 9PF, LL12 9PG",304,271,33
W00001655,LL12,"LL12 9NY, LL12 9PJ, LL12 9PS, LL12 9PT, LL12 9PX, LL12 9PY, LL12 9PZ, LL12 9QA, LL12 9RA, LL12 9RB, LL12 9RJ",418,380,38
W00001656,LL12,"LL12 9NE, LL12 9NF, LL12 9NG, LL12 9NH, LL12 9PH, LL12 9PL, LL12 9PN, LL12 9PW, LL12 9SE",275,234,41
W00001657,LL12,"LL12 9NJ, LL12 9NR, LL12 9NS, LL12 9NT, LL12 9NU, LL12 9PA, LL12 9PB, LL12 9PQ",288,258,30
W00001666,LL12,"LL12 9DF, LL12 9DH, LL12 9YB, LL12 9YD",224,201,23
W00002108,LL12,"LL12 0BH, LL12 0BL, LL12 8LE, LL12 8LG, LL12 8LH, LL12 8LL, LL12 8XJ, LL12 8YA, LL12 8YB, LL12 8YD, LL12 8YF, LL12 8YG",348,323,25
W00001668,LL12,"LL12 9DE, LL12 9SF, LL12 9TQ, LL12 9TR, LL12 9TS, LL12 9TU, LL12 9UA, LL12 9UB, LL12 9UD, LL12 9UE, LL12 9UJ, LL12 9UL, LL12 9UP, LL12 9UT, LL12 9UU, LL12 9UW, LL12 9UY, LL12 9YA, LL12 9YE",295,259,36
W00001833,LL12,"LL12 7HT, LL12 7LE, LL12 7YN, LL12 7YR",212,193,19
W00001834,LL12,"LL12 7BH, LL12 7EU, LL12 7EY, LL12 7HA, LL12 7HB, LL12 7HD, LL12 7HE, LL12 7LF",225,200,25
W00001835,LL12,"LL12 7BB, LL12 7BG, LL12 7NG, LL12 7NN, LL12 7NP, LL12 7TD, LL12 7UU, LL12 7UY, LL12 7YF, LL12 7YG",276,261,15
W00001836,LL12,"LL12 7BE, LL12 7BL, LL12 7BN, LL12 7HF, LL12 7HG, LL12 7HH, LL12 7HN, LL12 7HP, LL12 7HR, LL12 7HY",318,282,36
W00001837,LL12,"LL12 7PG, LL12 7RE, LL12 7RF, LL12 7RG, LL12 7RH, LL12 7YJ, LL12 8BS, LL12 8BT, LL12 8DB, LL12 8DD, LL12 8DE",372,319,53
W00001838,LL12,"LL12 7HU, LL12 7LG, LL12 7YB, LL12 7YD, LL12 7YH, LL12 8BU, LL12 8EF",234,211,23
W00001842,LL12,"LL12 7LB, LL12 7LD, LL12 7NT, LL12 7NU, LL12 7YT",257,227,30
W00001843,LL12,"LL12 7RP, LL12 7TF, LL12 7TJ, LL12 7TQ, LL12 7TX, LL12 7UA, LL12 7UB",254,239,15
W00001844,LL12,"LL12 7PH, LL12 7PP, LL12 7PW, LL12 7RY, LL12 7SB, LL12 7SD, LL12 7SP",260,221,39
W00001846,LL12,"LL12 7SG, LL12 7ST, LL12 7UE, LL12 7UF, LL12 7UH",263,230,33
W00001847,LL12,"LL12 7PE, LL12 7PF, LL12 7PL, LL12 7SH, LL12 7SL, LL12 7SN, LL12 7SW",245,224,21
W00001848,LL12,"LL12 7PD, LL12 7RT, LL12 7RU, LL12 7SE, LL12 7SF, LL12 7UD, LL12 7UG",241,209,32
W00001849,LL12,"LL12 7PB, LL12 7RN, LL12 7RR, LL12 7RS, LL12 7RW, LL12 7TE, LL12 7TU, LL12 7TY",253,227,26
W00001832,LL12,"LL12 7BD, LL12 7NF, LL12 7NH, LL12 7NL, LL12 7NW",275,251,24
W00002014,LL12,"LL12 9SG, LL12 9SL, LL12 9SN, LL12 9SP, LL12 9SR, LL12 9SS, LL12 9SW, LL12 9UN, LL12 9UR, LL12 9US, LL12 9YL, LL12 9YN, LL12 9YP, LL12 9YR, LL12 9YS, LL12 9YT, LL12 9YW",404,345,59
W00002218,LL12,"LL12 0DG, LL12 0DR, LL12 0DS, LL12 0ED, LL12 0EE, LL12 0EY, LL12 0HD, LL12 0HJ, LL12 0HP, LL12 0HR, LL12 0HW",253,231,22
W00002096,LL12,"LL12 7EW, LL12 7LR, LL12 7LS, LL12 7LU, LL12 7NA, LL12 7NB, LL12 7NE",257,216,41
W00002062,LL12,"LL12 8AT, LL12 8AY, LL12 8BA, LL12 8BB, LL12 8BD, LL12 8BE, LL12 8BH, LL12 8BW",264,237,27
W00002063,LL12,"LL12 7RD, LL12 7RL, LL12 8AB, LL12 8AD, LL12 8AE, LL12 8AF, LL12 8AG, LL12 8AH, LL12 8AN",240,219,21
W00002064,LL12,"LL12 7RJ, LL12 8AJ, LL12 8DF, LL12 8DH, LL12 8DQ, LL12 8DS",270,240,30
W00002066,LL12,"LL12 8JD, LL12 8JE, LL12 8JG, LL12 8JQ, LL12 8JT, LL12 8JX, LL12 8JY, LL12 8JZ, LL12 8LQ",310,284,26
W00002076,LL12,"LL12 0LZ, LL12 0NE, LL12 0NN, LL12 0NW, LL12 0QD, LL12 0QE, LL12 0QF, LL12 0QH, LL12 0QP, LL12 0QS, LL12 0QT, LL12 0QU, LL12 0QW, LL12 0QX, LL12 0RY, LL12 0UD, LL12 0UW, LL12 0UX, LL12 0WR, LL12 0XU",424,362,62
W00002077,LL12,"LL12 0LN, LL12 0SH, LL12 0SN, LL12 0SP, LL12 0SQ, LL12 0SW, LL12 0SZ",232,209,23
W00002078,LL12,"LL12 0BX, LL12 0PH, LL12 0PT, LL12 0PU, LL12 0PY, LL12 0RB, LL12 0RD, LL12 0RE, LL12 0RG, LL12 0RH, LL12 0TF, LL12 0TQ, LL12 0UR",318,269,49
W00002080,LL12,"LL12 0PL, LL12 0SE, LL12 0SF, LL12 0SG, LL12 0TT",262,234,28
W00002081,LL12,"LL12 0PS, LL12 0RL, LL12 0RN, LL12 0RW",276,255,21
W00002082,LL12,"LL12 0LS, LL12 0LT, LL12 0LY, LL12 0NA, LL12 8RL, LL12 8RN",289,273,16
W00002061,LL12,"LL12 8AA, LL12 8AU, LL12 8BG, LL12 8BL, LL12 8BN, LL12 8DL, LL12 8DN, LL12 8DT",283,257,26
W00002084,LL12,"LL12 0LP, LL12 0LR, LL12 0LU, LL12 0LW, LL12 0NF",295,268,27
W00002085,LL12,"LL12 0LL, LL12 0NB, LL12 0ND, LL12 0NG, LL12 0PP, LL12 0PW",252,215,37
W00002086,LL12,"LL12 0AB, LL12 0AE, LL12 0NU, LL12 0NY, LL12 0PA, LL12 0ZE, LL12 0ZH, LL12 0ZJ, LL12 0ZL, LL12 0ZR",123,107,16
W00002067,LL12,"LL12 8AL, LL12 8AQ, LL12 8AR, LL12 8AS, LL12 8AW, LL12 8JB, LL12 8JF, LL12 8JN",274,253,21
W00002083,LL12,"LL12 0RA, LL12 0RF, LL12 0RR, LL12 0RS, LL12 0RT",263,232,31
W00002087,LL12,"LL12 0LX, LL12 0NJ, LL12 0NQ, LL12 0NT, LL12 0NX, LL12 0PB, LL12 0PD, LL12 0PF, LL12 0PG, LL12 0PJ, LL12 0PQ, LL12 0PX, LL12 0PZ, LL12 0QB, LL12 0TG, LL12 0TH, LL12 0TL, LL12 0TR, LL12 0TS, LL12 0TU, LL12 0TX, LL12 0TY, LL12 0UG, LL12 0XT, LL12 0XZ, LL12 0YE, LL12 9UF, LL12 9UG, LL12 9UH, LL12 9YF, LL12 9YG",484,438,46
W00002088,LL12,"LL12 0NL, LL12 0NP, LL12 0NZ, LL12 0PE, LL12 0QA",154,143,11
W00002089,LL12,"LL12 0SJ, LL12 0TD, LL12 0TE, LL12 0TN, LL12 0TW",264,238,26
W00002090,LL12,"LL12 0NR, LL12 0NS, LL12 0SL, LL12 0UA, LL12 0UB, LL12 0UE, LL12 0UF, LL12 0UL, LL12 0UN",246,231,15
W00002091,LL12,"LL12 0PR, LL12 0SA, LL12 0SB, LL12 0SS, LL12 0ST, LL12 0SU, LL12 0SX, LL12 0TA, LL12 0TB, LL12 0TP",277,242,35
W00002095,LL12,"LL12 7DL, LL12 7DN, LL12 7DP, LL12 7DR, LL12 7DS, LL12 7DT, LL12 7EA, LL12 7EE, LL12 7EG, LL13 8NF",309,277,32
W00002092,LL12,"LL12 0SD, LL12 0SR, LL12 0SY, LL12 0TJ",207,186,21
W00002068,LL12,"LL12 8JA, LL12 8JH, LL12 8JJ, LL12 8JL, LL12 8JP, LL12 8JR, LL12 8JS, LL12 8JU, LL12 8JW",281,251,30
W00002097,LL12,"LL12 7DG, LL12 7DH, LL12 7DY, LL12 7EB, LL12 7ED",233,209,24
W00002037,LL13,"LL13 8BH, LL13 8QJ, LL13 8QL, LL13 8QP, LL13 8QU, LL13 8QW, LL13 8QY, LL13 8RD",204,184,20
W00002198,LL13,"LL13 8TS, LL13 8YA, LL13 9BF, LL13 9HX, LL13 9PE, LL13 9PF, LL13 9PL",354,319,35
W00002139,LL13,"LL13 7HT, LL13 7HY, LL13 7JG, LL13 7LB, LL13 7LF, LL13 7LG, LL13 7LN, LL13 7LQ, LL13 7LR, LL13 7LY, LL13 7NA, LL13 7ND, LL13 7NU, LL13 7PB, LL13 7RP, LL13 7RR, LL13 7RU",417,382,35
W00002227,LL13,"LL13 0FE, LL13 0YH, LL13 0YL, LL13 0YN, LL14 6HD, LL14 6HH, LL14 6HL, LL14 6HN, LL14 6LH",125,110,15
W00001892,LL13,"LL13 9AW, LL13 9BL, LL13 9HG, LL13 9HH, LL13 9HN, LL13 9HP, LL13 9LS, LL13 9LT, LL13 9LY, LL13 9NA",329,304,25
W00001893,LL13,"LL13 9BX, LL13 9DH, LL13 9DT, LL13 9DU, LL13 9DZ, LL13 9EB, LL13 9ED, LL13 9EE, LL13 9NB, LL13 9ND, LL13 9NE, LL13 9NF, LL13 9NH",360,317,43
W00001894,LL13,"LL13 9DA, LL13 9DB, LL13 9DD, LL13 9DE, LL13 9DG, LL13 9DL, LL13 9DN, LL13 9DP, LL13 9DS, LL13 9DW",250,233,17
W00001898,LL13,"LL13 9AG, LL13 9AY, LL13 9BU, LL13 9BY, LL13 9DF, LL13 9DR, LL13 9DX, LL13 9EQ, LL13 9NG",310,284,26
W00001896,LL13,"LL13 9HR, LL13 9HS, LL13 9HU, LL13 9HY, LL13 9LA, LL13 9LB, LL13 9NP, LL13 9NW",289,261,28
W00001897,LL13,"LL13 0PQ, LL13 8TH, LL13 8TL, LL13 9HT, LL13 9LN, LL13 9LP, LL13 9LQ, LL13 9LR, LL13 9LU, LL13 9LW",271,244,27
W00002137,LL13,"LL13 7GT, LL13 7RB, LL13 7RD, LL13 7RF, LL13 7RH, LL13 7RL, LL13 7RN, LL13 7RW, LL13 7SW",229,203,26
W00002242,LL13,"LL13 8BJ, LL13 8DE, LL13 8DF, LL13 8ET, LL13 8HB, LL13 8HD, LL13 8HF, LL13 8HG, LL13 8HH, LL13 8SR, LL13 8ST",218,205,13
W00002197,LL13,"LL13 9LD, LL13 9LE, LL13 9LF, LL13 9LG, LL13 9LH, LL13 9LL, LL13 9NR, LL13 9NS, LL13 9NT",291,259,32
W00002138,LL13,"LL13 7AH, LL13 7DS, LL13 7DT, LL13 7PL, LL13 7PN, LL13 7PP, LL13 7PR, LL13 7PS, LL13 7PT, LL13 7PW, LL13 7SN, LL13 7YE",362,286,76
W00002136,LL13,"LL13 7PU, LL13 7PY, LL13 7RS, LL13 7RY, LL13 7SB, LL13 7SD, LL13 7SG",336,302,34
W00001895,LL13,"LL13 9AB, LL13 9AT, LL13 9BH, LL13 9BN, LL13 9BW, LL13 9HL, LL13 9HW, LL13 9NL, LL13 9NN",401,364,37
W00001881,LL13,"LL13 7TR, LL13 7TS, LL13 7TT, LL13 7TW",211,199,12
W00002241,LL13,"LL13 7AN, LL13 8DX, LL13 8EQ, LL13 8NH, LL13 8NL, LL13 8NS, LL13 8NT, LL13 8NU, LL13 8NY, LL13 8PA, LL13 8PB, LL13 8UQ",395,360,35
W00001872,LL13,"LL13 7NP, LL13 7TG, LL13 7TH, LL13 7TL, LL13 7TP",252,232,20
W00002151,LL13,"LL13 0DS, LL13 0HG, LL13 0HH, LL13 0HL, LL13 0HP, LL13 0HR, LL13 0HT, LL13 0HU, LL13 0HW, LL13 0HY, LL13 0LB, LL13 0LE, LL13 0LF, LL13 0LG",354,331,23
W00002150,LL13,"LL13 0DX, LL13 0EF, LL13 0EG, LL13 0EH, LL13 0EL, LL13 0EX, LL13 0EZ, LL13 0FF, LL13 0LJ",271,247,24
W00002152,LL13,"LL13 0DU, LL13 0EU, LL13 0EY, LL13 0HA, LL13 0HB, LL13 0HJ",176,160,16
W00002148,LL13,"LL13 0DQ, LL13 0EP, LL13 0EQ, LL13 0ER, LL13 0ES, LL13 0ET, LL13 0EW, LL13 0FA, LL13 0LD",212,191,21
W00002147,LL13,"LL13 0GB, LL13 0HS, LL13 0JN, LL13 0JP, LL13 0JS, LL13 0JT, LL13 0LH, LL13 0LN, LL13 0LQ, LL13 0LR, LL13 0LU, LL13 0LY, LL13 0NA, LL13 0NB, LL13 0ND, LL13 0NE, LL13 0NF, LL13 0NG, LL13 0NH, LL13 0QE, LL13 0QQ",560,498,62
W00002146,LL13,"LL13 0LL, LL13 0LW, LL13 0NN",156,147,9
W00002145,LL13,"LL13 0LT, SY13 2LA, SY13 2LB, SY13 2LD, SY13 2LE, SY13 2LH, SY13 2LJ, SY13 2LL, SY13 2LN, SY13 2LP, SY13 2LQ, SY13 2LR, SY13 2LS, SY13 2LU, SY13 2LW, SY13 2LX, SY13 2LY, SY13 3DR",376,359,17
W00002144,LL13,"LL13 0FJ, LL13 0JR, LL13 0JU, LL13 0JW, LL13 0LP, LL13 0LS, LL13 0NL, LL13 0NW, LL13 0SJ",324,295,29
W00002142,LL13,"LL13 0BL, LL13 0BN, LL13 0BP, LL13 0BW, SY13 3BZ, SY13 3DA, SY13 3DD, SY13 3DH, SY13 3DJ, SY13 3DP, SY13 3DS, SY13 3DT, SY13 3DU, SY13 3DW, SY13 3DX, SY13 3DY, SY13 3DZ, SY13 3EA, SY13 3EB, SY13 3ED, SY13 3EE, SY13 3EF",329,300,29
W00002141,LL13,"LL13 7AA, LL13 7AB, LL13 7AE, LL13 7DD, LL13 7DE, LL13 7DF, LL13 7DN, LL13 7DW, LL13 7HP, LL13 7HR, LL13 7HS, LL13 7HU, LL13 7LH, LL13 7NY, LL13 7PA, LL13 7PD, LL13 8AG, LL13 8DR, LL13 8DW, LL13 8HR, LL13 8HU, LL13 8HY, LL13 8LA, LL13 8LB, LL13 8LD, LL13 8LE, LL13 8LF, LL13 8LL, LL13 8LN, LL13 8LR, LL13 8LS, LL13 8LT, LL13 8LU, LL13 8LY, LL13 8NA, LL13 8ND",315,296,19
W00002140,LL13,"LL13 7SF, LL13 7SH, LL13 7SL, LL13 7UN, LL13 7UR",291,257,34
W00002236,LL13,"LL13 8RG, LL13 8SP, LL13 8SS, LL13 8SU, LL13 8SY, LL13 8TA, LL13 8TE",333,312,21
W00002237,LL13,"LL13 8EG, LL13 8EJ, LL13 8EL, LL13 8ES",288,258,30
W00002238,LL13,"LL13 8DQ, LL13 8DU, LL13 8DY, LL13 8EB, LL13 8ED, LL13 8EE, LL13 8EF, LL13 8EH, LL13 8EP, LL13 8ER",363,343,20
W00002239,LL13,"LL13 8SJ, LL13 8SQ, LL13 8SX, LL13 8UL, LL13 8UR, LL13 8US, LL13 8ZB, LL13 8ZF",172,158,14
W00002240,LL13,"LL13 7AF, LL13 8AX, LL13 8BA, LL13 8BB, LL13 8BE, LL13 8BS, LL13 8BT, LL13 8BX, LL13 8BY, LL13 8DA, LL13 8DB, LL13 8DD, LL13 8DG, LL13 8DJ, LL13 8DL, LL13 8DN, LL13 8DP, LL13 8DS, LL13 8DT, LL13 8DZ, LL13 8HW, LL13 8LP, LL13 8LW",421,369,52
W00002199,LL13,"LL13 8TN, LL13 8TT, LL13 9NX, LL13 9PG",263,243,20
W00001852,LL13,"LL13 0AA, LL13 0AB, LL13 0AD, LL13 0AG, LL13 0AQ, LL13 0AX, LL13 0BT",278,247,31
W00001853,LL13,"LL13 0AH, LL13 0BD, LL13 0BE, LL13 0BH, LL13 0BZ, LL13 0DA, LL13 0DB, LL13 0DJ, LL13 0DP, LL13 0DZ, LL13 0FL, LL13 0HN, LL13 0JE",314,289,25
W00001854,LL13,"LL13 0AF, LL13 0AT, LL13 0AU, LL13 0AY, LL13 0BA, LL13 0BS, LL13 0BU, LL13 0BY, LL13 0HD",245,226,19
W00001855,LL13,"LL13 0BB, LL13 0BQ, LL13 0JA, LL13 0JB, LL13 0JD, LL13 0JF, LL13 0JG, LL13 0JQ",244,222,22
W00001860,LL13,"LL13 0AR, LL13 0AS, SY13 3BU, SY13 3BX, SY13 3BY, SY14 7HY, SY14 7JH, SY14 7LD, SY14 7LF, SY14 7LG, SY14 7LH, SY14 7LJ, SY14 7LL, SY14 7LP, SY14 7LQ, SY14 7LR, SY14 7LS, SY14 7LT, SY14 7LU, SY14 7LX, SY14 7LY, SY14 7LZ, SY14 7NA, SY14 7NB, SY14 7ND",343,318,25
W00001861,LL13,"LL13 0AE, LL13 0AL, LL13 0AN, LL13 0AP, LL13 0AW, LL13 0AZ, LL13 0BF, LL13 0BG, LL13 0BJ, LL13 0BX, LL13 0FD, LL13 0GA, SY14 7AN, SY14 7AZ, SY14 7LN, SY14 7LW",478,444,34
W00001874,LL13,"LL13 7UL, LL14 4HD, LL14 4HQ",252,221,31
W00002200,LL13,"LL13 9BQ, LL13 9NU, LL13 9NY",217,207,10
W00002036,LL13,"LL13 7HG, LL13 7HJ, LL13 7HQ, LL13 7HX",155,139,16
W00002204,LL13,"LL13 8UA, LL13 8UD",280,249,31
W00010494,LL13,"LL13 0PE, LL13 9FZ, LL13 9JT, LL13 9PP, LL13 9PU, LL13 9PY, LL13 9QS, LL13 9UG, LL13 9UH, LL13 9XN, LL13 9XS",140,125,15
W00002260,LL13,"LL13 0NJ, LL13 0NX, LL13 0YU, LL13 8NX, LL13 8PN",311,260,51
W00002261,LL13,"LL13 9AS, LL13 9BA, LL13 9BB, LL13 9BD, LL13 9BP, LL13 9BS, LL13 9HE",317,281,36
W00002262,LL13,"LL13 8SF, LL13 9BT, LL13 9EU, LL13 9EY, LL13 9HA",285,263,22
W00002263,LL13,"LL13 8SG, LL13 8SH, LL13 8SL, LL13 8SW",336,313,23
W00002265,LL13,"LL13 8RH, LL13 8RL, LL13 8RT, LL13 9AP, LL13 9AR, LL13 9AU",266,249,17
W00002266,LL13,"LL13 8RU, LL13 8RY, LL13 8SA, LL13 8SB, LL13 8SD, LL13 8SE",249,231,18
W00002267,LL13,"LL13 8RN, LL13 8RP, LL13 8RR, LL13 8RS, LL13 8RW, LL13 8TB, LL13 8TD",249,229,20
W00002049,LL13,"LL13 9JU, LL13 9PH, LL13 9PN, LL13 9PQ, LL13 9PW, LL13 9QF, LL13 9RD, LL13 9RE, LL13 9RF, LL13 9RG, LL13 9RH, LL13 9RJ, LL13 9RL, LL13 9RN, LL13 9RP, LL13 9RR, LL13 9RS, LL13 9RT, LL13 9RU, LL13 9RW, LL13 9RX, LL13 9RY, LL13 9UA, LL13 9UE, LL13 9UL, LL13 9UP, LL13 9US, LL13 9UT, LL13 9UU, LL13 9UW, LL13 9UY, LL13 9WB, LL13 9WD, LL13 9WE, LL13 9WF, LL13 9WG, LL13 9WR, LL13 9WS, LL13 9WY, LL13 9XG, LL13 9XP, LL13 9XQ, LL13 9XR, LL13 9XT, LL13 9XU, LL13 9XW, LL13 9XX",390,355,35
W00002046,LL13,"LL13 9AH, LL13 9AJ, LL13 9AQ, LL13 9BJ, LL13 9DJ, LL13 9EJ, LL13 9FW, LL13 9TS, LL13 9WJ, LL13 9YJ, LL13 9YP, LL13 9YR, LL13 9YT, LL13 9YU, LL13 9YZ",316,295,21
W00002045,LL13,"LL13 9JE, LL13 9JF, LL13 9JH, LL13 9JJ, LL13 9JL, LL13 9JN, LL13 9JQ, LL13 9JS, LL13 9JW, LL13 9XH, LL13 9XJ, LL13 9XL",225,200,25
W00002043,LL13,"LL13 9AX, LL13 9AZ, LL13 9YH, LL13 9YL, LL13 9YN, LL13 9YQ, LL13 9YS, LL13 9YW, LL13 9YY",272,256,16
W00002041,LL13,"LL13 0NU, LL13 0NY, LL13 0PB, LL13 0PD, LL13 0PJ, LL13 0PX, LL13 0PZ, LL13 0QF, LL13 0QG, LL13 9AE, LL13 9FS, LL13 9GA, LL13 9GB, LL13 9TT, LL13 9TU, LL13 9TY, LL13 9UD, LL13 9UZ, LL13 9XE",354,328,26
W00002040,LL13,"LL13 7AU, LL13 7AW, LL13 7BA, LL13 7BB",333,287,46
W00002039,LL13,"LL13 7UY, LL13 7YA, LL13 7YB, LL13 7YD, LL13 7YG, LL13 7YS, LL13 8AF, LL13 8AP, LL13 8PD, LL13 8RE, LL13 8RF, LL13 8RJ, LL13 8RQ, LL13 8RX",320,280,40
W00002107,LL13,"LL13 0RZ, LL13 0SL, LL13 0SY, LL13 0TA, LL13 0TB, LL13 0TD, LL13 0TG, LL13 0TH, LL13 0TL, LL13 0TP, LL13 0TR, LL13 0TT, LL13 0TW, LL13 0TX, LL13 0UB, LL13 0UE, LL13 0UF, LL13 0UG, LL13 0UH, LL13 0UL, LL13 0ZQ",251,232,19
W00002106,LL13,"LL13 0QA, LL13 0QB, LL13 0SX, LL13 0TJ, LL13 0TN, LL13 0TQ, LL13 0TS, LL13 0TU, LL13 0TY, LL13 0UA, LL13 0UD, LL13 0UJ, LL13 0UN, LL13 0UP, LL13 0UQ, LL13 0UR, LL13 0US, LL13 0UT, LL13 0UW, LL13 0UX, LL13 0UZ",291,259,32
W00002105,LL13,"LL13 0AJ, LL13 0PS, LL13 0PY, LL13 0RA, LL13 0RB, LL13 0RD, LL13 0RF, LL13 0RG, LL13 0RP, LL13 0RS, LL13 0SG, LL13 0SH",266,236,30
W00002104,LL13,"LL13 0PL, LL13 0RH, LL13 0RJ, LL13 0RL, LL13 0RN, LL13 0RQ, LL13 0RR, LL13 0RW",238,210,28
W00002103,LL13,"LL13 0SP, LL13 0SR, LL13 0SS, LL13 0ST, LL13 0SU, LL13 0TE, LL13 0UU, LL13 0UY, LL13 0XD, LL13 0XE, LL13 0XX, LL13 0YA, LL13 0YB, LL13 0YP, LL13 0YS, LL13 0YT, LL13 0YW",235,206,29
W00002102,LL13,"LL13 0PF, LL13 0PG, LL13 0PH, LL13 0PN, LL13 0PP, LL13 0PR, LL13 0PT, LL13 0PU, LL13 0PW, LL13 0RE, LL13 0SA, LL13 0SD, LL13 0SE, LL13 0SF, LL13 0SQ, LL13 0SZ, LL13 0TF",267,240,27
W00002101,LL13,"LL13 0RT, LL13 0RU, LL13 0RX, LL13 0RY, LL13 0SB",245,211,34
W00002038,LL13,"LL13 7AR, LL13 7BT, LL13 7BU, LL13 7UU, LL13 7YF, LL13 7YJ, LL13 7YN, LL13 7YQ",186,162,24
W00002032,LL13,"LL13 7AY, LL13 7BD, LL13 7BE, LL13 7BG, LL13 7BS",365,339,26
W00002033,LL13,"LL13 7BH, LL13 7BL, LL13 7BW, LL13 7EY, LL13 7HF, LL13 7HH, LL13 7HL",230,192,38
W00002034,LL13,"LL13 7BN, LL13 7DA, LL13 7GU, LL13 7GW, LL13 7GX, LL13 7GY, LL13 7GZ, LL13 8QN",335,282,53
W00002035,LL13,"LL13 8NP, LL13 8NR, LL13 8QH, LL13 8QR, LL13 8QS, LL13 8QT, LL13 8QX, LL13 8QZ",293,241,52
W00002259,LL13,"LL13 0NP, LL13 0NQ, LL13 0NR, LL13 0NS, LL13 0NZ, LL13 0YJ, LL13 0YY, LL13 0YZ",302,261,41
W00002203,LL13,"LL13 8TP, LL13 8TR, LL13 8TW, LL13 8UB",406,366,40
W00002258,LL13,"LL13 8EW, LL13 8NW, LL13 8PL, LL13 8PT, LL13 8PW, LL13 8QA, LL13 8RB",283,264,19
W00010038,LL13,"LL13 9GE, LL13 9GJ, LL13 9GL, LL13 9GP, LL13 9GW, LL13 9GY, LL13 9PJ",319,278,41
W00002205,LL13,"LL13 9DQ, LL13 9QH, LL13 9QR, LL13 9QT, LL13 9QU, LL13 9QX, LL13 9QY, LL13 9SX",383,352,31
W00002206,LL13,"LL13 9JY, LL13 9PZ, LL13 9QQ, LL13 9QW",257,232,25
W00002253,LL13,"LL13 0QD, LL13 0QH, LL13 0QL, LL13 0QN, LL13 8JE, LL13 8YE",332,273,59
W00002254,LL13,"LL13 8JA, LL13 8JD, LL13 8JF, LL13 8JG, LL13 8JH, LL13 8JJ, LL13 8JL, LL13 8JQ",281,250,31
W00002211,LL13,"LL13 9HQ, LL13 9HZ, LL13 9QB, LL13 9QD, LL13 9QG, LL13 9QJ, LL13 9QP",285,255,30
W00002213,LL13,"LL13 9EF, LL13 9EH, LL13 9ES, LL13 9EX",193,177,16
W00002214,LL13,"LL13 9AN, LL13 9DY, LL13 9EA, LL13 9EN, LL13 9ET, LL13 9EZ",206,183,23
W00010025,LL13,"LL13 0JH, LL13 0JY",192,148,44
W00010026,LL13,"LL13 9GD, LL13 9GQ, LL13 9GR, LL13 9GS, LL13 9GX",276,242,34
W00010031,LL13,"LL13 0QR, LL13 8JB, LL13 8YF, LL13 8YH",256,240,16
W00010032,LL13,"LL13 0JJ, LL13 0JZ, LL13 0LA, LL13 0LX, LL13 0LZ, LL13 0NT, LL13 0QP",280,242,38
W00002135,LL13,"LL13 7RA, LL13 7RE, LL13 7SA, LL13 7SE, LL13 7UG, LL13 7UH, LL13 7UP, LL13 7US, LL13 7UT, LL13 7UW",281,262,19
W00010035,LL13,"LL13 7UA, LL13 7UE, LL13 7UF",235,219,16
W00010037,LL13,"LL13 9FX, LL13 9FY, LL13 9GF, LL13 9GG, LL13 9GN, LL13 9GT, LL13 9GU, LL13 9GZ, LL13 9SE",322,288,34
W00002243,LL13,"LL13 8EN, LL13 8EU, LL13 8EY, LL13 8HA, LL13 8HE",307,283,24
W00002134,LL13,"LL13 7DR, LL13 7PE, LL13 7PF, LL13 7PG, LL13 7PH, LL13 7RT, LL13 7SP, LL13 7SS, LL13 7YR, LL13 7ZD, LL13 7ZG",235,203,32
W00002256,LL13,"LL13 8AQ, LL13 8PP, LL13 8PR, LL13 8PS, LL13 8PU, LL13 8PY, LL13 8RA, LL13 8UE, LL13 8UG, LL13 8UN, LL13 8UP, LL13 8UT, LL13 8YN, LL13 8YP, LL13 8YR, LL13 8YS",362,318,44
W00001952,LL13,"LL13 7EN, LL13 7ER, LL13 7JA, LL13 7QH, LL13 7QL, LL13 7QN, LL13 7QP, LL13 7QQ",375,310,65
W00001953,LL13,"LL13 7DJ, LL13 7DP, LL13 7DU, LL13 7DY, LL13 7EE, LL13 7EG, LL13 7EH, LL13 7EL",369,326,43
W00001954,LL13,"LL13 7AD, LL13 7AL, LL13 7AS, LL13 7BY, LL13 7DG, LL13 7DH, LL13 7DL, LL13 7EA, LL13 7EU, LL13 7HD, LL13 7HE, LL13 7LE",281,248,33
W00001955,LL13,"LL13 7AP, LL13 7AT, LL13 7DQ, LL13 7EB, LL13 7ED, LL13 7EF, LL13 7ES, LL13 7ET, LL13 7EW, LL13 7HA, LL13 7HB",383,342,41
W00001956,LL13,"LL13 7QB, LL13 7QD, LL13 7QE, LL13 7QF, LL13 7QG, LL13 7QJ, LL13 7QW",281,215,66
W00001957,LL13,"LL13 7DX, LL13 7DZ, LL13 7EJ, LL13 7EP, LL13 7EQ, LL13 7EX, LL13 7EZ, LL13 7JB, LL13 7JD, LL13 7JE, LL13 7JF, LL13 7JH, LL13 7JJ, LL13 7JL",297,240,57
W00002257,LL13,"LL13 8EA, LL13 8NN, LL13 8PE, LL13 8PF, LL13 8PG, LL13 8PH",344,308,36
W00002182,LL13,"LL13 0YR, LL14 1PD, LL14 1PE, LL14 1PG, LL14 1PJ, LL14 1PL, LL14 4DP, LL14 4DR, LL14 4DS, LL14 4DT, LL14 4DU, LL14 4EH, LL14 4EL, LL14 4EN, LL14 4EP, LL14 4FH, LL14 4FJ, LL14 4HB, LL14 4PJ, LL14 6ET, LL14 6HF, LL14 6HG",461,369,92
W00010468,LL13,"LL13 0PA, LL13 9PR, LL13 9PS, LL13 9PT, LL13 9QA, LL13 9QE, LL13 9RA, LL13 9RB, LL13 9SQ",1666,1566,100
W00002185,LL14,"LL14 1LW, LL14 1SS, LL14 1ST, LL14 1SU, LL14 1SY, LL14 1TB, LL14 1TE",295,202,93
W00002184,LL14,"LL14 1HL, LL14 1HR, LL14 1HT, LL14 1NP, LL14 1NR, LL14 1NS, LL14 1NT, LL14 1NU, LL14 1NW, LL14 1NY, LL14 1PA, LL14 1PB, LL14 1PF, LL14 1PH",272,220,52
W00002183,LL14,"LL14 1TG, LL14 1TJ, LL14 1UH, LL14 1UJ, LL14 1UL, LL14 1UN, LL14 2LP, LL14 2LR, LL14 2LS, LL14 2LT, LL14 2PP",260,209,51
W00002180,LL14,"LL14 3AU, LL14 3HE, LL14 3HG, LL14 3HH, LL14 3HL, LL14 3LE",344,311,33
W00002181,LL14,"LL14 1TH, LL14 1TL, LL14 1TN, LL14 4ER, LL14 4ES, LL14 4ET, LL14 4EW, LL14 4HY, LL14 4LA, LL14 4LB, LL14 4LD, LL14 4LE, LL14 4LF, LL14 4LG, LL14 4LH, LL14 4LW, LL14 4LY, LL14 4NB, LL14 4ND, LL14 4ZY",301,248,53
W00002194,LL14,"LL14 1AE, LL14 1DE, LL14 1DF, LL14 1DG, LL14 1DH, LL14 1DJ, LL14 1PY, LL14 1RB, LL14 1RD, LL14 1RE, LL14 1RF, LL14 1RG",229,185,44
W00002232,LL14,"LL14 6AP, LL14 6AR, LL14 6AS, LL14 6AT, LL14 6BN",238,203,35
W00002226,LL14,"LL14 6AD, LL14 6AE, LL14 6AG, LL14 6AQ, LL14 6AX, LL14 6LF, LL14 6LG, LL14 6WA, LL14 6WB",317,269,48
W00001114,LL14,"LL14 5WZ, LL14 5YD, LL14 5YU, LL14 5YZ, LL14 5ZA, LL14 5ZB, LL20 7ZA, LL20 7ZB, LL20 7ZD, LL20 7ZF, LL20 7ZH, LL20 7ZJ, LL20 7ZR, LL20 7ZU, LL20 7ZW, LL20 7ZZ, LL20 8EP, LL20 8ET, LL20 8EY, LL20 8HJ, LL20 8HW, LL20 8ND, LL20 8NE, LL20 8NF, LL20 8NH, LL20 8NJ, LL20 8NL, LL20 8NN, LL20 8NP, LL20 8NR, LL20 8NS, LL20 8NT, LL20 8NW, LL20 8NY, LL20 8PA, LL20 8PB, LL20 8PE, LL20 8PF, LL20 8PG, LL20 8PH, LL20 8PL, LL20 8PN, LL20 8PQ, LL20 8PW, LL20 8RL, LL20 8RP, LL20 8RR, LL20 8RT, LL20 8RU, LL20 8RW, LL20 8RY, LL20 8TT, LL20 8TY, LL20 8WA, LL20 8WB, LL20 8WP, LL20 8WR, LL20 8WZ, LL20 8YH, LL20 8YL, LL20 8YN, LL20 8YW, LL20 8ZA, LL20 8ZB, LL20 8ZD, LL20 8ZE, LL20 8ZF, LL20 8ZG, LL20 8ZH, LL20 8ZJ, LL20 8ZL, LL20 8ZP, LL20 8ZW, LL20 9AF, LL20 9AG, LL20 9AH, LL20 9AJ, LL20 9AL, LL20 9AN, LL20 9AP, LL20 9AQ, LL20 9AR, LL20 9AS, LL20 9AT, LL20 9AU, LL20 9AW, LL20 9AX, LL20 9AY, LL20 9BA, LL20 9BB, LL20 9BE, LL20 9BF, LL20 9BG, LL20 9BH, LL20 9BJ",234,209,25
W00002179,LL14,"LL14 3HA, LL14 3HB, LL14 3HD",278,253,25
W00010039,LL14,"LL14 6AF, LL14 6AJ, LL14 6BP, LL14 6BY",265,228,37
W00010034,LL14,"LL14 6BJ, LL14 6BQ, LL14 6BS, LL14 6BW, LL14 6BX, LL14 6BZ, LL14 6YY",331,266,65
W00002196,LL14,"LL14 1HN, LL14 1HP, LL14 1HU, LL14 1HW, LL14 1LB, LL14 1LD, LL14 1LT, LL14 1LY, LL14 1PN, LL14 1SD, LL14 1SF, LL14 1SG, LL14 1SL, LL14 1SN, LL14 1SP, LL14 1SR, LL14 1SW, LL14 1TA, LL14 1TD",262,224,38
W00002195,LL14,"LL14 1AL, LL14 1AP, LL14 1AS, LL14 1AT, LL14 1AU, LL14 1AX, LL14 1AY, LL14 1BB, LL14 1BD, LL14 1BN, LL14 1BP, LL14 1BQ, LL14 1BS, LL14 2LF",291,223,68
W00002193,LL14,"LL14 1AN, LL14 1AW, LL14 1BF, LL14 1BW, LL14 1BY, LL14 1DP, LL14 1DT, LL14 1EA, LL14 1EB, LL14 1ED, LL14 1EE",238,177,61
W00002192,LL14,"LL14 1DY, LL14 1EF, LL14 1EG, LL14 1EN, LL14 1EP, LL14 1EW, LL14 1EY, LL14 1RW, LL14 1SB",210,158,52
W00002191,LL14,"LL14 1BA, LL14 1BE, LL14 1BG, LL14 1BH, LL14 1BJ, LL14 1BL, LL14 1BT, LL14 1BU, LL14 1BX, LL14 1BZ, LL14 1DA, LL14 1DL, LL14 1DN, LL14 2LG, LL14 2LH, LL14 2LN, LL14 2LW",273,207,66
W00002190,LL14,"LL14 1EU, LL14 1HA, LL14 1HF, LL14 1HG, LL14 1HH, LL14 1HQ, LL14 1HS, LL14 1HX, LL14 1HY, LL14 1LA, LL14 1LE",302,220,82
W00002189,LL14,"LL14 1DB, LL14 1DD, LL14 1EH, LL14 1EJ, LL14 1EL, LL14 1ER, LL14 1ES, LL14 1ET, LL14 1HB, LL14 1HD, LL14 1HE",277,176,101
W00002188,LL14,"LL14 1AA, LL14 1AB, LL14 1AD, LL14 1AF, LL14 1AG, LL14 1AQ, LL14 1LN, LL14 1PT, LL14 1PU, LL14 2BL, LL14 2EE, LL14 2HY, LL14 2LA, LL14 2LJ",235,205,30
W00002235,LL14,"LL14 6AA, LL14 6AB, LL14 6BF, LL14 6BL, LL14 6DQ, LL14 6DR, LL14 6ER, LL14 6LE, LL14 6LX, LL14 6NB, LL14 6ND, LL14 6NE, LL14 6NF, LL14 6NG, LL14 6NH, LL14 6NJ, LL14 6NL, LL14 6NN, LL14 6NP, LL14 6NQ, LL14 6NX, LL14 6WD, LL14 6WG",256,229,27
W00002234,LL14,"LL14 6NR, LL14 6NS, LL14 6NT, LL14 6NU, LL14 6NW, LL14 6NY, LL14 6PE, LL14 6PF, LL14 6PG, LL14 6PH, LL14 6PL, LL14 6PN",222,201,21
W00002187,LL14,"LL14 1AH, LL14 1AR, LL14 2DP, LL14 2DR, LL14 2DT, LL14 2DW, LL14 2EQ, LL14 2LD, LL14 2LE, LL14 2LL",296,232,64
W00002186,LL14,"LL14 1AJ, LL14 1DQ, LL14 1DU, LL14 1RH, LL14 1RL, LL14 1RN, LL14 1RP, LL14 1RR, LL14 1RS, LL14 1RT, LL14 1RU, LL14 1RX, LL14 1RY, LL14 1SA, LL14 1SE, LL14 1SH, LL14 1WG",351,266,85
W00002233,LL14,"LL14 6AH, LL14 6AL, LL14 6AN, LL14 6AW, LL14 6PW",292,271,21
W00002231,LL14,"LL14 6BE, LL14 6BG, LL14 6BH, LL14 6PP",251,227,24
W00002178,LL14,"LL14 3LF, LL14 3UN, LL14 3UP, LL14 3UQ, LL14 3US, LL14 3UT, LL14 3UU, LL14 3UW, LL14 3UY",287,264,23
W00002172,LL14,"LL14 3EH, LL14 3EL, LL14 6DP, LL14 6EN, LL14 6EP, LL14 6EQ, LL14 6PR, LL14 6TA, LL14 6TB, LL14 6TD, LL14 6TE, LL14 6TF, LL14 6TG",266,236,30
W00002160,LL14,"LL14 2NE, LL14 2NP, LL14 2NR, LL14 2NS, LL14 2NT, LL14 2NU",284,251,33
W00001959,LL14,"LL14 4HF, LL14 4HG, LL14 4HH, LL14 4HL, LL14 4HN, LL14 4HP, LL14 4HR, LL14 4HS, LL14 4HT, LL14 4LL, LL14 4LP",116,101,15
W00001958,LL14,"LL14 4DD, LL14 4DE, LL14 4DF, LL14 4DG, LL14 4DJ, LL14 4DQ, LL14 4DX, LL14 4DZ, LL14 4EQ",252,233,19
W00001936,LL14,"LL14 5DH, LL14 5EZ, LL14 5HX, LL14 5LW, LL14 5PE, LL14 5PF, LL14 5PQ",188,172,16
W00001935,LL14,"LL14 5AJ, LL14 5BH, LL14 5BQ, LL14 5BS, LL14 5BT, LL14 5ET, LL14 5EU, LL14 5EY, LL14 5HA, LL14 5HB, LL14 5HD, LL14 5HE, LL14 5LQ, LL14 5NR, LL14 5NS, LL14 5NW, LL14 5PA, LL14 5PG, LL14 5PN, LL14 5PS, LL14 5RD, LL14 5RE",399,358,41
W00001934,LL14,"LL14 5PB, LL14 5PD, LL14 5PH, LL14 5PJ, LL14 5PL, LL14 5PR, LL14 5PU, LL14 5PW, LL14 5QB",371,350,21
W00001933,LL14,"LL14 5ND, LL14 5NE, LL14 5PP",315,287,28
W00001932,LL14,"LL14 5NF, LL14 5NH, LL14 5NJ, LL14 5NL, LL14 5NN, LL14 5NP, LL14 5NQ, LL14 5NU, LL14 5PT, LL14 5PY, LL14 5RB",335,298,37
W00001931,LL14,"LL14 5AA, LL14 5AB, LL14 5AD, LL14 5AE, LL14 5AF, LL14 5AG, LL14 5AH, LL14 5AL, LL14 5AN, LL14 5HG, LL14 5HH, LL14 5HP, LL14 5LR, LL14 5LS, LL14 5LT, LL14 5LU, LL14 5LY, LL14 5NA, LL14 5NB, LL14 5NT, LL14 5RL, LL14 5SB, LL20 7RY",316,276,40
W00001930,LL14,"LL14 5BP, LL14 5EP, LL14 5EQ, LL14 5ER, LL14 5ES",311,284,27
W00001929,LL14,"LL14 5AQ, LL14 5BE, LL14 5BF, LL14 5BX, LL14 5BZ, LL14 5DJ, LL14 5RA, LL14 5RF",391,346,45
W00001960,LL14,"LL14 4EU, LL14 4EX, LL14 4EY, LL14 4EZ, LL14 4HJ, LL14 4HX",255,214,41
W00001928,LL14,"LL14 5HY, LL14 5LA, LL14 5LG, LL14 5NG, LL14 5NY",305,277,28
W00001926,LL14,"LL14 3JE, LL14 5AP, LL14 5AR, LL14 5AS, LL14 5AT, LL14 5AU, LL14 5AW",234,207,27
W00001925,LL14,"LL14 5LD, LL14 5LE, LL14 5LF, LL14 5LH, LL14 5LL, LL14 5ZD",299,285,14
W00001924,LL14,"LL14 5HF, LL14 5HL, LL14 5HN, LL14 5HR, LL14 5HS, LL14 5HT, LL14 5HU, LL14 5HW, LL14 5LB",281,263,18
W00001923,LL14,"LL14 5BJ, LL14 5BN, LL14 5BW, LL14 5LN, LL14 5RG",309,286,23
W00002164,LL14,"LL14 1UW, LL14 2PG, LL14 2PR, LL14 2PT, LL14 2PU, LL14 2PW, LL14 2PY, LL14 2RA",280,228,52
W00002163,LL14,"LL14 2DE, LL14 2DH, LL14 2EF, LL14 2PN, LL14 2SE",287,228,59
W00002162,LL14,"LL14 2NF, LL14 2NG, LL14 2NN, LL14 2NW, LL14 2NY, LL14 2PA, LL14 2PB",303,233,70
W00002161,LL14,"LL14 2PH, LL14 2PL, LL14 2PS",293,240,53
W00001917,LL14,"LL14 5BL, LL20 7AT, LL20 7AU, LL20 7BD, LL20 7BE, LL20 7BG, LL20 7BN, SY10 7NE, SY10 7NF, SY10 7NS, SY10 7NT, SY10 7NU, SY10 7NX, SY10 7NY, SY10 7PA",297,256,41
W00002159,LL14,"LL14 2BS, LL14 2EA, LL14 2EB, LL14 2ED, LL14 2HU, LL14 2LB",273,188,85
W00001927,LL14,"LL14 5AX, LL14 5AY, LL14 5AZ, LL14 5BA, LL14 5BB, LL14 5BD, LL14 5BG",222,203,19
W00001961,LL14,"LL14 4AR, LL14 4AS, LL14 4AT, LL14 4AX, LL14 4AY, LL14 4BJ, LL14 4EJ, LL14 4FA, LL14 4FB, LL14 4FE, LL14 4HU",212,175,37
W00001962,LL14,"LL14 4BP, LL14 4BS, LL14 4BY, LL14 4DA, LL14 4DH, LL14 4DW, LL14 4EG, LL14 4FG, LL14 4HZ",315,283,32
W00001963,LL14,"LL14 4AB, LL14 4AE, LL14 4BD, LL14 4BE, LL14 4BG, LL14 4BH, LL14 4BL, LL14 4BN",361,321,40
W00002170,LL14,"LL14 1TP, LL14 1TR, LL14 1TS, LL14 1TW, LL14 2SA, LL14 2SD, LL14 2SJ",249,205,44
W00002169,LL14,"LL14 2EG, LL14 2LY, LL14 2RD, LL14 2RE, LL14 2RN, LL14 2RT, LL14 2RU, LL14 2RW, LL14 2RY, LL14 2SG",318,254,64
W00002168,LL14,"LL14 2RP, LL14 2RR, LL14 2RS, LL14 2SB, LL14 2TR",346,292,54
W00002167,LL14,"LL14 1TT, LL14 1UD, LL14 1UE, LL14 1UF, LL14 1UG, LL14 2RB, LL14 2RF, LL14 2RG, LL14 2RH, LL14 2RL",281,231,50
W00002166,LL14,"LL14 2NH, LL14 2PD, LL14 2PE, LL14 2PF, LL14 2PJ, LL14 2PQ, LL14 2SF",287,234,53
W00002071,LL14,"LL14 3NL, LL14 3NP, LL14 3NW, LL20 7PF, LL20 7TQ, LL20 7TS, LL20 7TT, LL20 7TY, LL20 7UA, LL20 7UF, LL20 7YQ, LL20 7YR, LL20 7YS",206,188,18
W00002070,LL14,"LL14 3SG, LL14 3ST, LL14 3SU, LL20 7TL, LL20 7TN, LL20 7TP, LL20 7TR, LL20 7TU, LL20 7TW",309,269,40
W00002165,LL14,"LL14 2DF, LL14 2DG, LL14 2NA, LL14 2NB, LL14 2ND, LL14 2NL",361,312,49
W00002060,LL14,"LL14 1RA, LL14 1UR, LL14 1UT, LL14 1YE, LL14 1YF, LL14 2TB",283,245,38
W00002059,LL14,"LL14 1PS, LL14 1PW, LL14 1RJ, LL14 1UP, LL14 1UU",271,230,41
W00002058,LL14,"LL14 2AP, LL14 2AR, LL14 2AS, LL14 2AT, LL14 2AU, LL14 2AW, LL14 2AY",304,270,34
W00002057,LL14,"LL14 2BB, LL14 2BD, LL14 2BE, LL14 2BG, LL14 2TN, LL14 2TP, LL14 2TW, LL14 6HY",305,273,32
W00002056,LL14,"LL14 2AG, LL14 2AH, LL14 2AJ, LL14 2AN, LL14 2AZ, LL14 2BA, LL14 2BF, LL14 6ES, LL14 6EU, LL14 6HA, LL14 6HJ, LL14 6HU, LL14 6JA, LL14 6JB, LL14 6PU, LL14 6UY, LL14 6YF",327,299,28
W00002055,LL14,"LL14 1YG, LL14 2SS, LL14 2TD, LL14 2TG, LL14 2TH, LL14 2TL, LL14 2TS, LL14 2TT",306,264,42
W00002054,LL14,"LL14 2SP, LL14 2SR, LL14 2SU, LL14 2TA, LL14 2TE, LL14 2TF",252,190,62
W00002053,LL14,"LL14 2AB, LL14 2AD, LL14 2AF, LL14 2SW, LL14 2SY",170,149,21
W00002052,LL14,"LL14 1PQ, LL14 1PR, LL14 1US, LL14 1UY",303,270,33
W00002051,LL14,"LL14 1AZ, LL14 1LU, LL14 1NA, LL14 1NB, LL14 1ND, LL14 1NE, LL14 1NF, LL14 1NG, LL14 1NH, LL14 1NL, LL14 1NN, LL14 2AA, LL14 2SL, LL14 2SN",285,243,42
W00002050,LL14,"LL14 1NJ, LL14 1NQ, LL14 1PP, LL14 2AE, LL14 2AL, LL14 2AX, LL14 2SH, LL14 2ST, LL14 2SX",277,235,42
W00001967,LL14,"LL14 4AH, LL14 4AL, LL14 4AP, LL14 4AW, LL14 4EA, LL14 4EB, LL14 4ED, LL14 4EF, LL14 4GA",306,285,21
W00001966,LL14,"LL14 4AF, LL14 4AJ, LL14 4AN, LL14 4AQ, LL14 4DN, LL14 4DY, LL14 4EE",250,234,16
W00001965,LL14,"LL14 4AA, LL14 4BQ, LL14 4BT, LL14 4BU, LL14 4BW, LL14 4BX, LL14 4DB, LL14 4DL",288,264,24
W00001964,LL14,"LL14 4AD, LL14 4AG, LL14 4AU, LL14 4AZ, LL14 4BA, LL14 4BB, LL14 4FD, LL14 4FF, LL14 4ZD",308,284,24
W00002158,LL14,"LL14 2BP, LL14 2BT, LL14 2BW, LL14 2BY, LL14 2BZ, LL14 2DA, LL14 2DB, LL14 2DJ, LL14 2DQ, LL14 2HT, LL14 2WD",265,198,67
W00001914,LL14,"LL14 3AZ, LL14 3BP, LL14 3BS, LL14 3BT, LL14 3BU, LL14 3BW, LL14 3DL, LL14 3DN, LL14 3DP, LL14 3DR, LL14 3DS, LL14 3DW, LL14 3GB, LL14 3QA, LL14 3RE, LL14 3RF, LL14 3RH, LL14 3RJ, LL14 3RL, LL14 3RN, LL14 3RW, LL14 3RX, LL14 3SA, LL14 3SY",321,296,25
W00002228,LL14,"LL14 6DT, LL14 6DY, LL14 6EB, LL14 6PA, LL14 6PB, LL14 6PD, LL14 6PS, LL14 6PY, LL14 6RA, LL14 6RD, LL14 6RE, LL14 6RF, LL14 6RG, LL14 6RH, LL14 6RJ, LL14 6RL, LL14 6RP",395,322,73
W00002173,LL14,"LL14 6DW, LL14 6HP, LL14 6HR, LL14 6HS, LL14 6HT, LL14 6HW, LL14 6LA, LL14 6LB, LL14 6LD, LL14 6LJ, LL14 6LL, LL14 6LN, LL14 6LP, LL14 6LQ, LL14 6LR, LL14 6LS, LL14 6LT, LL14 6LU, LL14 6LW, LL14 6LY",400,356,44
W00002229,LL14,"LL14 6AU, LL14 6AY, LL14 6BA, LL14 6BB, LL14 6BD, LL14 6HB, LL14 6HE, LL14 6PT",183,167,16
W00001882,LL14,"LL14 4HE, LL14 4JA, LL14 4JB, LL14 4JD, LL14 4JE, LL14 4JF",339,287,52
W00002174,LL14,"LL14 6BU, LL14 6DA, LL14 6DB, LL14 6DD, LL14 6DE, LL14 6DF, LL14 6DG, LL14 6DH, LL14 6DJ, LL14 6DL, LL14 6DN, LL14 6DS, LL14 6DX, LL14 6EA, LL14 6EE, LL14 6EJ, LL14 6EL",402,348,54
W00002175,LL14,"LL14 3ER, LL14 3HF, LL14 3LG, LL14 3UR",278,257,21
W00001899,LL14,"LL14 3DX, LL14 3EA, LL14 3EB, LL14 3ED, LL14 3EX, LL14 3YF, LL14 3YG, LL14 3YH, LL14 3YJ, LL14 3YL, LL14 3YN, LL14 3YQ, LL14 3YW, LL14 3ZA, LL14 3ZF, LL14 3ZH",226,202,24
W00001900,LL14,"LL14 3AE, LL14 3AF, LL14 3AG, LL14 3AH, LL14 3AL, LL14 3AN, LL14 3AQ, LL14 3AR, LL14 3AS, LL14 3AT, LL14 3AW, LL14 3AX, LL14 3BF, LL14 3DF, LL14 3DG, LL14 3DH, LL14 3DT, LL14 3PL, LL14 3PU, LL14 3PY, LL14 3YD, LL14 3YE, LL14 3YP, LL14 3YR, LL14 3YU",357,310,47
W00001901,LL14,"LL14 3BH, LL14 3BL, LL14 3BN, LL14 3JP, LL14 3RG, LL14 3RR, LL14 3RS, LL14 3RT, LL14 3RU, LL14 3RY, LL14 3SF, LL14 3SL, LL14 3SN, LL14 3SW",273,235,38
W00001902,LL14,"LL14 3AA, LL14 3BD, LL14 3BE, LL14 3BG, LL14 3LN, LL14 3LW, LL14 3NB, LL14 3ND, LL14 3NF, LL14 3NG, LL14 3NH, LL14 3NN, LL14 3NR, LL14 3PF, LL14 3RA",275,235,40
W00001903,LL14,"LL14 3AJ, LL14 3BJ, LL14 3DJ, LL14 3JD, LL14 3PP, LL14 3PR, LL14 3YS, LL14 3YT, LL14 3YY",302,269,33
W00002153,LL14,"LL14 2EJ, LL14 2EU, LL14 2EW, LL14 2EY, LL14 2HP, LL14 2HR",277,231,46
W00001904,LL14,"LL14 3AB, LL14 3AD, LL14 3AP, LL14 3AY, LL14 3BA, LL14 3BB, LL14 3BQ, LL14 3BY, LL14 3BZ, LL14 3DA, LL14 3DB, LL14 3DD, LL14 3DE, LL14 3LP, LL14 3LR, LL14 3NJ, LL14 3NQ, LL14 3NU",266,224,42
W00002176,LL14,"LL14 3HY, LL14 3LA, LL14 3LD, LL14 3UH, LL14 3UL",283,260,23
W00002156,LL14,"LL14 2EP, LL14 2ES, LL14 2ET, LL14 2HB, LL14 2HH",359,305,54
W00001905,LL14,"LL14 3LS, LL14 3LT, LL14 3NE, LL14 3NY, LL14 3PB",313,287,26
W00001906,LL14,"LL14 3PA, LL14 3PH, LL14 3PN, LL14 3PS, LL14 3PT, LL14 3PW",328,298,30
W00001907,LL14,"LL14 3EJ, LL14 3HJ, LL14 3JA, LL14 3JB, LL14 3JF, LL14 3JG, LL14 3JH, LL14 3JJ, LL14 3JL, LL14 3JN, LL14 3JQ, LL14 3JW, LL14 3PE, LL14 3RB, LL14 3RD",305,272,33
W00002177,LL14,"LL14 3EP, LL14 3ES, LL14 3ET, LL14 3EU, LL14 3EY",314,279,35
W00001908,LL14,"LL14 3LU, LL14 3LY, LL14 3NA, LL14 3PD, LL14 3PG",326,288,38
W00001909,LL14,"LL14 1TU, LL14 3HN, LL14 3LH, LL14 3LJ, LL14 3LX, LL14 3TS, LL14 3TT, LL14 3TU, LL14 3TY, LL14 3UA, LL14 3UB, LL14 3UD, LL14 3UE, LL14 3UF, LL14 3UG, LL14 3UJ, LL14 3YA, LL14 3YB, LL14 6RN",478,437,41
W00001910,LL14,"LL14 3RP, LL14 3SB, LL14 3SD, LL14 3SE, LL14 3SH, LL14 3SJ, LL14 3TB, LL14 3TD, LL14 3TF, LL14 3TG, LL14 3TH, LL14 3TJ, LL14 3TP, LL14 3TQ, LL14 3TR, LL14 3TW, LL14 3TZ",302,271,31
W00002155,LL14,"LL14 1LP, LL14 1LR, LL14 1LS, LL14 2BN, LL14 2BU, LL14 2BX, LL14 2DY, LL14 2EN, LL14 2ER, LL14 2HN, LL14 2HW",369,288,81
W00002154,LL14,"LL14 2HA, LL14 2HD, LL14 2HE, LL14 2HF, LL14 2HG, LL14 2HL, LL14 2HS, LL14 6RB",323,253,70
W00001911,LL14,"LL14 1TY, LL14 1UA, LL14 1UB, LL14 3SP, LL14 3SR, LL14 3SS, LL14 3SX, LL14 3TA, LL14 3TE, LL14 3TL, LL14 3TN, LL14 3TX, LL20 7YH",273,235,38
W00001912,LL14,"LL14 3HP, LL14 3HQ, LL14 3HR, LL14 3HS, LL14 3HT, LL14 3HU, LL14 3HW, LL14 3LB",226,194,32
W00001913,LL14,"LL14 3BX, LL14 3DZ, LL14 3EE, LL14 3EF, LL14 3EG, LL14 3EN, LL14 3EQ, LL14 3EW, LL14 3EZ",292,255,37
W00002157,LL14,"LL14 2DD, LL14 2DL, LL14 2DN, LL14 2DS, LL14 2DU, LL14 2DX, LL14 2EH, LL14 2EL",338,263,75
W00002171,LL14,"LL14 6BT, LL14 6DU, LL14 6ED, LL14 6EF, LL14 6EG, LL14 6EH, LL14 6RW",291,246,45
W00001304,LL15,"LL15 1AR, LL15 1BU, LL15 1BY, LL15 1DQ, LL15 1DR, LL15 1DS, LL15 1DX, LL15 1PP, LL15 1PT, LL15 1XQ, LL15 2NP, LL15 2NR, LL15 2NU, LL15 2NZ",277,154,123
W00001302,LL15,"LL15 1LF, LL15 1LH, LL15 1NS, LL15 1NT, LL15 1NU, LL15 1PD",274,189,85
W00001301,LL15,"LL15 1DN, LL15 1DT, LL15 1DU, LL15 1DY, LL15 1EA, LL15 1ED, LL15 1EE, LL15 1EF, LL15 1EX, LL15 1HD",345,270,75
W00001303,LL15,"LL15 1HE, LL15 1HL, LL15 1HT, LL15 1HU, LL15 1LB, LL15 1LE, LL15 1LX, LL15 2AA, LL15 2AB, LL15 2AD, LL15 2AE, LL15 2AR, LL15 2LL",284,163,121
W00001305,LL15,"LL15 1RL, LL15 1RN, LL15 1RP, LL15 1RW, LL15 1YP",200,107,93
W00001306,LL15,"LL15 1PJ, LL15 1PU, LL15 1RA, LL15 1RQ, LL15 1RR, LL15 1RS, LL15 1RX",289,152,137
W00001090,LL15,"LL15 1AY, LL15 1RJ, LL15 1RY, LL15 1SB, LL15 1SE, LL15 1SF, LL15 1SJ, LL15 1UD, LL15 1UE",281,185,96
W00001089,LL15,"LL15 1BF, LL15 1SA, LL15 1SH, LL15 1SS, LL15 1ST, LL15 1SU, LL15 1TA, LL15 1TB, LL15 1TD, LL15 1TS, LL15 1TT, LL15 1TU, LL15 1UU, LL15 1UY, LL15 1YA, LL15 1YB, LL15 1YD, LL15 1YT",262,176,86
W00001300,LL15,"LL15 1AE, LL15 1AF, LL15 1AG, LL15 1AH, LL15 1AN, LL15 1AP, LL15 1AS, LL15 1AW, LL15 1BP, LL15 1DL, LL15 1DP, LL15 1DW, LL15 1HF, LL15 1HG, LL15 1HH, LL15 1HP, LL15 1HR, LL15 1HS, LL15 1HW, LL15 1HY, LL15 1WY",236,186,50
W00001307,LL15,"LL15 1RB, LL15 1RD, LL15 1RE, LL15 1RF, LL15 1RG, LL15 1RH, LL15 1RZ, LL15 1YH",261,123,138
W00001088,LL15,"LL15 1BQ, LL15 1SL, LL15 1SP, LL15 1SR, LL15 1SW, LL15 1SY, LL15 1UN, LL15 1UW, LL15 1YE, LL15 1YF, LL15 1YG, LL15 2UR, LL15 2UT, LL15 2UU, LL15 2UY, LL15 2XG, LL15 2XX",255,177,78
W00001087,LL15,"LL15 1AQ, LL15 1UP, LL15 1UR, LL15 1US, LL15 1UT, LL15 1UZ, LL15 1WA, LL15 1YR",319,220,99
W00001078,LL15,"LL15 2LP, LL15 2LS, LL15 2NY, LL15 2PB, LL15 2PD, LL15 2PH, LL15 2PJ, LL15 2PL",268,149,119
W00001077,LL15,"LL15 2AF, LL15 2AG, LL15 2AH, LL15 2AN, LL15 2AW, LL15 2DB, LL15 2LN, LL15 2PE, LL15 2PF, LL15 2PG, LL15 2PN, LL15 2PQ, LL15 2PW, LL15 2YU, LL15 2ZG, LL15 2ZP",306,170,136
W00001076,LL15,"LL15 2NA, LL15 2NB, LL15 2ND, LL15 2NF, LL15 2NJ, LL15 2NL, LL15 2NN, LL15 2NQ, LL15 2NW, LL15 2NX, LL21 9RN, LL21 9RU, LL21 9SF, LL21 9SG, LL21 9SH, LL21 9SL, LL21 9SN, LL21 9SQ",452,232,220
W00001091,LL15,"LL15 1RT, LL15 1RU, LL15 1SD, LL15 1SG, LL15 1TR, LL15 1TY, LL15 1UA, LL15 1UB, LL15 1UF, LL16 4LL, LL16 4LN, LL16 4LP",306,192,114
W00001299,LL15,"LL15 1LG, LL15 1LL, LL15 1LN, LL15 1LW, LL15 1LZ, LL15 1YS",246,155,91
W00001123,LL15,"LL15 1AX, LL15 1AZ, LL15 2AL, LL15 2BE, LL15 2BG, LL15 2BH, LL15 2BL, LL15 2BN, LL15 2BP, LL15 2BT, LL15 2BW, LL15 2DD, LL15 2DE, LL15 2DF, LL15 2DG, LL15 2DH, LL15 2DL, LL15 2DN, LL15 2DP, LL15 2DR, LL15 2DS, LL15 2DU, LL15 2DW, LL15 2DX, LL15 2EA, LL15 2EB, LL15 2ED",460,258,202
W00001312,LL15,"LL15 1EH, LL15 1EL, LL15 1EQ, LL15 1ET, LL15 1EW, LL15 1FA, LL15 1HA, LL15 1HB",310,195,115
W00001075,LL15,"LL15 2AP, LL15 2AS, LL15 2AT, LL15 2AU, LL15 2AX, LL15 2AY, LL15 2BA, LL15 2BB, LL15 2BD, LL15 2DT, LL15 2LR, LL15 2LT, LL15 2LU, LL15 2LW, LL15 2LY, LL15 2NE, LL15 2NG, LL15 2NH, LL21 9PR",250,144,106
W00001309,LL15,"LL15 1XY, LL15 1YQ, LL15 2US",285,132,153
W00001108,LL15,"LL15 2EL, LL15 2HD, LL15 2HE, LL15 2HF, LL15 2HG, LL15 2HH, LL15 2HL, LL15 2HN, LL15 2HP, LL15 2HR, LL15 2HS, LL15 2HT, LL15 2HU, LL15 2HW, LL15 2LB, LL15 2LD, LL15 2LE, LL15 2PA, LL15 2SE, LL15 2SH, LL15 2SL, LL15 2SN, LL15 2SP, LL15 2SR, LL15 2SS, LL15 2TF, LL15 2TG, LL15 2TH, LL15 2TL",385,175,210
W00001107,LL15,"LL15 2AJ, LL15 2AQ, LL15 2AZ, LL15 2EF, LL15 2EG, LL15 2EH, LL15 2EN, LL15 2EP, LL15 2EQ, LL15 2EW, LL15 2RT, LL15 2SB, LL15 2SD, LL15 2UH, LL15 2UL, LL15 2UP, LL15 2YL",322,188,134
W00001106,LL15,"LL15 2BF, LL15 2ER, LL15 2ES, LL15 2ET, LL15 2EU, LL15 2EX, LL15 2EY, LL15 2EZ, LL15 2HA, LL15 2HB, LL15 2RJ, LL15 2RU, LL15 2RY, LL15 2SA, LL15 2SF, LL15 2SG, LL15 2UN, LL15 2UW, LL15 2YA, LL15 2YB, LL15 2YD, LL15 2YE, LL15 2YF, LL15 2YG, LL15 2YQ",371,219,152
W00001105,LL15,"LL15 2HY, LL15 2LA, LL15 2LF, LL15 2LG, LL15 2LH, LL15 2PP, LL15 2PR, LL15 2PS, LL15 2PT, LL15 2PU, LL15 2PY, LL15 2RA, LL15 2RB, LL15 2RD, LL15 2RE, LL15 2RF, LL15 2RG, LL15 2RH, LL15 2RL, LL15 2RN, LL15 2RP, LL15 2RR, LL15 2RW, LL15 2ST, LL15 2SU, LL15 2SW, LL15 2SY, LL15 2TA, LL15 2TB, LL15 2TD, LL15 2TE",351,216,135
W00001101,LL15,"LL15 1TF, LL15 1TG, LL15 1TL, LL15 2BS, LL15 2DA, LL15 2TT, LL15 2TU, LL15 2TY, LL15 2TZ, LL15 2UA, LL15 2UB, LL15 2UD, LL15 2UF, LL15 2UJ, LL16 4PA, LL16 4PF, LL16 4PN",403,240,163
W00001311,LL15,"LL15 1AA, LL15 1AB, LL15 1AD, LL15 1BD, LL15 1DH, LL15 1JZ, LL15 1LT, LL15 1NF, LL15 1NG, LL15 1NP, LL15 1NR, LL15 1NW, LL15 1PF, LL15 1QJ, LL15 1XS, LL15 1YL, LL15 2ZD, LL15 2ZH, LL15 9AN, LL15 9AQ, LL15 9AT, LL15 9AY, LL15 9AZ, LL15 9BA, LL15 9BB",339,232,107
W00001100,LL15,"LL15 1BA, LL15 1TE, LL15 1TH, LL15 1TJ, LL15 1TN, LL15 1TP, LL15 1TW, LL15 1TX, LL15 1TZ, LL15 1UG, LL15 1UH, LL15 1UL, LL15 2BY, LL15 2TP, LL15 2TR, LL15 2TS, LL15 2TW, LL15 2UE, LL16 4LF, LL16 4LG, LL16 4LH, LL16 4NY, LL16 4PB",403,211,192
W00001124,LL15,"LL15 2BU, LL15 2DY, LL16 4SA, LL16 4SB, LL16 4SF, LL16 4SG, LL16 4SH, LL16 4SL, LL16 4SN, LL16 4SP, LL16 4SR, LL16 4SW, LL16 4TD, LL16 4TE, LL16 4TH, LL16 4TL, LL16 4TN, LL16 4TP, LL16 4TR, LL16 4TS, LL16 4TT",300,108,192
W00010493,LL15,"LL15 1BB, LL15 1BN, LL15 1BX, LL15 1EN, LL15 1EP, LL15 1ES, LL15 1JG, LL15 1LU, LL15 1LY, LL15 1NA, LL15 1ND, LL15 1NE, LL15 1NJ, LL15 1NL, LL15 1NQ, LL15 1QA, LL15 1QB, LL15 1QD, LL15 1QE, LL15 1QW, LL15 1SN, LL15 1YU, LL15 1ZD, LL15 1ZF, LL15 1ZJ",330,208,122
W00001294,LL15,"LL15 1DZ, LL15 1EB, LL15 1EG, LL15 1EZ, LL15 1JA, LL15 1JB, LL15 1JD, LL15 1JE, LL15 1JF, LL15 1PR, LL15 1PS, LL15 1PY",258,129,129
W00001295,LL15,"LL15 1BZ, LL15 1LR, LL15 1NY, LL15 1PA, LL15 1PB, LL15 1PE, LL15 1PL, LL15 1PQ",279,173,106
W00001296,LL15,"LL15 1HN, LL15 1LS, LL15 1NB, LL15 1PG, LL15 1PH",270,202,68
W00001297,LL15,"LL15 1LD, LL15 1LJ, LL15 1LP, LL15 1LQ",218,156,62
W00001298,LL15,"LL15 1AJ, LL15 1AL, LL15 1AT, LL15 1AU, LL15 1BE, LL15 1BG, LL15 1BH, LL15 1BJ, LL15 1BL, LL15 1BS, LL15 1BT, LL15 1BW, LL15 1DJ, LL15 1EJ, LL15 1ER, LL15 1EU, LL15 1EY, LL15 1LA, LL15 1NH, LL15 1NN, LL15 1WH, LL15 1XF, LL15 1XR, LL15 1XT, LL15 1XU, LL15 1YN, LL15 1YW, LL15 1ZA, LL15 1ZB, LL15 1ZE, LL15 1ZG, LL15 1ZH, LL15 1ZL, LL15 1ZN, LL15 1ZP, LL15 1ZQ, LL15 1ZR, LL15 2WX, LL15 2WY, LL15 2WZ, LL15 2ZA, LL15 2ZB, LL15 2ZE, LL15 2ZF, LL15 2ZJ, LL15 2ZL, LL15 2ZN, LL15 2ZQ, LL15 2ZR, LL15 2ZS, LL15 2ZT, LL15 2ZW, LL15 9AA, LL15 9AB, LL15 9AD, LL15 9AE, LL15 9AF, LL15 9AG, LL15 9AH, LL15 9AJ, LL15 9AL, LL15 9AP, LL15 9AR, LL15 9AS, LL15 9AU, LL15 9AW, LL15 9AX, LL15 9ZY, LL15 9ZZ",241,173,68
W00010458,LL15,"LL15 1FB, LL15 1FD, LL15 1PW, LL15 1QF, LL15 1QG, LL15 1QH, LL15 1QL, LL15 1QN, LL15 1QQ, LL15 2TN, LL15 2UG, LL15 2YH",308,189,119
W00001308,LL15,"LL15 1DA, LL15 1DB, LL15 1DD, LL15 1DE, LL15 1DF, LL15 1DG, LL15 2EE, LL15 2NS, LL15 2NT, LL15 2RS",274,144,130
W00001046,LL16,"LL16 3DG, LL16 3DH, LL16 3DL, LL16 3DN, LL16 3DP, LL16 3DS, LL16 3DU, LL16 3DY, LL16 3DZ, LL16 3EE, LL16 3EQ, LL16 3ET, LL16 3JT, LL16 5TB, LL16 5TE",422,263,159
W00001059,LL16,"LL16 3LG, LL16 3LN, LL16 3LP, LL16 3LR, LL16 3LS, LL16 3LW, LL16 3NT, LL16 3PD, LL16 3PP, LL16 3RG, LL16 3RJ, LL16 3RQ, LL16 3SJ, LL16 3TH, LL16 3TN",282,210,72
W00001060,LL16,"LL16 4RN, LL16 4RW, LL16 4ST, LL16 4SU, LL16 4SY, LL16 4TA, LL16 4TU, LL16 5AA, LL16 5NT, LL16 5NU, LL16 5NY, LL16 5PA, LL16 5RP, LL16 5RW, LL16 5SS, LL16 5UP, LL16 5UR",210,121,89
W00001326,LL16,"LL16 5TZ, LL16 5UF, LL16 5UW, LL17 0BF, LL17 0BP, LL17 0BS, LL17 0BT, LL17 0BW, LL17 0UU, LL17 0YE, LL17 0YP, LL17 0YR, LL17 0ZA",248,162,86
W00001058,LL16,"LL16 3PY, LL16 3RP, LL16 3RR, LL16 3RS, LL16 3RU, LL16 3RW, LL16 3RX, LL16 3RZ",338,274,64
W00001057,LL16,"LL16 3PG, LL16 3PR, LL16 3PS, LL16 3PT, LL16 3PU, LL16 3RF",352,257,95
W00001056,LL16,"LL16 3LH, LL16 3PE, LL16 3PF, LL16 3PH, LL16 3PL, LL16 3RB, LL16 3RD, LL16 3RE, LL16 3SB",181,145,36
W00001099,LL16,"LL16 4HA, LL16 4HD, LL16 4HE, LL16 4HF, LL16 4HG, LL16 4HJ, LL16 4HX, LL16 4YG",317,235,82
W00001055,LL16,"LL16 3RA, LL16 3RH, LL16 3RL, LL16 3RN, LL16 3RT",271,216,55
W00001098,LL16,"LL16 4EW, LL16 4EY, LL16 4HB, LL16 4LE, LL16 4LR, LL16 4LU, LL16 4LW, LL16 4NA, LL16 4NB, LL16 4ND",413,309,104
W00001097,LL16,"LL16 4ET, LL16 4EU, LL16 4HH, LL16 4HL, LL16 4HN, LL16 4HP, LL16 4HR, LL16 4HW, LL16 4LA, LL16 4LS, LL16 4LT, LL16 4LY",344,207,137
W00001047,LL16,"LL16 4AB, LL16 4AP, LL16 4AX, LL16 4AZ, LL16 4BB, LL16 4PY, LL16 4RA, LL16 4RB, LL16 4RE, LL16 4RF, LL16 4RJ, LL16 4RQ, LL16 4SS, LL16 4YB, LL16 4YF, LL16 4YP",315,172,143
W00001061,LL16,"LL16 3YG, LL16 3YJ, LL16 3YY",290,246,44
W00001048,LL16,"LL16 3HH, LL16 3HJ, LL16 3HP, LL16 3HR, LL16 3HW, LL16 3JQ, LL16 3JR, LL16 3JU",337,212,125
W00001050,LL16,"LL16 3EB, LL16 3EY, LL16 3HD, LL16 3HF, LL16 3HG, LL16 3HU, LL16 3JP",360,215,145
W00000647,LL16,"LL16 5LE, LL22 8AJ, LL22 8BJ, LL22 8RT, LL22 8RU, LL22 8RY, LL22 8SD, LL22 8SE, LL22 8SG, LL22 8SP, LL22 8SR, LL22 8SS, LL22 8ST, LL22 8SU, LL22 8SW, LL22 8SX, LL22 8SY, LL22 8TA, LL22 8TB, LL22 8TF, LL22 8TG, LL22 8TL, LL22 8TN, LL22 8TR, LL22 8TS, LL22 8TT, LL22 8TW, LL22 8YS, LL22 8YT",308,170,138
W00001051,LL16,"LL16 3EU, LL16 3EZ, LL16 3HA, LL16 3HE, LL16 4AE, LL16 4AU, LL16 4AY, LL16 4PQ, LL16 4PZ",335,160,175
W00001052,LL16,"LL16 3HL, LL16 3HN, LL16 3HT, LL16 4AF, LL16 4PT, LL16 4PU, LL16 4YU",269,141,128
W00001096,LL16,"LL16 4BQ, LL16 4BT, LL16 4BU, LL16 4DD, LL16 4DE, LL16 4DF, LL16 4DR, LL16 4DW, LL16 4EE, LL16 4HS, LL16 4HT, LL16 4HU, LL16 4HY",292,212,80
W00001045,LL16,"LL16 3HX, LL16 3HZ, LL16 3JA, LL16 3JB, LL16 3JD, LL16 3JE, LL16 3JF, LL16 3JS, LL16 5YW",276,198,78
W00001053,LL16,"LL16 4AA, LL16 4AG, LL16 4AH, LL16 4AJ, LL16 4AL, LL16 4AN, LL16 4AT, LL16 4AW, LL16 4BA, LL16 4BD, LL16 4BE",251,142,109
W00001054,LL16,"LL16 4AD, LL16 4AR, LL16 4AS, LL16 4PJ, LL16 4PX, LL16 4RG",242,169,73
W00001328,LL16,"LL16 4UD, LL16 4UE, LL16 4UF, LL16 4UG, LL16 4UP, LL16 4US, LL16 5AG, LL16 5TY, LL16 5UA, LL16 5UB, LL16 5UD, LL16 5UE, LL16 5UG, LL16 5UH, LL16 5UJ, LL16 5UL, LL16 5YP, LL17 0BN, LL17 0HN",301,207,94
W00001329,LL16,"LL16 4UN, LL16 4UT, LL16 4UU, LL16 4YE, LL16 4YH, LL16 4YJ, LL16 4YL, LL16 5TU, LL17 0BQ, LL17 0YA",352,266,86
W00001049,LL16,"LL16 3DF, LL16 3DR, LL16 3EH, LL16 3EL, LL16 3ER, LL16 3ES, LL16 3EX, LL16 3HB, LL16 3JG",295,195,100
W00001331,LL16,"LL16 4BP, LL16 4BS, LL16 4BY, LL16 4DA, LL16 4DB, LL16 4DG, LL16 4DH, LL16 4DJ, LL16 4DL, LL16 4DN, LL16 4DP, LL16 4DS, LL16 4DT, LL16 4DU, LL16 4DY, LL16 4EA, LL16 4EB, LL16 4ED, LL16 4EF, LL16 4EG, LL16 4EH, LL16 4EL, LL16 4EN",373,296,77
W00001062,LL16,"LL16 3PN, LL16 3PW, LL16 3TP, LL16 3YS, LL16 3YT, LL16 3YU",231,169,62
W00001064,LL16,"LL16 5AN, LL16 5AP, LL16 5AR, LL16 5AS, LL16 5AT, LL16 5BQ, LL16 5BX, LL16 5DB, LL16 5YA, LL16 5YL",313,171,142
W00001044,LL16,"LL16 3DJ, LL16 3DQ, LL16 3DX, LL16 5UT, LL16 5UY, LL16 5YF",359,231,128
W00001043,LL16,"LL16 3AL, LL16 3BG, LL16 3DT, LL16 3DW, LL16 3EA, LL16 3ED, LL16 3EF, LL16 3EG, LL16 3TQ, LL16 5SJ, LL16 5SU, LL16 5SY, LL16 5TA, LL16 5TF, LL16 5TG, LL16 5TH, LL16 5TL, LL16 5TQ, LL16 5TS, LL16 5TX, LL16 5US, LL16 5YD",286,182,104
W00001042,LL16,"LL16 4BN, LL16 4BW, LL16 4ER, LL16 4ES, LL16 4PP, LL16 4RD, LL16 4RH, LL16 4RL, LL16 4RX, LL16 4UB, LL16 4ZE, LL16 4ZF, LL16 4ZH, LL16 5SR, LL16 5ST, LL16 5TD, LL16 5TJ, LL16 5TN, LL16 5TP, LL16 5TR, LL16 5TT, LL16 5TW, LL16 5UN",377,252,125
W00001041,LL16,"LL16 4BH, LL16 4BL, LL16 5UU, LL16 5YB, LL16 5YG, LL16 5YH, LL16 5YN",293,178,115
W00001040,LL16,"LL16 3AA, LL16 3AB, LL16 3AD, LL16 3AF, LL16 3AG, LL16 3AH, LL16 3AJ, LL16 3AN, LL16 3AS, LL16 3BE, LL16 3BJ, LL16 3BL, LL16 3BQ, LL16 3HQ, LL16 3HY, LL16 3LA, LL16 3LB, LL16 3LE, LL16 3LF, LL16 3ND, LL16 3NE, LL16 3NF, LL16 3NG, LL16 3NL, LL16 3NY, LL16 3RY, LL16 3SA, LL16 3SD, LL16 3SE, LL16 3SF, LL16 3SH, LL16 3SR, LL16 3ST, LL16 3SU, LL16 3SW, LL16 3SX, LL16 3SY, LL16 3SZ, LL16 3TA, LL16 3TB, LL16 3TE, LL16 3TF, LL16 3TG, LL16 3TJ, LL16 3TL, LL16 3TT, LL16 3WB, LL16 3WD, LL16 3WE, LL16 3WF, LL16 3WG, LL16 3WJ, LL16 3WL, LL16 3WY, LL16 3YE, LL16 4AQ, LL16 4YQ, LL16 4ZA, LL16 4ZB, LL16 4ZD, LL16 4ZG, LL16 4ZJ, LL16 4ZT, LL16 4ZU, LL16 5WA, LL16 5WL, LL16 5ZA, LL16 5ZB, LL16 5ZD, LL16 5ZE, LL16 5ZF, LL16 5ZG, LL16 5ZJ, LL16 5ZL, LL16 5ZQ, LL16 5ZU, LL16 9AA, LL16 9AB, LL16 9AD, LL16 9AE, LL16 9AF, LL16 9AG, LL16 9AH, LL16 9AJ, LL16 9AL, LL16 9AN, LL16 9AP, LL16 9AQ, LL16 9AR, LL16 9AS, LL16 9AT, LL16 9AU, LL16 9AW, LL16 9AX, LL16 9AY, LL16 9AZ, LL16 9BA, LL16 9BB, LL16 9BD, LL16 9BE, LL16 9BF, LL16 9BG, LL16 9BH, LL16 9BJ",227,178,49
W00001039,LL16,"LL16 3AP, LL16 3AQ, LL16 3AR, LL16 3BD, LL16 3BH, LL16 3BN, LL16 3BT, LL16 3BU, LL16 3DB, LL16 3DD, LL16 3EJ, LL16 3EN, LL16 3EP, LL16 3NU, LL16 3PA, LL16 3PB, LL16 3SP, LL16 3SS, LL16 3UG, LL16 3UH, LL16 3UL, LL16 3UN, LL16 3UR, LL16 3US, LL16 3UW, LL16 3WA, LL16 3WH, LL16 3ZA, LL16 3ZB",331,248,83
W00000861,LL16,"LL16 5DA, LL16 5DH, LL16 5DL, LL16 5DN, LL16 5DR, LL16 5DT, LL16 5DU, LL16 5DY, LL16 5EE, LL16 5EF, LL16 5EG, LL16 5EH, LL16 5EL, LL16 5EN, LL16 5EP, LL16 5ER, LL16 5ES, LL16 5ET, LL16 5EU, LL16 5EW, LL16 5EY, LL16 5EZ, LL16 5HA, LL16 5HB, LL16 5HD, LL22 8DJ, LL22 9EA",275,114,161
W00000862,LL16,"LL16 5BP, LL16 5DD, LL16 5DE, LL16 5DF, LL16 5DG, LL16 5DP, LL16 5DS, LL16 5DW, LL16 5EA, LL16 5EB, LL16 5ED, LL16 5EQ, LL16 5YE, LL17 0HL, LL17 0HP, LL17 0HW",260,105,155
W00000863,LL16,"LL16 5BU, LL16 5BY, LL16 5BZ, LL16 5HU, LL16 5HW, LL16 5HY, LL16 5LA, LL16 5LB, LL16 5LU, LL16 5NA, LL16 5NG, LL16 5NH, LL16 5NL, LL16 5NN, LL16 5NP, LL16 5NR, LL16 5NW, LL16 5SA, LL16 5SE, LL16 5SG, LL16 5SH, LL16 5SL, LL22 8TP",337,147,190
W00000864,LL16,"LL16 5HE, LL16 5HF, LL16 5HG, LL16 5HH, LL16 5HJ, LL16 5HL, LL16 5HN, LL16 5HP, LL16 5HQ, LL16 5HT, LL16 5HX, LL16 5HZ, LL16 5LD, LL16 5LJ, LL22 8TU",299,87,212
W00001063,LL16,"LL16 5AB, LL16 5AD, LL16 5AE, LL16 5AF, LL16 5AX, LL16 5BA, LL16 5BB, LL16 5BD, LL16 5BE, LL16 5BF, LL16 5BG, LL16 5BH, LL16 5BJ, LL16 5BS, LL16 5BW",234,140,94
W00001038,LL16,"LL16 3AU, LL16 3AW, LL16 3AY, LL16 3BB, LL16 3BS, LL16 3BW, LL16 3BX, LL16 3BY, LL16 3BZ, LL16 3DA, LL16 3DE, LL16 3EW, LL16 3FD, LL16 3GA, LL16 3UT, LL16 3UU, LL16 3UX, LL16 3UY, LL16 3UZ, LL16 3YA",344,254,90
W00000865,LL16,"LL16 5BL, LL16 5BN, LL16 5BT, LL16 5LS, LL16 5PB, LL16 5PD, LL16 5PR, LL16 5PT, LL16 5RR, LL16 5RS, LL16 5RT, LL16 5RU, LL16 5RY, LL16 5SB, LL16 5SD, LL16 5SF, LL16 5SN, LL16 5YR, LL16 5YT, LL16 5YU, LL16 5ZH",310,159,151
W00000866,LL16,"LL16 5HR, LL16 5HS, LL16 5LF, LL16 5LG, LL16 5LH, LL16 5LL, LL16 5LN, LL16 5LP, LL16 5LR, LL16 5LT, LL16 5LW, LL16 5LY, LL16 5NB, LL16 5ND, LL16 5NE, LL16 5NF, LL16 5NS, LL16 5SW, LL22 8YG",288,105,183
W00001036,LL16,"LL16 3PJ, LL16 3TD, LL16 3TR, LL16 3TS, LL16 3TW, LL16 3YP, LL16 3YQ",249,163,86
W00001035,LL16,"LL16 3LD, LL16 3LY, LL16 3NB, LL16 3NH, LL16 3NP, LL16 3NR, LL16 3NS, LL16 3SG, LL16 3SN",256,181,75
W00001034,LL16,"LL16 3AE, LL16 3LJ, LL16 3LL, LL16 3LT, LL16 3LU, LL16 3NA, LL16 3NN, LL16 3NW",236,180,56
W00001125,LL16,"LL16 4NE, LL16 4NL, LL16 4NN, LL16 4NR, LL16 4NS, LL16 4NT, LL16 4YN",244,132,112
W00001126,LL16,"LL16 4NG, LL16 4NH, LL16 4NP, LL16 4NW, LL16 4PH, LL16 4PL, LL16 4RP, LL16 4RR, LL16 4RS, LL16 4RT, LL16 4RU, LL16 4RY, LL16 4SD, LL16 4SE",246,147,99
W00001127,LL16,"LL16 4NF, LL16 4NU, LL16 4PD, LL16 4PE, LL16 4PG, LL16 4PR, LL16 4PW, LL16 4YW, LL16 4YZ",223,116,107
W00001128,LL16,"LL16 4TB, LL16 4TF, LL16 4TG, LL16 4TW, LL16 5PE, LL16 5PF, LL16 5PG, LL16 5PH, LL16 5PL, LL16 5PN, LL16 5PP, LL16 5PS, LL16 5PU, LL16 5PW, LL16 5PX, LL16 5PY, LL16 5RA, LL16 5RB, LL16 5RD, LL16 5RE, LL16 5RF, LL16 5RG, LL16 5RH, LL16 5RL, LL16 5RN, LL16 5SP",288,167,121
W00001065,LL16,"LL16 5AH, LL16 5AJ, LL16 5AL, LL16 5AQ, LL16 5AU, LL16 5AW, LL16 5AY, LL16 5AZ",284,187,97
W00001037,LL16,"LL16 3AT, LL16 3PQ, LL16 3TU, LL16 3TY, LL16 3UA, LL16 3UB, LL16 3UD, LL16 3UE, LL16 3UF, LL16 3UJ, LL16 3UP, LL16 3YB, LL16 3YD, LL16 3YF, LL16 3YH, LL16 3YL, LL16 3YN, LL16 3YR, LL16 3YW",208,145,63
W00001330,LL16,"LL16 4UA, LL16 4UH, LL16 4UJ, LL16 4UL, LL16 4UQ, LL16 4UR, LL16 4UW, LL16 4UY, LL16 4WA, LL16 4YA, LL16 4YD",254,197,57
W00001327,LL17,"LL17 0AZ, LL17 0BB, LL17 0BD, LL17 0BE, LL17 0BG, LL17 0BJ, LL17 0BL, LL17 0BX, LL17 0BZ, LL17 0UY",276,191,85
W00001265,LL17,"LL17 0WA, LL17 0WB, LL17 0WE, LL17 0WF, LL17 0WG, LL17 0WH, LL17 0WP, LL17 0WQ, LL17 0WS, LL17 0WT, LL17 0WZ, LL18 1AA, LL18 1JP, LL18 1JU, LL18 1WR, LL18 1WU, LL18 1WW, LL18 1WX, LL18 1XY, LL18 1YZ, LL18 1ZA, LL18 1ZB, LL18 1ZE, LL18 1ZF, LL18 1ZG, LL18 1ZL, LL18 1ZN, LL18 1ZR, LL18 1ZT, LL18 1ZU, LL18 2BP, LL18 2BZ, LL18 2DF, LL18 2DG, LL18 2DH, LL18 2DL, LL18 2DS, LL18 2DT, LL18 2DU, LL18 2WZ, LL18 2ZA, LL18 2ZB, LL18 2ZD, LL18 2ZE, LL18 2ZF, LL18 2ZG, LL18 2ZH, LL18 2ZJ, LL18 2ZN, LL18 2ZR, LL18 2ZS, LL18 2ZT, LL18 3WY, LL18 3WZ, LL18 3YA, LL18 3YR, LL18 3ZA, LL18 3ZB, LL18 3ZD, LL18 3ZE, LL18 3ZF, LL18 3ZL, LL18 3ZN, LL18 3ZP, LL18 3ZQ, LL18 3ZR, LL18 3ZU, LL18 4NT, LL18 4NY, LL18 4PD, LL18 4WA, LL18 4WE, LL18 4WF, LL18 4WG, LL18 4WH, LL18 4WJ, LL18 4WL, LL18 4WN, LL18 4WR, LL18 4WT, LL18 4WU, LL18 4WW, LL18 4WX, LL18 4WY, LL18 4WZ, LL18 4ZW, LL18 4ZY, LL18 5WA, LL18 5XD, LL18 5YY, LL18 5YZ, LL18 5ZA, LL18 5ZB, LL18 5ZD, LL18 5ZE, LL18 5ZF, LL18 5ZQ, LL18 5ZR, LL18 5ZS, LL18 5ZT, LL18 5ZU, LL18 5ZW, LL18 6WA, LL18 6WZ, LL18 6ZA, LL18 6ZB, LL18 6ZD, LL18 6ZF, LL18 6ZG, LL18 6ZH, LL18 6ZJ, LL18 6ZU, LL18 9AD, LL18 9AE, LL18 9AF, LL18 9AH, LL18 9AJ, LL18 9AL, LL18 9AN, LL18 9AP, LL18 9AQ, LL18 9AR, LL18 9AS, LL18 9AT, LL18 9AU, LL18 9AW, LL18 9AX, LL18 9AY, LL18 9AZ, LL18 9BA, LL18 9BB, LL18 9BD, LL18 9BE, LL18 9BF, LL18 9BG, LL18 9BH, LL18 9BJ, LL18 9BL, LL18 9BN, LL18 9BP, LL18 9BQ, LL18 9BR, LL18 9BS, LL18 9BT, LL18 9BU, LL18 9BW, LL18 9BX, LL18 9BY, LL18 9BZ, LL18 9DA, LL18 9DB, LL18 9DD, LL18 9DE, LL18 9DF, LL18 9DG, LL18 9DH, LL18 9DJ, LL18 9DL, LL18 9DN, LL18 9DP, LL18 9DQ, LL18 9DR, LL18 9DS, LL18 9DT, LL18 9DU, LL18 9DW, LL18 9DY, LL18 9DZ, LL18 9EA, LL18 9EB, LL18 9ED, LL18 9EE, LL18 9EF, LL18 9EG, LL18 9EH, LL18 9EJ, LL18 9EL, LL18 9EN, LL18 9EP, LL18 9EQ, LL18 9ER, LL18 9ES, LL18 9ET, LL18 9EU, LL18 9EW, LL18 9EX, LL18 9EY, LL18 9EZ, LL18 9FA, LL18 9FB, LL18 9FD, LL18 9FE, LL18 9FF, LL18 9FG, LL18 9FH, LL18 9FJ, LL18 9FL, LL18 9FN, LL18 9FP, LL18 9FQ, LL18 9FR, LL18 9FS, LL18 9FT, LL18 9FU, LL18 9FW, LL18 9FX, LL18 9FY, LL18 9GA, LL18 9GB, LL18 9GD, LL18 9GE, LL18 9GG, LL18 9GH, LL18 9GJ, LL18 9GL, LL18 9GN, LL18 9GP, LL18 9GQ, LL18 9GR, LL18 9GS, LL18 9GT, LL18 9GU, LL18 9GW, LL18 9GX, LL18 9GY, LL18 9GZ, LL18 9HA, LL18 9HB, LL18 9HD, LL18 9HE, LL18 9HF, LL18 9HG, LL18 9HH, LL18 9HJ, LL18 9HL, LL18 9HN, LL18 9HP, LL18 9HQ, LL18 9HR, LL18 9HS, LL18 9HT, LL18 9HU, LL18 9HW, LL18 9HX, LL18 9HY, LL18 9HZ, LL18 9JA, LL18 9JB, LL18 9JD, LL18 9JE, LL18 9JF, LL18 9JG, LL18 9JH, LL19 0AN, LL19 0BD, LL19 0BH, LL19 0BJ, LL19 0BL, LL19 0BN, LL19 0BP, LL19 0BQ, LL19 0BR, LL19 0BS, LL19 0BT, LL19 7WB, LL19 7WW, LL19 7XB, LL19 9YR, LL19 9ZE, LL19 9ZR, LL19 9ZT, LL22 7WU, LL22 7XP, LL22 7ZA, LL22 7ZD, LL22 7ZE, LL22 7ZJ, LL22 7ZN, LL22 7ZS, LL22 8BF, LL22 8HX, LL22 8WZ, LL22 8YZ, LL22 8ZA, LL22 8ZB, LL22 8ZD, LL22 8ZE, LL22 8ZF, LL22 8ZG, LL22 8ZH, LL22 8ZL, LL22 8ZN, LL22 8ZQ, LL22 8ZR, LL22 8ZS, LL22 8ZT, LL22 8ZU, LL22 8ZW, LL22 8ZY, LL22 9WE, LL22 9WF, LL22 9WH, LL22 9WJ, LL22 9WL, LL22 9WN, LL22 9WQ, LL22 9WW, LL22 9WZ, LL22 9ZN, LL22 9ZR, LL22 9ZU",347,292,55
W00001333,LL17,"LL17 0AP, LL17 0AR, LL17 0AS, LL17 0AT, LL17 0AU, LL17 0AW, LL17 0AY, LL17 0EE, LL17 0TA, LL17 0TD, LL17 0TG, LL17 0TR, LL17 0UD, LL17 0UN, LL17 0UP, LL17 0UW, LL17 0WJ",340,229,111
W00001335,LL17,"LL17 0AA, LL17 0AB, LL17 0AD, LL17 0AE, LL17 0AG, LL17 0AH, LL17 0AN, LL17 0DS, LL17 0DT, LL17 0DU, LL17 0DY, LL18 5RT",224,152,72
W00001332,LL17,"LL17 0AL, LL17 0TP, LL17 0TT, LL17 0TY, LL18 5RU, LL18 5RY, LL18 5SD, LL18 5SE, LL18 5SF, LL18 5SG, LL18 5SH, LL18 5SL, LL18 5SN, LL18 6EE, LL18 6HT, LL18 6HU",336,247,89
W00001325,LL17,"LL17 0EN, LL17 0EP, LL17 0ET, LL17 0EU, LL17 0EW, LL17 0EY, LL17 0HA, LL17 0HB, LL17 0HD, LL17 0HE, LL17 0HF, LL17 0HG, LL17 0HH, LL17 0HR, LL17 0LJ, LL17 0LL, LL22 9DG, LL22 9DP, LL22 9DR, LL22 9DS, LL22 9DT, LL22 9DW, LL22 9EB, LL22 9ED",350,253,97
W00001317,LL17,"LL17 0DD, LL17 0DE, LL17 0DF, LL17 0DG, LL17 0DH, LL17 0DJ, LL17 0DP, LL17 0DQ, LL17 0DW, LL17 0DX, LL17 0DZ, LL17 0LB",332,243,89
W00001323,LL17,"LL17 0LH, LL17 0NN, LL17 0NR, LL17 0NS, LL17 0NU, LL17 0NX, LL17 0PE",287,240,47
W00001067,LL17,"LL17 0WY, LL18 6AA, LL18 6AF, LL18 6AG, LL18 6DA, LL18 6LN, LL18 6LR, LL18 6LW",283,234,49
W00001324,LL17,"LL17 0HU, LL17 0HX, LL17 0LD, LL17 0LT, LL17 0LU, LL17 0LY, LL17 0NB, LL17 0PJ, LL17 0PR",353,277,76
W00001313,LL17,"LL17 0DA, LL17 0DR, LL17 0RA, LL17 0RD, LL17 0RE, LL17 0RF, LL17 0RG, LL17 0RL, LL17 0RN, LL17 0RQ, LL17 0TW",208,179,29
W00001314,LL17,"LL17 0BH, LL17 0EJ, LL17 0EQ, LL17 0EX, LL17 0EZ, LL17 0LW, LL17 0RP, LL17 0RR, LL17 0RS, LL17 0RT, LL17 0RU, LL17 0RW, LL17 0RX, LL17 0SY, LL17 0WD, LL17 0WL, LL17 0WN",415,308,107
W00001315,LL17,"LL17 0SJ, LL17 0SQ, LL17 0SU, LL17 0SX, LL17 0SZ, LL17 0UA",299,212,87
W00001019,LL17,"LL17 0HQ, LL17 0HT, LL17 0HY, LL17 0JA, LL17 0JB, LL17 0JD, LL17 0JE, LL17 0JG, LL17 0JJ, LL17 0JL, LL17 0LG, LL18 5UG, LL18 5UH, LL18 5UL, LL18 5UP, LL18 5UW, LL18 5UY, LL22 9DD, LL22 9DE, LL22 9DF",184,138,46
W00001318,LL17,"LL17 0AF, LL17 0BU, LL17 0BY, LL17 0DB, LL17 0DL, LL17 0DN, LL17 0RH, LL17 0RY, LL17 0SA, LL17 0SB, LL17 0SF, LL17 0SH, LL17 0SL",302,237,65
W00001319,LL17,"LL17 0LA, LL17 0LE, LL17 0LF, LL17 0LP, LL17 0LQ, LL17 0LS, LL17 0LZ, LL17 0PL, LL17 0PP, LL17 0PT, LL17 0PU, LL17 0PW, LL17 0PX, LL17 0PY",271,220,51
W00001320,LL17,"LL17 0EG, LL17 0NA, LL17 0ND, LL17 0NE, LL17 0NG, LL17 0PG, LL17 0PH, LL17 0PN, LL17 0PS",229,179,50
W00001321,LL17,"LL17 0EA, LL17 0NP, LL17 0NT, LL17 0NW, LL17 0NY, LL17 0PB, LL17 0PD, LL17 0PF",212,181,31
W00001316,LL17,"LL17 0AJ, LL17 0AQ, LL17 0AX, LL17 0SD, LL17 0SE, LL17 0SG, LL17 0SN, LL17 0SP, LL17 0SR, LL17 0SS, LL17 0ST, LL17 0SW, LL17 0TB",239,196,43
W00001322,LL17,"LL17 0EB, LL17 0ED, LL17 0EF, LL17 0EH, LL17 0EL, LL17 0ER, LL17 0ES, LL17 0LN, LL17 0NF, LL17 0NH, LL17 0NL, LL17 0PA",247,218,29
W00010480,LL18,"LL18 4RQ, LL18 4TJ, LL18 4TL",103,84,19
W00010477,LL18,"LL18 4EF, LL18 4FB, LL18 4FR, LL18 4FT, LL18 4FW, LL18 4JB, LL18 4XA",396,342,54
W00010457,LL18,"LL18 4FA, LL18 4FH, LL18 4FJ, LL18 4FL, LL18 4FN, LL18 4FP",453,374,79
W00001071,LL18,"LL18 6BA, LL18 6BB, LL18 6BD, LL18 6BE, LL18 6HG, LL18 6HL",347,282,65
W00001070,LL18,"LL18 6AN, LL18 6AP, LL18 6AR, LL18 6AS, LL18 6AT, LL18 6AW, LL18 6AY, LL18 6BG, LL18 6BJ",273,213,60
W00001069,LL18,"LL18 6EY, LL18 6HA, LL18 6HB, LL18 6HD, LL18 6HE, LL18 6HF",254,225,29
W00010014,LL18,"LL18 6BF, LL18 6BH, LL18 6BN, LL18 6BP, LL18 6BW, LL18 6BX, LL18 6BZ, LL19 8BE, LL19 8BG, LL19 8YA, LL19 8YB, LL19 8YD, LL19 8YH, LL19 8YN",388,321,67
W00010010,LL18,"LL18 6BY, LL18 6DD, LL18 6DE, LL18 6DJ, LL18 6DX, LL18 6LP, LL18 6LS",204,172,32
W00001066,LL18,"LL18 6AE, LL18 6DB, LL18 6EG, LL18 6ES, LL18 6ET, LL18 6EU",283,230,53
W00001017,LL18,"LL18 5TE, LL18 5TJ, LL18 5TP, LL18 5TT, LL18 5UN",204,164,40
W00001018,LL18,"LL18 5WE, LL18 5WF, LL18 5WG, LL18 5WH, LL18 5WJ, LL18 5WL, LL18 5WN",266,203,63
W00001020,LL18,"LL18 5ST, LL18 5SU, LL18 5SX, LL18 5SY, LL18 5TA",258,223,35
W00001021,LL18,"LL18 5TQ, LL18 5TX, LL18 5TY, LL18 5TZ, LL18 5UQ, LL18 5UR, LL18 5US, LL18 5UT, LL18 5UU, LL18 5UX, LL18 5WS, LL18 5XH, LL18 5XW, LL18 5YA, LL18 5YB, LL18 5YD, LL18 5YG",219,196,23
W00001022,LL18,"LL18 5SQ, LL18 5SR, LL18 5TG, LL18 5TH, LL18 5TN, LL18 5TS, LL18 5TW, LL18 5XE, LL18 5XG",184,161,23
W00001024,LL18,"LL18 5SS, LL18 5TB, LL18 5TD, LL18 5TF, LL18 5TL, LL18 5TR, LL18 5WQ",258,233,25
W00001025,LL18,"LL18 5UJ, LL18 5WD, LL18 5WP, LL18 5WR, LL18 5WT",334,285,49
W00001068,LL18,"LL18 6AB, LL18 6AD, LL18 6AH, LL18 6AL, LL18 6BS, LL18 6DF, LL18 6DQ, LL18 6HS, LL18 6LE, LL18 6LF, LL18 6ZE",335,290,45
W00001023,LL18,"LL18 5HS, LL18 5HT, LL18 5LJ, LL18 5SP, LL18 5SW, LL18 5SZ, LL18 5WB, LL18 5XA, LL18 5YR, LL18 5ZG, LL18 5ZH, LL18 5ZJ, LL18 5ZL",118,86,32
W00001211,LL18,"LL18 3NQ, LL18 3NW, LL18 3SF",124,111,13
W00001248,LL18,"LL18 4AU, LL18 4AY, LL18 4BA, LL18 4BB, LL18 4BL, LL18 4BN",204,182,22
W00001280,LL18,"LL18 1HH, LL18 1HL, LL18 1PH, LL18 1PL, LL18 1PY",330,300,30
W00001281,LL18,"LL18 1HE, LL18 1HF, LL18 1HG, LL18 1PD, LL18 1RU, LL18 1SJ, LL18 1SR, LL18 1SS, LL18 1ST, LL18 1SY, LL18 1TA, LL18 1TB, LL18 1TD, LL18 1TE, LL18 1TF, LL18 1TL",200,179,21
W00001282,LL18,"LL18 1LS, LL18 1LT, LL18 1LZ",200,189,11
W00001283,LL18,"LL18 1BF, LL18 1HN, LL18 1HZ, LL18 1LG, LL18 1PR, LL18 1PT, LL18 1PU, LL18 1RA, LL18 1RB, LL18 1RF, LL18 1UJ",419,380,39
W00001284,LL18,"LL18 1AB, LL18 1AD, LL18 1AE, LL18 1AH, LL18 1AL, LL18 1AN, LL18 1AP, LL18 1AS, LL18 1AT, LL18 1AU, LL18 1AX, LL18 1AY, LL18 1AZ, LL18 1BA, LL18 1BB, LL18 1BD, LL18 1BG, LL18 1BH, LL18 1BL, LL18 1BN, LL18 1BQ, LL18 1BW, LL18 1BX, LL18 1ET, LL18 1EU, LL18 1HA, LL18 1HB, LL18 1LD, LL18 1RG, LL18 1RH, LL18 1RL, LL18 1RN, LL18 1RP, LL18 1RR, LL18 1RS, LL18 1RY, LL18 1SA, LL18 1SB, LL18 1SF, LL18 1SG, LL18 1SH, LL18 1SL, LL18 1SN, LL18 1SP, LL18 1SU, LL18 1SW, LL18 1SX, LL18 1TH, LL18 1TP, LL18 1TQ, LL18 1TR, LL18 1TS, LL18 1TT, LL18 1TU, LL18 1TW, LL18 1TX, LL18 1TY, LL18 1TZ, LL18 1UA, LL18 1UB, LL18 1UD, LL18 1UE, LL18 1UF, LL18 1UG, LL18 1UH, LL18 1UP, LL18 1UQ, LL18 1UR, LL18 1UU, LL18 1WY, LL18 3BS, LL18 3BT, LL18 3BU, LL18 3HE, LL18 3LA, LL18 3LB, LL18 3LD, LL18 3LE, LL18 3LG, LL18 3LH, LL18 3LL, LL18 3LN, LL18 3PY",319,286,33
W00001072,LL18,"LL18 6AU, LL18 6AX, LL18 6BQ, LL18 6HH, LL18 6HN, LL18 6HP, LL18 6HR, LL18 6HW",301,239,62
W00001285,LL18,"LL18 1DB, LL18 1DF, LL18 1JN, LL18 1LA, LL18 1LB, LL18 1LF, LL18 1LJ, LL18 1LU, LL18 1LY, LL18 1PB, LL18 1SQ, LL18 1SZ, LL18 1TJ, LL18 1WS, LL18 1ZD, LL18 1ZH, LL18 1ZJ, LL18 1ZP, LL18 1ZQ, LL18 1ZS",256,227,29
W00001286,LL18,"LL18 1AQ, LL18 1DZ, LL18 1EE, LL18 1HP, LL18 1HW, LL18 1JA, LL18 1JB, LL18 1JD, LL18 1JE, LL18 1JH, LL18 1JJ, LL18 1JQ, LL18 1JT, LL18 1JW, LL18 1JX, LL18 1JY, LL18 1JZ, LL18 1LL, LL18 1LN, LL18 1LQ, LL18 1LR, LL18 1NF, LL18 1NG, LL18 1NH, LL18 1NL, LL18 1NN, LL18 1NP, LL18 1NR, LL18 1NS, LL18 1NW, LL18 1UL, LL18 1UN, LL18 1UW",366,335,31
W00001287,LL18,"LL18 1HR, LL18 1HS, LL18 1HT, LL18 1HU, LL18 1HX, LL18 1HY, LL18 1LH, LL18 1RD",458,400,58
W00001288,LL18,"LL18 1DD, LL18 1DE, LL18 1DG, LL18 1DH, LL18 1DL, LL18 1DN, LL18 1LE",357,321,36
W00001289,LL18,"LL18 1DP, LL18 1DR, LL18 1DW, LL18 1LP, LL18 1LW, LL18 1NA, LL18 1NB, LL18 1ND, LL18 1NE",324,281,43
W00001290,LL18,"LL18 1DS, LL18 1DT, LL18 1DU, LL18 1DX, LL18 1DY, LL18 1EA, LL18 1EB, LL18 1ED, LL18 1EG, LL18 1EH, LL18 1EJ, LL18 1EL, LL18 1EX",301,263,38
W00001291,LL18,"LL18 1EN, LL18 1EP, LL18 1EQ, LL18 1ER, LL18 1ES, LL18 1EW, LL18 1HD, LL18 1SD, LL18 1SE, LL18 3AA, LL18 3AB, LL18 3AD, LL18 3AG, LL18 3AH, LL18 3AL, LL18 3DA, LL18 3DB, LL18 3DE, LL18 3EB, LL18 3ED, LL18 3EE, LL18 3EG, LL18 3LF, LL18 3LY",392,348,44
W00001279,LL18,"LL18 1AG, LL18 1AJ, LL18 1AR, LL18 1AW, LL18 1BE, LL18 1BP, LL18 1BS, LL18 1BT, LL18 1BU, LL18 1BY, LL18 1DA, LL18 1UT, LL18 1UX, LL18 1UZ",312,271,41
W00001292,LL18,"LL18 3BJ, LL18 3EY, LL18 3HA, LL18 3HB, LL18 3HD, LL18 3HF, LL18 3LP, LL18 3LR, LL18 3LS, LL18 3LT, LL18 3LW, LL18 3NA",167,152,15
W00001263,LL18,"LL18 2AB, LL18 2AD, LL18 2AH, LL18 2AL, LL18 2AP, LL18 2JN, LL18 2QA",286,262,24
W00001262,LL18,"LL18 2BS, LL18 2BT, LL18 2BU, LL18 2DA, LL18 2DB, LL18 4PA, LL18 4PF, LL18 4RA",333,296,37
W00001261,LL18,"LL18 4HR, LL18 4HS, LL18 4LT, LL18 4LU, LL18 4NB, LL18 4NF, LL18 4NW",302,260,42
W00001260,LL18,"LL18 4LP, LL18 4LR, LL18 4NA, LL18 4ND, LL18 4NE, LL18 4NR, LL18 4NS",328,273,55
W00001259,LL18,"LL18 4ET, LL18 4EY, LL18 4HE, LL18 4HF, LL18 4HL",241,204,37
W00001258,LL18,"LL18 4EW, LL18 4JA, LL18 4JD, LL18 4JF, LL18 4RP, LL18 4RZ",296,266,30
W00001257,LL18,"LL18 4DP, LL18 4DR, LL18 4HD, LL18 4HG, LL18 4HH, LL18 4HN, LL18 4HW, LL18 4WB, LL18 4WP, LL18 4WQ, LL18 4WS",270,237,33
W00001272,LL18,"LL18 2AA, LL18 2BB, LL18 2BD, LL18 2BW, LL18 2BX, LL18 2DY",286,265,21
W00001255,LL18,"LL18 3SS, LL18 4BW, LL18 4BY, LL18 4DA, LL18 4DB, LL18 4DD, LL18 4DE, LL18 4DF, LL18 4DG, LL18 4DH, LL18 4EA",293,245,48
W00001253,LL18,"LL18 4DJ, LL18 4DL, LL18 4DT, LL18 4DU, LL18 4DX, LL18 4EE, LL18 4EG, LL18 4EH, LL18 4EL, LL18 4EX, LL18 4FD, LL18 4FG, LL18 4XB, LL18 4ZR, LL18 4ZS",484,398,86
W00001252,LL18,"LL18 4DQ, LL18 4DZ, LL18 4EJ, LL18 4GD, LL18 4JT, LL18 4JU, LL18 4NZ, LL18 4RW",229,204,25
W00001251,LL18,"LL18 4AE, LL18 4AH, LL18 4AN, LL18 4AQ, LL18 4AR, LL18 4BS, LL18 4RG, LL18 4RH",232,201,31
W00001250,LL18,"LL18 4BQ, LL18 4EQ, LL18 4EZ, LL18 4FY, LL18 4FZ, LL18 4GB, LL18 4GH, LL18 4GJ",336,281,55
W00001293,LL18,"LL18 1NT, LL18 1NU, LL18 1NY, LL18 1PA, LL18 1PE, LL18 1PF, LL18 1PN, LL18 1TG",156,145,11
W00001249,LL18,"LL18 4AA, LL18 4AB, LL18 4AL, LL18 4AP, LL18 4AS, LL18 4AT, LL18 4AW, LL18 4RF",361,299,62
W00001278,LL18,"LL18 1PG, LL18 1PP, LL18 1PS, LL18 1PW",133,116,17
W00001276,LL18,"LL18 2AJ, LL18 2AT, LL18 2AU, LL18 2AY, LL18 2JH, LL18 2JJ, LL18 2JL, LL18 2JP",354,321,33
W00001271,LL18,"LL18 2AE, LL18 2AF, LL18 2AG, LL18 2AN, LL18 2AR, LL18 2AS, LL18 2AW",346,316,30
W00000802,LL18,"LL18 5LN, LL18 5LP, LL18 5LW",333,299,34
W00000803,LL18,"LL18 5EJ, LL18 5HJ, LL18 5HN, LL18 5HX, LL18 5JJ, LL18 5JT",280,247,33
W00000804,LL18,"LL18 5GZ, LL18 5HA, LL18 5HB, LL18 5HP, LL18 5HR, LL18 5JA, LL18 5JH, LL18 5JW, LL18 5JX, LL18 5JY, LL18 5JZ, LL18 5TU, LL22 9SB, LL22 9SD, LL22 9SL",377,324,53
W00001270,LL18,"LL18 2AQ, LL18 2BY, LL18 2DD, LL18 2DE, LL18 2DW, LL18 2EG, LL18 2EH, LL18 2EW",277,248,29
W00001269,LL18,"LL18 2PF, LL18 4AG, LL18 4PL, LL18 4PN, LL18 4PP, LL18 4PR, LL18 4PS, LL18 4PT, LL18 4PW",384,326,58
W00000805,LL18,"LL18 5EX, LL18 5FN, LL18 5FT, LL18 5HH, LL18 5HW, LL18 5JG",263,227,36
W00000806,LL18,"LL18 5AU, LL18 5AY, LL18 5DG, LL18 5DH, LL18 5DL, LL18 5DN, LL18 5DQ, LL18 5EN, LL18 5EZ",263,241,22
W00000807,LL18,"LL18 5BD, LL18 5BJ, LL18 5BP, LL18 5BQ, LL18 5BW, LL18 5EP",242,209,33
W00000808,LL18,"LL18 5ED, LL18 5NA, LL18 5NE, LL18 5NF, LL18 5NG, LL18 5NH, LL18 5NL, LL18 5NN, LL18 5NS, LL18 5NW",256,243,13
W00000809,LL18,"LL18 5BB, LL18 5BT, LL18 5DA, LL18 5DE, LL18 5DJ, LL18 5EE, LL18 5EQ, LL18 5LR, LL18 5NP, LL18 5NU, LL18 5NY",299,266,33
W00000810,LL18,"LL18 5BE, LL18 5BZ, LL18 5FA, LL18 5FJ, LL18 5FL, LL18 5JB, LL18 5JD, LL18 5JE",250,215,35
W00000811,LL18,"LL18 5LS, LL18 5LT, LL18 5NB, LL18 5ND, LL18 5NJ, LL18 5NR, LL18 5NT, LL18 5PA",255,234,21
W00001277,LL18,"LL18 2BA, LL18 2BE, LL18 2BG, LL18 2BH, LL18 2BL, LL18 2BN, LL18 2EA, LL18 2EB, LL18 2EE, LL18 2HH",430,386,44
W00000812,LL18,"LL18 5DP, LL18 5DR, LL18 5DT, LL18 5DW, LL18 5DY, LL18 5EF, LL18 5LU",243,227,16
W00000814,LL18,"LL18 4PJ, LL18 5DS, LL18 5DU, LL18 5EA, LL18 5EH, LL18 5HU, LL18 5HY, LL18 5LF, LL18 5LG, LL18 5LQ, LL18 5LY, LL18 5LZ",404,356,48
W00000815,LL18,"LL18 5LA, LL18 5LB, LL18 5LD, LL18 5LE, LL18 5LH, LL18 5LL, LL18 5NQ",261,236,25
W00000800,LL18,"LL18 5FG, LL18 5FQ, LL18 5FS, LL18 5FW, LL18 5FX, LL18 5FY, LL18 5FZ, LL18 5HF, LL18 5HG, LL18 5JP, LL18 5JQ, LL18 5JR",558,480,78
W00000799,LL18,"LL18 5AZ, LL18 5BS, LL18 5BY, LL18 5DB, LL18 5DD, LL18 5JF",286,248,38
W00001268,LL18,"LL18 4DW, LL18 4EP, LL18 4ER, LL18 4HA, LL18 4HB, LL18 4RR, LL18 4RU, LL18 4SA",302,250,52
W00001267,LL18,"LL18 2PG, LL18 2PH, LL18 2PL, LL18 4AD, LL18 4AF, LL18 4BT, LL18 4RS, LL18 4RT, LL18 4RY",334,295,39
W00000798,LL18,"LL18 5AR, LL18 5AS, LL18 5AT, LL18 5AX, LL18 5BA, LL18 5BG, LL18 5BH, LL18 5BL, LL18 5BN, LL18 5BU, LL18 5BX, LL18 5DF, LL18 5EL, LL18 5EW",341,309,32
W00000797,LL18,"LL18 5EY, LL18 5FE, LL18 5FF, LL18 5FH, LL18 5FR, LL18 5HL, LL18 5LX",322,279,43
W00001266,LL18,"LL18 4NU, LL18 4PB, LL18 4PE, LL18 4PG, LL18 4PH, LL18 4PU, LL18 4PY, LL18 4RB, LL18 4RD, LL18 4RE, LL18 4RN",379,334,45
W00001264,LL18,"LL18 2AZ, LL18 2EU, LL18 2EZ, LL18 2HD, LL18 2HE, LL18 2HF, LL18 2HG, LL18 2HP, LL18 2HR, LL18 2HW, LL18 2YR",289,241,48
W00001273,LL18,"LL18 1XA, LL18 1XB, LL18 2DN, LL18 2DP, LL18 2DR, LL18 2ED, LL18 2EF, LL18 2EL, LL18 2EP, LL18 2ES, LL18 2QD",322,283,39
W00001274,LL18,"LL18 2ER, LL18 2HL, LL18 2HN, LL18 2PE",369,324,45
W00001275,LL18,"LL18 2EJ, LL18 2EN, LL18 2ET, LL18 2EY, LL18 2HA, LL18 2HB, LL18 2HS, LL18 2HX, LL18 2PD, LL18 2PX",300,269,31
W00000813,LL18,"LL18 5BF, LL18 5EB, LL18 5EG, LL18 5ER, LL18 5ES, LL18 5ET, LL18 5EU, LL18 5FB, LL18 5FD, LL18 5HD, LL18 5HE, LL18 5HQ, LL18 5JU",275,248,27
W00001247,LL18,"LL18 4BD, LL18 4BE, LL18 4BG, LL18 4BH, LL18 4BP, LL18 4BU, LL18 4JH, LL18 4JL, LL18 4JN",206,186,20
W00001256,LL18,"LL18 4DN, LL18 4DS, LL18 4EN, LL18 4HP, LL18 4HT, LL18 4JS",262,224,38
W00001245,LL18,"LL18 4AJ, LL18 4AX, LL18 4HJ, LL18 4JG, LL18 4JR",248,201,47
W00001219,LL18,"LL18 3BB, LL18 3BG, LL18 3BH, LL18 3BN, LL18 3TT, LL18 3UA, LL18 3UD",190,174,16
W00001218,LL18,"LL18 3PP, LL18 3PR, LL18 3TU, LL18 3TY, LL18 3UF, LL18 3UG",220,203,17
W00001217,LL18,"LL18 3AY, LL18 3BA, LL18 3BE, LL18 3BF, LL18 3BW, LL18 3UB, LL18 3UE",244,224,20
W00001216,LL18,"LL18 3PT, LL18 3RE, LL18 3TP, LL18 3TW, LL18 3UH, LL18 3US, LL18 3UT, LL18 3UU, LL18 3YE, LL18 3YF, LL18 3YG, LL18 3YH, LL18 3YL, LL18 3YN, LL18 3YQ, LL18 3YW, LL18 3ZH",290,259,31
W00001246,LL18,"LL18 4BJ, LL18 4FE, LL18 4FF, LL18 4HQ, LL18 4JE, LL18 4JJ, LL18 4JP, LL18 4JQ, LL18 4JZ, LL18 4LZ",299,250,49
W00001215,LL18,"LL18 3BY, LL18 3DD, LL18 3DF, LL18 3DG, LL18 3DH, LL18 3DL, LL18 3DW, LL18 3DX, LL18 3EF, LL18 3HG, LL18 3HL, LL18 3HR, LL18 3HS, LL18 3HY, LL18 3LU",421,389,32
W00001214,LL18,"LL18 3NL, LL18 3NN, LL18 3NS, LL18 3NT, LL18 3NU, LL18 3PD, LL18 3RP, LL18 3RR",307,257,50
W00001213,LL18,"LL18 3DN, LL18 3DP, LL18 3EN, LL18 3EW, LL18 3HH, LL18 3HN, LL18 3HP, LL18 3HT, LL18 3HU, LL18 3HW, LL18 3NB, LL18 3ND, LL18 3NE, LL18 3NF, LL18 3NH, LL18 3TS",375,333,42
W00001212,LL18,"LL18 3AF, LL18 3AJ, LL18 3AN, LL18 3AP, LL18 3AQ, LL18 3AR, LL18 3AW, LL18 3DQ, LL18 3DR, LL18 3DS, LL18 3DT, LL18 3DU, LL18 3EH, LL18 3EL, LL18 3EP, LL18 3ER, LL18 3ES, LL18 3ET, LL18 3SG, LL18 3YP",550,495,55
W00001210,LL18,"LL18 3RL, LL18 3RN, LL18 3RS, LL18 3RT, LL18 3RW, LL18 3RY, LL18 3SB, LL18 3SE, LL18 3TR, LL18 3ZG, LL18 3ZJ",227,198,29
W00001209,LL18,"LL18 3RU, LL18 3SA, LL18 3SD, LL18 3SU, LL18 3SY, LL18 3TD, LL18 3TE",204,189,15
W00001208,LL18,"LL18 2UE, LL18 2UF, LL18 2UP, LL18 2UR, LL18 2YE, LL18 2YU",217,183,34
W00001207,LL18,"LL18 2UG, LL18 2UH, LL18 2UL, LL18 2UN, LL18 2UW",274,236,38
W00001206,LL18,"LL18 2SG, LL18 2SH, LL18 2SQ, LL18 2YG, LL18 2YH, LL18 2YW, LL18 5AP, LL18 5UD, LL18 5UE, LL18 5UZ",221,186,35
W00001205,LL18,"LL18 2SA, LL18 2SB, LL18 2SD, LL18 2SE, LL18 2SF, LL18 2TD, LL18 2TL, LL18 2YL, LL18 2YN",208,178,30
W00001204,LL18,"LL18 2RU, LL18 2TE, LL18 2TF, LL18 2TG, LL18 2TH, LL18 2TN, LL18 5PD, LL18 6HJ, LL18 6HY, LL18 6HZ, LL18 6JA, LL18 6JB, LL18 6LT",425,339,86
W00001203,LL18,"LL18 4DY, LL18 4QA, LL18 4QB, LL18 4QD, LL18 4QE, LL18 4QF, LL18 4QG, LL18 4QH, LL18 4QJ, LL18 4QL",488,417,71
W00001202,LL18,"LL18 2HJ, LL18 2LS, LL18 2RL, LL18 2RT, LL18 2SP, LL18 2SX, LL18 2SY, LL18 2TB, LL18 2TJ, LL18 2TT, LL18 2YB, LL18 2YD, LL18 5AQ, LL18 5RE, LL18 5RN, LL18 5RS, LL18 5SB, LL18 5UA, LL18 5UB, LL18 5UF, LL18 6BL, LL18 6LA, LL18 6LB, LL18 6LD",341,288,53
W00001201,LL18,"LL18 5PL, LL18 5PQ, LL18 5PT, LL18 5PU, LL18 5RA, LL18 5YE, LL18 5YF, LL18 5YH, LL18 5ZN, LL18 5ZP",218,178,40
W00001200,LL18,"LL18 2UQ, LL18 2US, LL18 2UT, LL18 2UX",214,172,42
W00001199,LL18,"LL18 2TR, LL18 2TU, LL18 2TY, LL18 2TZ, LL18 2UA, LL18 2UB, LL18 2UD, LL18 2UU, LL18 2UY, LL18 2WA, LL18 2WB, LL18 2WD, LL18 2WE, LL18 2YA, LL18 5AD, LL18 5AH, LL18 5AJ, LL18 5AL, LL18 5AN, LL18 5AW",225,184,41
W00001198,LL18,"LL18 5PE, LL18 5PG, LL18 5PN, LL18 5PP, LL18 5PW, LL18 5RB",321,253,68
W00001197,LL18,"LL18 2TP, LL18 2TQ, LL18 2TS, LL18 2TW, LL18 2TX, LL18 2UJ, LL18 5PF, LL18 5PH, LL18 5SA",215,178,37
W00001196,LL18,"LL18 2RX, LL18 2RY, LL18 2SJ, LL18 2SL, LL18 2SN, LL18 2SR, LL18 2SS, LL18 2ST, LL18 2SU, LL18 2SW, LL18 2TA",234,190,44
W00001195,LL18,"LL18 5AA, LL18 5AB, LL18 5AE, LL18 5AF, LL18 5AG, LL18 5PY, LL18 5RG, LL18 5RH, LL18 5RJ",309,243,66
W00001194,LL18,"LL18 5RD, LL18 5RF, LL18 5RL, LL18 5RP, LL18 5RR, LL18 5RW",286,227,59
W00001816,LL18,"LL18 1YF, LL18 1YH, LL18 1YL, LL18 1YP, LL18 1YR, LL18 1YS, LL18 1YT, LL18 1YW, LL18 1YY, LL18 1ZY, LL18 6BT, LL18 6DL, LL18 6DN, LL18 6DP, LL18 6DR, LL18 6DW, LL18 6DY, LL18 6EA, LL18 6EB, LL18 6EF, LL18 6EH, LL18 6EN",288,222,66
W00001817,LL18,"LL18 6BU, LL18 6DG, LL18 6DH, LL18 6DS, LL18 6DT, LL18 6DU, LL18 6PB, LL18 6PD, LL18 6PE, LL18 6PG, LL18 6WB",277,213,64
W00001818,LL18,"LL18 6EJ, LL18 6EL, LL18 6EP, LL18 6EQ, LL18 6ER, LL18 6EW, LL18 6LG",200,162,38
W00001220,LL18,"LL18 3AE, LL18 3AS, LL18 3AT, LL18 3AU, LL18 3BL, LL18 3BP, LL18 3BQ, LL18 3NR, LL18 3NY, LL18 3PA, LL18 3PB, LL18 3PE, LL18 3PF, LL18 3PG, LL18 3PH, LL18 3PL, LL18 3PU",287,255,32
W00001221,LL18,"LL18 3DJ, LL18 3DY, LL18 3EA, LL18 3EU, LL18 3NG, LL18 3NP, LL18 3RA, LL18 3RB",251,206,45
W00000801,LL18,"LL18 5DX, LL18 5DZ, LL18 5FP, LL18 5HZ, LL18 5JL, LL18 5JN, LL18 5JS",258,231,27
W00001223,LL18,"LL18 3BD, LL18 3PN, LL18 3PW, LL18 3RD, LL18 3RF, LL18 3RG, LL18 3RH, LL18 3SP, LL18 3SR, LL18 3ST, LL18 3TH",305,254,51
W00001244,LL18,"LL18 4LJ, LL18 4LL, LL18 4LN, LL18 4NP, LL18 4NQ",252,218,34
W00001243,LL18,"LL18 4EU, LL18 4NJ, LL18 4NX, LL18 4SE, LL18 4SF, LL18 4SG, LL18 4SN, LL18 4UU, LL18 4WD",265,224,41
W00001242,LL18,"LL18 4LS, LL18 4LW, LL18 4LY, LL18 4NG, LL18 4NH, LL18 4NL, LL18 4NN",305,271,34
W00001241,LL18,"LL18 2PN, LL18 2PR, LL18 2PW, LL18 4ES, LL18 4SB, LL18 4SD",232,208,24
W00001240,LL18,"LL18 4EB, LL18 4ED, LL18 4HU, LL18 4UL",310,252,58
W00001239,LL18,"LL18 4AZ, LL18 4BX, LL18 4BZ, LL18 4HX, LL18 4HZ, LL18 4JX, LL18 4JY, LL18 4LQ, LL18 4LX",336,281,55
W00001238,LL18,"LL18 4GA, LL18 4GE, LL18 4GF, LL18 4GG, LL18 4JW, LL18 4PQ",369,304,65
W00001237,LL18,"LL18 4RJ, LL18 4RL, LL18 4RX, LL18 4SJ, LL18 4SQ, LL18 4SX, LL18 4SZ",267,236,31
W00001236,LL18,"LL18 2HT, LL18 2HU, LL18 2HY, LL18 2LA, LL18 2LD, LL18 2LF, LL18 2PP, LL18 2PT, LL18 2RA, LL18 2RB",337,274,63
W00001235,LL18,"LL18 2LR, LL18 2LT, LL18 2PB, LL18 2RF, LL18 2RH, LL18 4ST, LL18 4SU, LL18 4TG",263,220,43
W00001222,LL18,"LL18 3PS, LL18 3TF, LL18 3TG, LL18 3TL, LL18 3TN",258,231,27
W00001233,LL18,"LL18 4SY, LL18 4TA, LL18 4TB, LL18 4TD, LL18 4TE, LL18 4TF, LL18 4TH, LL18 4TS, LL18 4TT",203,173,30
W00001232,LL18,"LL18 2NP, LL18 2NT, LL18 2NU, LL18 2NW, LL18 2NY, LL18 2PA, LL18 2RD, LL18 2RG, LL18 4SR",253,220,33
W00001231,LL18,"LL18 4SH, LL18 4SL, LL18 4SP, LL18 4SS, LL18 4SW, LL18 4TP, LL18 4TW",312,251,61
W00001234,LL18,"LL18 2LU, LL18 2LY, LL18 2NA, LL18 2ND, LL18 2NF, LL18 2NH, LL18 2NL, LL18 2NN, LL18 2PJ, LL18 2YS, LL18 2ZL, LL18 2ZP, LL18 2ZQ",229,194,35
W00001229,LL18,"LL18 4HY, LL18 4LA, LL18 4LB, LL18 4LD, LL18 4TU, LL18 4TY, LL18 4UA, LL18 4UD, LL18 4UE, LL18 4US",268,232,36
W00001224,LL18,"LL18 3TA, LL18 3TB, LL18 3UL, LL18 3UN, LL18 3UP, LL18 3UR, LL18 3UW",282,242,40
W00001225,LL18,"LL18 2LB, LL18 2LG, LL18 2LJ, LL18 2LQ, LL18 2LX, LL18 2LZ, LL18 2RP, LL18 2RW",237,212,25
W00001226,LL18,"LL18 4LE, LL18 4LF, LL18 4LG, LL18 4LH, LL18 4TN, LL18 4TR",241,192,49
W00001230,LL18,"LL18 2LE, LL18 2LH, LL18 2LL, LL18 2NG, LL18 2NJ, LL18 2NR, LL18 2NS, LL18 2PS, LL18 2PU, LL18 2PY, LL18 2RE, LL18 2YF, LL18 2YP",251,185,66
W00001227,LL18,"LL18 2LN, LL18 2LP, LL18 2LW, LL18 2NB, LL18 2NE, LL18 2RN, LL18 2RR, LL18 2RS",244,218,26
W00001228,LL18,"LL18 4UB, LL18 4UF, LL18 4UG, LL18 4UH, LL18 4UN, LL18 4UP, LL18 4UR",254,222,32
W00001132,LL19,"LL19 8DU, LL19 8RU, LL19 8RY, LL19 8SB, LL19 8SD, LL19 8SE, LL19 8SG, LL19 8SH",270,219,51
W00001597,LL19,"LL19 9SQ, LL19 9TF, LL19 9TG, LL19 9TJ, LL19 9TP, LL19 9TQ, LL19 9TX, LL19 9UB, LL19 9UG, LL19 9UH, LL19 9UL, LL19 9UU, LL19 9WA, LL19 9XA, LL19 9XD",236,196,40
W00001133,LL19,"LL19 8RL, LL19 8RN, LL19 8RT, LL19 8RW, LL19 9RF, LL19 9RH, LL19 9RL",367,286,81
W00001594,LL19,"LL19 9SJ, LL19 9SR, LL19 9SS, LL19 9ST, LL19 9SU, LL19 9SY, LL19 9TA",202,176,26
W00001134,LL19,"LL19 8TJ, LL19 9AA, LL19 9AB, LL19 9AE, LL19 9AU, LL19 9BB, LL19 9BD, LL19 9BE, LL19 9BG, LL19 9BH, LL19 9BN, LL19 9BQ, LL19 9BU, LL19 9BZ, LL19 9DA, LL19 9DB, LL19 9DF, LL19 9DG, LL19 9DH",254,215,39
W00001135,LL19,"LL19 9AT, LL19 9BA, LL19 9BP, LL19 9BW, LL19 9DD, LL19 9DL, LL19 9DN, LL19 9DW, LL19 9NP, LL19 9RT, LL19 9SB, LL19 9SD, LL19 9SF, LL19 9SN",212,185,27
W00001136,LL19,"LL19 8SZ, LL19 8TE, LL19 8TL, LL19 8TN, LL19 8TW",283,239,44
W00001137,LL19,"LL19 7SE, LL19 8EG, LL19 8EQ, LL19 8EX, LL19 8SY, LL19 8TA, LL19 8TB, LL19 8TD, LL19 8TG, LL19 9AW, LL19 9BT",245,215,30
W00001140,LL19,"LL19 8DS, LL19 8DT, LL19 8EB, LL19 8ED, LL19 8EH, LL19 8EJ, LL19 8EL, LL19 8SP, LL19 8SU",246,215,31
W00001130,LL19,"LL19 9BS, LL19 9EW, LL19 9NR, LL19 9PA, LL19 9PD, LL19 9PE, LL19 9PF, LL19 9PH, LL19 9PN, LL19 9PW",316,257,59
W00001129,LL19,"LL19 8RH, LL19 8RR, LL19 8RS, LL19 8SA, LL19 8SF, LL19 8SS, LL19 8ST, LL19 8SW, LL19 9RA, LL19 9RD",318,254,64
W00010013,LL19,"LL19 7UN, LL19 7UQ, LL19 7US",301,250,51
W00010012,LL19,"LL19 7JA, LL19 7TL, LL19 7TN, LL19 7UF, LL19 7UG, LL19 7UH, LL19 7UL",238,210,28
W00010011,LL19,"LL19 8YJ, LL19 8YL, LL19 8YP, LL19 8YQ",258,227,31
W00001592,LL19,"LL19 9TW, LL19 9TY, LL19 9UA, LL19 9UE, LL19 9UF",245,216,29
W00001145,LL19,"LL19 7HJ, LL19 7HP, LL19 7HR, LL19 7HS, LL19 7HT, LL19 7HU, LL19 7HW, LL19 7HX, LL19 7LB, LL19 7LD",210,188,22
W00001144,LL19,"LL19 9EL, LL19 9EN, LL19 9SG, LL19 9SH, LL19 9SL",256,221,35
W00001143,LL19,"LL19 9ES, LL19 9ET, LL19 9EU, LL19 9HG, LL19 9HH, LL19 9HN, LL19 9NE",329,286,43
W00001142,LL19,"LL19 9HQ, LL19 9JZ, LL19 9LN, LL19 9LS, LL19 9LT, LL19 9NG, LL19 9NW",245,198,47
W00001138,LL19,"LL19 8SR, LL19 8TF, LL19 8TH, LL19 8TP, LL19 9DE, LL19 9RU, LL19 9RY, LL19 9SA",281,239,42
W00001139,LL19,"LL19 9NS, LL19 9NT, LL19 9NU, LL19 9NY, LL19 9PB, LL19 9PP, LL19 9PS, LL19 9PT, LL19 9PY, LL19 9SE",302,240,62
W00001141,LL19,"LL19 9BJ, LL19 9LJ, LL19 9LQ, LL19 9LW, LL19 9LX, LL19 9LZ, LL19 9NX",294,266,28
W00001131,LL19,"LL19 9AD, LL19 9PG, LL19 9PL, LL19 9PU, LL19 9RB, LL19 9RE, LL19 9RG, LL19 9RP, LL19 9RW",311,242,69
W00001182,LL19,"LL19 8DB, LL19 8DG, LL19 8TT, LL19 8TU",249,209,40
W00010016,LL19,"LL19 7UJ, LL19 7UT, LL19 7UU, LL19 7UZ, LL19 7YA",231,190,41
W00001164,LL19,"LL19 7PR, LL19 7RB, LL19 7RD, LL19 7RY",222,191,31
W00001166,LL19,"LL19 7RE, LL19 7RF, LL19 7RG, LL19 7RL, LL19 7RN, LL19 7SN, LL19 7UA, LL19 7UB",279,230,49
W00001167,LL19,"LL19 7PU, LL19 7PW, LL19 7PY, LL19 7RA, LL19 7RT, LL19 7RU, LL19 7WR, LL19 7XX",248,223,25
W00001168,LL19,"LL19 7AL, LL19 7BE, LL19 7BL, LL19 7BN, LL19 7DP, LL19 7DR, LL19 7DS, LL19 7DT, LL19 7DU, LL19 7DY, LL19 7EB, LL19 7ED",219,202,17
W00001169,LL19,"LL19 7AD, LL19 7AE, LL19 7AF, LL19 7AG, LL19 7AH, LL19 7AN, LL19 7AP, LL19 7AR, LL19 7AT, LL19 7AU, LL19 7AY, LL19 7BA, LL19 7BB, LL19 7BD, LL19 7BG, LL19 7BH, LL19 7BP, LL19 7BS, LL19 7BW",261,218,43
W00010015,LL19,"LL19 7JG, LL19 7PH, LL19 7PL, LL19 7PN, LL19 7UW, LL19 7UX",265,220,45
W00001171,LL19,"LL19 7DD, LL19 7DE, LL19 7DF, LL19 7EL, LL19 7YP, LL19 7YR, LL19 7YS, LL19 7YT, LL19 7YU, LL19 7YW, LL19 7YY, LL19 7ZZ",223,202,21
W00001172,LL19,"LL19 7AB, LL19 7AS, LL19 7DG, LL19 7DH, LL19 7EF, LL19 7EH",229,205,24
W00001173,LL19,"LL19 7JB, LL19 7JD, LL19 7TD, LL19 7TE, LL19 7TG, LL19 7TP, LL19 7TR, LL19 7TS, LL19 7TU, LL19 7TW, LL19 7TY",525,463,62
W00001174,LL19,"LL19 7ET, LL19 7EU, LL19 7EY, LL19 7LL, LL19 7LN, LL19 7LP, LL19 7LR, LL19 7LS, LL19 7LT, LL19 7LW, LL19 7NQ, LL19 7NX",255,231,24
W00001175,LL19,"LL19 7NE, LL19 7SH, LL19 7SL, LL19 7SW, LL19 7TA, LL19 7TF",245,210,35
W00001176,LL19,"LL19 7NF, LL19 7NG, LL19 7NJ, LL19 7NL, LL19 7NP, LL19 7NW",317,281,36
W00001177,LL19,"LL19 7AQ, LL19 7NH, LL19 7NN, LL19 7SP, LL19 7SR, LL19 7TB, LL19 7TT",294,254,40
W00001178,LL19,"LL19 7AX, LL19 7EA, LL19 7EQ, LL19 7ER, LL19 7ES, LL19 7SA, LL19 7SB, LL19 7SF, LL19 7SG, LL19 8RF",235,214,21
W00001179,LL19,"LL19 7PX, LL19 7RH, LL19 7RJ, LL19 7RQ, LL19 7SJ, LL19 7SS, LL19 7TH, LL19 7UD",207,175,32
W00001180,LL19,"LL19 7PP, LL19 7PS, LL19 7PT, LL19 7ST, LL19 7SU, LL19 7SY, LL19 7UE, LL19 7UP, LL19 7UR, LL19 7ZA, LL19 7ZE, LL19 7ZJ, LL19 7ZL, LL19 7ZN, LL19 7ZQ, LL19 7ZT",237,206,31
W00001193,LL19,"LL19 8BZ, LL19 8DA, LL19 8DE, LL19 8DF, LL19 8DJ, LL19 8DQ, LL19 8DX, LL19 8DZ",206,180,26
W00001192,LL19,"LL19 8BP, LL19 8DD, LL19 8DH, LL19 8DL, LL19 8DN, LL19 8DW, LL19 8ES",219,195,24
W00001191,LL19,"LL19 8AA, LL19 8AB, LL19 8AD, LL19 8AE, LL19 8AG, LL19 8AL, LL19 8AN, LL19 8AU, LL19 8AW, LL19 8AY, LL19 8AZ",284,250,34
W00001190,LL19,"LL19 8BA, LL19 8BB, LL19 8BD, LL19 8BH, LL19 8BL, LL19 8BS, LL19 8BT, LL19 8EA, LL19 8EF",239,210,29
W00001189,LL19,"LL19 8EU, LL19 8EY, LL19 8HA, LL19 8HB, LL19 8HD, LL19 8HE, LL19 8ZF, LL19 8ZH",169,144,25
W00001188,LL19,"LL19 8BN, LL19 8BW, LL19 8DR",181,167,14
W00001187,LL19,"LL19 8BU, LL19 8BY, LL19 8DP",247,207,40
W00001186,LL19,"LL19 8HG, LL19 8HJ, LL19 8HQ, LL19 8HX, LL19 8HY, LL19 8HZ, LL19 8YE",208,176,32
W00001185,LL19,"LL19 8AJ, LL19 8AQ, LL19 8DY, LL19 8EE, LL19 8RP, LL19 8SN",335,275,60
W00001184,LL19,"LL19 8AH, LL19 8HF, LL19 8YF, LL19 8YG",213,181,32
W00001183,LL19,"LL19 8EN, LL19 8EP, LL19 8ER, LL19 8ET, LL19 8EW, LL19 9YE, LL19 9YG, LL19 9YH, LL19 9YN, LL19 9YS, LL19 9YT",235,212,23
W00001163,LL19,"LL19 7AW, LL19 7DJ, LL19 7DL, LL19 7DN, LL19 7DQ, LL19 7EN",204,194,10
W00001162,LL19,"LL19 7AA, LL19 7DA, LL19 7DB, LL19 7EG, LL19 7YH, LL19 7YL, LL19 7YN",225,208,17
W00001170,LL19,"LL19 7RP, LL19 7RR, LL19 7RS, LL19 7UY, LL19 7YB, LL19 7YD, LL19 7YE, LL19 7YF, LL19 7YG, LL19 7YQ",252,227,25
W00001161,LL19,"LL19 8LA, LL19 8NA, LL19 8PN, LL19 8PP, LL19 8PS, LL19 8PT, LL19 8PW, LL19 8QA, LL19 8RD, LL19 8RE",280,216,64
W00001146,LL19,"LL19 0AA, LL19 0AB, LL19 0AD, LL19 0AF, LL19 0AG, LL19 0AH, LL19 0AJ, LL19 0AL, LL19 0AP, LL19 0AQ, LL19 0AR, LL19 0AS, LL19 0AT, LL19 0AU, LL19 0AW, LL19 0AX, LL19 0AY, LL19 0AZ, LL19 0BA, LL19 0BB, LL19 0BE, LL19 0BF, LL19 0BG, LL19 7AJ, LL19 7HA, LL19 7HB, LL19 7HD, LL19 7HF, LL19 7HG, LL19 7HH, LL19 7HL, LL19 7NB, LL19 7WJ, LL19 7WQ, LL19 7WT, LL19 7WU, LL19 7WX, LL19 7WZ, LL19 7ZB, LL19 7ZD, LL19 7ZF, LL19 7ZG, LL19 7ZH, LL19 7ZP, LL19 7ZR, LL19 7ZS, LL19 7ZU, LL19 8YU, LL19 8YW, LL19 8ZA, LL19 8ZB, LL19 8ZD, LL19 8ZE, LL19 8ZG, LL19 8ZJ, LL19 8ZL, LL19 8ZN, LL19 8ZU, LL19 9AF, LL19 9AG, LL19 9LR, LL19 9WZ, LL19 9YD, LL19 9YQ, LL19 9YY, LL19 9ZA, LL19 9ZB, LL19 9ZD, LL19 9ZJ, LL19 9ZP, LL19 9ZS, LL19 9ZU, LL19 9ZW, LL19 9ZY",296,259,37
W00001181,LL19,"LL19 8AF, LL19 8AP, LL19 8AR, LL19 8AS, LL19 8AT, LL19 8TS, LL19 8TY",269,225,44
W00001149,LL19,"LL19 9AH, LL19 9AL, LL19 9AN, LL19 9AP, LL19 9AR, LL19 9AS, LL19 9AY, LL19 9BY, LL19 9DP, LL19 9DT, LL19 9LG, LL19 9LH, LL19 9LL, LL19 9NJ, LL19 9NL, LL19 9NN, LL19 9RR, LL19 9WY",243,209,34
W00001150,LL19,"LL19 9DS, LL19 9DU, LL19 9DY, LL19 9EA, LL19 9EB, LL19 9ED, LL19 9EG, LL19 9EH, LL19 9HB",291,229,62
W00001151,LL19,"LL19 9EE, LL19 9EF, LL19 9EY, LL19 9HA, LL19 9HD, LL19 9HF, LL19 9HL, LL19 9HU, LL19 9YA, LL19 9ZF, LL19 9ZG, LL19 9ZH, LL19 9ZL, LL19 9ZQ",262,226,36
W00001152,LL19,"LL19 7HE, LL19 7HN, LL19 7LA, LL19 7LE, LL19 7LF, LL19 7LG, LL19 7LH, LL19 7NT, LL19 7NU, LL19 7PB, LL19 7PD, LL19 7PE",305,264,41
W00001153,LL19,"LL19 7HY, LL19 7PF, LL19 7PG, LL19 7PJ",192,164,28
W00001147,LL19,"LL19 9HE, LL19 9HJ, LL19 9HP, LL19 9HT, LL19 9HW, LL19 9HY, LL19 9LA, LL19 9LB, LL19 9LE, LL19 9LF",302,246,56
W00001148,LL19,"LL19 9ER, LL19 9HR, LL19 9HS, LL19 9LD, LL19 9LP, LL19 9LU, LL19 9LY, LL19 9NA, LL19 9NB, LL19 9ND, LL19 9NF, LL19 9NH, LL19 9NQ, LL19 9SW",283,235,48
W00001154,LL19,"LL19 7LU, LL19 7ND, LL19 7NR, LL19 7NS, LL19 7NY, LL19 7PA",313,265,48
W00001155,LL19,"LL19 8BF, LL19 8GA, LL19 8HN, LL19 8HP, LL19 8HR, LL19 8HT, LL19 8HU, LL19 8LH, LL19 8LL, LL19 8LP, LL19 8LR, LL19 8LS, LL19 8LW, LL19 8PG",264,237,27
W00001160,LL19,"LL19 8HH, LL19 8HL, LL19 8HW, LL19 8LT, LL19 8LU, LL19 8LY, LL19 8NB, LL19 8PH, LL19 8PL, LL19 8PU, LL19 9RN",270,229,41
W00001156,LL19,"LL19 8LB, LL19 8NF, LL19 8NN, LL19 8NR, LL19 8NW, LL19 8NY, LL19 8PA, LL19 8PX, LL19 8RA",299,257,42
W00001157,LL19,"LL19 8LD, LL19 8LE, LL19 8LG, LL19 8LN, LL19 8ND",263,228,35
W00001158,LL19,"LL19 8LF, LL19 8NP, LL19 8NQ, LL19 8NS, LL19 8PJ, LL19 8PR, LL19 8PY, LL19 8PZ, LL19 8RB",262,215,47
W00001159,LL19,"LL19 8NE, LL19 8NG, LL19 8NH, LL19 8NL, LL19 8NT, LL19 8NU, LL19 8PB, LL19 8PD, LL19 8PE, LL19 8PF, LL19 8PQ",310,259,51
W00001916,LL20,"LL20 7AL, LL20 7AN, LL20 7AP, LL20 7AR, LL20 7AS, LL20 7AW, LL20 7AX, LL20 7DH",195,140,55
W00001918,LL20,"LL20 7AA, LL20 7AB, LL20 7AD, LL20 7AE, LL20 7AF, LL20 7AG, LL20 7AH, LL20 7AY, LL20 7BA, LL20 7BB, LL20 7BH, LL20 7BL, LL20 7BY, SY10 7NZ",297,215,82
W00001919,LL20,"LL20 7DA, LL20 7EQ, LL20 7EU, LL20 7EY, LL20 7HA, LL20 7HB, LL20 7HD, LL20 7HF, LL20 7HL, LL20 7HN, LL20 7HR, LL20 7HW, LL20 7NF, LL20 7NG, LL20 7NH, LL20 7NJ, LL20 7NL, LL20 7NP, LL20 7NR, LL20 7NS, LL20 7NW",316,221,95
W00001920,LL20,"LL20 7DP, LL20 7DR, LL20 7DW, LL20 7DY, LL20 7EA, LL20 7EB, LL20 7ED, LL20 7EE, LL20 7EG, LL20 7EH, LL20 7EL, LL20 7EN, LL20 7EP, LL20 7ER, LL20 7ES, LL20 7ET, LL20 7FB, LL20 7HP",212,148,64
W00002069,LL20,"LL20 7EJ, LL20 7TB, LL20 7TD, LL20 7TE, LL20 7TF, LL20 7TG, LL20 7TX, LL20 7UR, LL20 7US, LL20 7UT, LL20 7UU",303,260,43
W00001922,LL20,"LL20 7BU, LL20 7DB, LL20 7DD, LL20 7DE, LL20 7DF, LL20 7DL, LL20 7DN, LL20 7EF, LL20 7LY, LL20 7NA, LL20 7NB, LL20 7ND, LL20 7NE, LL20 7NN, LL20 7NT, LL20 7NU, LL20 7NY, LL20 7PB, LL20 7PD, LL20 7PE",199,159,40
W00001915,LL20,"LL20 7HS, LL20 7HT, LL20 7HU, LL20 7HY, LL20 7LA, LL20 7LB, LL20 7LD, LL20 7LE, LL20 7LF, LL20 7LG, LL20 7LH, LL20 7LJ, LL20 7LL, LL20 7PA",293,146,147
W00002072,LL20,"LL20 7TJ, LL20 7UB, LL20 7UD, LL20 7UE",296,252,44
W00002073,LL20,"LL20 7PY, LL20 7RA, LL20 7RB, LL20 7RD, LL20 7RE, LL20 7RF, LL20 7RG, LL20 7RH, LL20 7RJ, LL20 7RL, LL20 7RW, LL20 7SN, LL20 7SR, LL20 7SS, LL20 7ST",304,263,41
W00002074,LL20,"LL20 7PU, LL20 7RN, LL20 7RP, LL20 7RR, LL20 7RS, LL20 7RT, LL20 7RU, LL20 7SA, LL20 7SB, LL20 7SD, LL20 7SE, LL20 7SF, LL20 7SG, LL20 7SH, LL20 7SL, LL20 7SP, LL20 7SU, LL20 7SW, LL20 7SY",285,260,25
W00002075,LL20,"LL20 7DJ, LL20 7DQ, LL20 7UP, LL20 7UY, LL20 7YA, LL20 7YB, LL20 7YD, LL20 7YE, LL20 7YG, LL20 7YL, LL20 7YN, LL20 7YP, LL20 7YW",237,196,41
W00001921,LL20,"LL20 7DS, LL20 7DT, LL20 7DU, LL20 7EW, LL20 7HE, LL20 7HG, LL20 7HH, LL20 7HJ",216,134,82
W00001111,LL20,"LL20 7BP, LL20 7BS, LL20 7BW, LL20 8BX, LL20 8BZ, LL20 8EA, LL20 8EJ, LL20 8EQ, LL20 8ER, LL20 8EU, LL20 8HA, LL20 8HB, LL20 8HE, LL20 8HF, LL20 8HG, LL20 8HH, LL20 8HP, LL20 8HR, LL20 8HS, LL20 8HT",419,321,98
W00001115,LL20,"LL20 8AS, LL20 8AY, LL20 8BA, LL20 8BD, LL20 8BG, LL20 8BJ",324,230,94
W00001113,LL20,"LL20 8HL, LL20 8HN, LL20 8HU, LL20 8HY, LL20 8HZ, LL20 8LA, LL20 8LH, LL20 8LL, LL20 8LS, LL20 8RZ",226,172,54
W00001118,LL20,"LL20 8AT, LL20 8AU, LL20 8BB, LL20 8BL",288,229,59
W00001117,LL20,"LL20 7BX, LL20 8AP, LL20 8BE, LL20 8EN, LL20 8HD, LL20 8LT",207,169,38
W00001116,LL20,"LL20 7PP, LL20 7PR, LL20 7PS, LL20 7PT, LL20 7TA, LL20 7UH, LL20 7UL, LL20 7UN, LL20 7UW, LL20 8EG",185,148,37
W00001119,LL20,"LL20 7BT, LL20 7LP, LL20 7LR, LL20 7LS, LL20 7LT, LL20 7LU, LL20 8AA, LL20 8AB, LL20 8AE, LL20 8AG, LL20 8AJ, LL20 8AL, LL20 8AN, LL20 8BH, LL20 8BN, LL20 8BP, LL20 8BW, LL20 8EF, LL20 8RA, LL20 8RH, LL20 8RS, LL20 8SS, LL20 8TE",362,294,68
W00001120,LL20,"LL20 8AD, LL20 8AF, LL20 8AH, LL20 8AX, LL20 8AZ, LL20 8BF, LL20 8NG, LL20 8SL, LL20 8SN, LL20 8SP, LL20 8SR, LL20 8ST, LL20 8SU, LL20 8SW, LL20 8SY, LL20 8TB, LL20 8TD, LL20 8TJ, LL20 8TN, LL20 8TP, LL20 8TR, LL20 8TS, LL20 8TU, LL20 8TW, LL20 8UD, LL20 8YF, LL20 8YG",285,252,33
W00001121,LL20,"LL20 8NA, LL20 8NB, LL20 8NQ, LL20 8NU, LL20 8PD, LL20 8PP, LL20 8PR, LL20 8PS, LL20 8PT, LL20 8PU, LL20 8PY, LL20 8RB, LL20 8RD, LL20 8RE, LL20 8RF, LL20 8RG, LL20 8RN",248,203,45
W00001122,LL20,"LL20 7AJ, LL20 7BJ, LL20 7YT, LL20 7YU, LL20 7YY, LL20 7ZG, LL20 8BS, LL20 8BT, LL20 8BU, LL20 8BY, LL20 8DA, LL20 8DB, LL20 8DD, LL20 8DE, LL20 8DF, LL20 8DG, LL20 8DH, LL20 8DL, LL20 8DN, LL20 8DP, LL20 8DS, LL20 8DT, LL20 8DW, LL20 8ED, LL20 8EE, LL20 8EH, LL20 8EL",415,335,80
W00001109,LL20,"LL20 8DU, LL20 8DY, LL20 8EB, LL20 8RJ, LL20 8RQ, LL20 8RX, LL20 8SA, LL20 8SB, LL20 8SD, LL20 8SE, LL20 8SF, LL20 8SG, LL20 8SH, LL20 8TA, LL20 8TF, LL20 8TG, LL20 8TH, LL20 8UB, LL20 8UE",272,229,43
W00001110,LL20,"LL20 8LB, LL20 8LD, LL20 8LE, LL20 8LF, LL20 8LG, LL20 8LJ, LL20 8LN, LL20 8LP, LL20 8LR, LL20 8LU, LL20 8LW",207,163,44
W00001112,LL20,"LL20 7DG, LL20 7FZ, LL20 7PG, LL20 7PH, LL20 7PL, LL20 7PN, LL20 7PW, LL20 7ZE, LL20 8AQ, LL20 8AR, LL20 8AW, LL20 8BQ",269,207,62
W00001103,LL21,"LL21 9DE, LL21 9DF, LL21 9DH, LL21 9DP, LL21 9DR, LL21 9DS, LL21 9DT, LL21 9DW, LL21 9EJ",220,110,110
W00001092,LL21,"LL21 0HR, LL21 0HU, LL21 0LA, LL21 0LB, LL21 0LD, LL21 0LE, LL21 0LF, LL21 0LU, LL21 0NA, LL21 0NG, LL21 0NH, LL21 0NX",294,94,200
W00001093,LL21,"LL21 0AJ, LL21 0ET, LL21 0EU, LL21 0EW, LL21 0EY, LL21 0HP, LL21 0HW, LL21 0HY, LL21 0LG, LL21 0LH, LL21 0LL, LL21 0LN, LL21 0LP, LL21 0LR, LL21 0LS, LL21 0LT, LL21 0LW, LL21 0LY, LL21 0NF",298,152,146
W00001094,LL21,"LL21 0SJ, LL21 0SL, LL21 0SS, LL21 0ST, LL21 0SU, LL21 0SW, LL21 0SX, LL21 0SY, LL21 0TA, LL21 0TF, LL21 0TJ, LL21 0TL, LL21 0TP, LL21 0TT, LL21 0TU, LL21 0TW, LL21 0ZB",284,126,158
W00001095,LL21,"LL21 0NB, LL21 0ND, LL21 0NE, LL21 0SN, LL21 0SP, LL21 0SQ, LL21 0SR, LL21 0TB, LL21 0TD, LL21 0TE, LL21 0TG, LL21 0TH, LL21 0TN, LL21 0TQ, LL21 0TR",296,155,141
W00001104,LL21,"LL21 9DB, LL21 9DG, LL21 9DL, LL21 9DN, LL21 9DQ, LL21 9DU, LL21 9DY, LL21 9EA, LL21 9EB, LL21 9ED, LL21 9EE, LL21 9RY, LL21 9SA, LL21 9SB, LL21 9SD, LL21 9WE",263,128,135
W00001032,LL21,"LL21 0BH, LL21 0EE, LL21 0EG, LL21 0EH, LL21 0EL, LL21 0EN, LL21 0EP, LL21 0ER, LL21 0ES, LL21 0HH, LL21 0NL, LL21 0NN, LL21 0ZE, LL21 0ZF, LL21 0ZG, LL21 0ZH, LL21 0ZJ, LL21 0ZL, LL21 9BT, LL21 9BU, LL21 9DD, LL21 9NR, LL21 9NS, LL21 9NT, LL21 9NU, LL21 9PS, LL21 9QX, LL21 9RJ, LL21 9RP, LL21 9RQ, LL21 9RR, LL21 9RS, LL21 9RZ, LL21 9YA, LL21 9YE, LL21 9YG",299,161,138
W00000420,LL21,"LL21 0RN, LL23 7DN, LL23 7DS, LL23 7DT, LL23 7DU, LL23 7DW, LL23 7DY, LL23 7EA, LL23 7EB, LL23 7ED, LL23 7EE, LL23 7EF, LL23 7HD, LL23 7HE, LL23 7NP, LL23 7NR, LL23 7NS, LL23 7NT, LL23 7NU, LL23 7NW, LL23 7SA",351,89,262
W00000419,LL21,"LL21 0HA, LL21 0HB, LL21 0HD, LL21 0HE, LL21 0HF, LL21 0HG, LL21 0NP, LL21 0NW, LL21 0PF, LL21 0PG, LL21 0PH, LL23 7HF, LL23 7HG, LL23 7HY, LL23 7LA, LL23 7LB, LL23 7LD, LL23 7LE, LL23 7LF, LL23 7LG, LL23 7LH, LL23 7LL, LL23 7LN, LL23 7LW",381,128,253
W00001033,LL21,"LL21 9BN, LL21 9BP, LL21 9BS, LL21 9BW, LL21 9EU, LL21 9EY, LL21 9HA, LL21 9HB, LL21 9HD, LL21 9HE, LL21 9HF, LL21 9HG, LL21 9HH, LL21 9HL, LL21 9HN, LL21 9HP, LL21 9HR, LL21 9HS, LL21 9HT, LL21 9HW",377,230,147
W00001012,LL21,"LL21 0RT, LL21 0RU, LL21 0RY, LL21 0SA, LL21 0SB, LL21 0SD, LL21 0SE, LL21 0SF, LL21 0SH, LL21 9SR, LL21 9SU, LL21 9SW, LL21 9TA, LL21 9TB, LL21 9TD, LL21 9TE, LL21 9TP, LL21 9TR, LL21 9TS, LL21 9TT, LL21 9TU, LL21 9TW",383,133,250
W00001013,LL21,"LL21 9SE, LL21 9SP, LL21 9SS, LL21 9ST, LL21 9SY, LL21 9TF, LL21 9TG, LL21 9TH, LL21 9TL, LL21 9TN, LL21 9TQ, LL21 9UA, LL21 9UB, LL21 9UD, LL21 9UE",313,93,220
W00001014,LL21,"LL21 9PA, LL21 9PG, LL21 9PH, LL21 9UF, LL21 9UG, LL21 9UH, LL21 9UL, LL21 9UN, LL21 9UR, LL21 9UW",196,64,132
W00001015,LL21,"LL21 0PB, LL21 0PN, LL21 0PS, LL21 0PT, LL21 0PU, LL21 0PY, LL21 0RA, LL21 0RB, LL21 0RE, LL21 0RF, LL21 0RG, LL21 0RH, LL21 0RL, LL21 0RP, LL21 0RR, LL21 0RS, LL21 0RW, LL21 0SG, LL21 0TS",255,77,178
W00001074,LL21,"LL21 9PD, LL21 9PE, LL21 9PF, LL21 9PL, LL21 9PN, LL21 9PP, LL21 9PT, LL21 9PU, LL21 9PW, LL21 9PY, LL21 9RA, LL21 9RB, LL21 9RD, LL21 9RE, LL21 9RF, LL21 9RG, LL21 9RH, LL21 9RL, LL21 9UP, LL21 9US, LL21 9XA",323,154,169
W00001026,LL21,"LL21 0BG, LL21 0BP, LL21 0BS, LL21 0BT, LL21 0BU, LL21 0BY, LL21 0DA, LL21 0HN",224,106,118
W00001027,LL21,"LL21 9RT, LL21 9RX, LL21 9YB, LL21 9YD, LL21 9YF, LL21 9YS",271,195,76
W00001028,LL21,"LL21 0BL, LL21 9AP, LL21 9AR, LL21 9AS, LL21 9AT, LL21 9AU, LL21 9AW, LL21 9AY, LL21 9BA, LL21 9BB, LL21 9BD, LL21 9BE, LL21 9BG, LL21 9BH, LL21 9BL, LL21 9EH, LL21 9EL, LL21 9EN, LL21 9EP, LL21 9ER, LL21 9ES, LL21 9ET, LL21 9EW, LL21 9LD",306,181,125
W00001016,LL21,"LL21 0NR, LL21 0NS, LL21 0NT, LL21 0NU, LL21 0NY, LL21 0PA, LL21 0PD, LL21 0PE, LL21 0PL, LL21 0PP, LL21 0PR, LL21 0RD, LL21 9NY, LL21 9PB",208,114,94
W00001031,LL21,"LL21 9AA, LL21 9AB, LL21 9AD, LL21 9AE, LL21 9AF, LL21 9AG, LL21 9AH, LL21 9AL, LL21 9AN, LL21 9BY, LL21 9EF, LL21 9EG, LL21 9HU, LL21 9HY, LL21 9LA, LL21 9LB, LL21 9RW",295,151,144
W00001030,LL21,"LL21 0AE, LL21 0AG, LL21 0AL, LL21 0AN, LL21 0AS, LL21 0AT, LL21 0AU, LL21 0AW, LL21 0BA, LL21 0BB, LL21 0BD, LL21 0BE, LL21 0BN, LL21 0DH, LL21 0DW",221,108,113
W00001029,LL21,"LL21 0AA, LL21 0AB, LL21 0AD, LL21 0AH, LL21 0AP, LL21 0AR, LL21 0AY, LL21 0DB, LL21 0DD, LL21 0DE, LL21 0DF, LL21 0DG, LL21 0DJ, LL21 0DL, LL21 0DN, LL21 0DP, LL21 0DR, LL21 0DS, LL21 0DT, LL21 0DU, LL21 0DY, LL21 0EA, LL21 0EB, LL21 0ED, LL21 0RZ, LL21 0UD, LL21 0WY, LL21 0YJ, LL21 0ZA, LL21 0ZD, LL21 0ZP, LL21 0ZY, LL21 1AA, LL21 1AB, LL21 1AD, LL21 1AE, LL21 1AF, LL21 1AG, LL21 1AH, LL21 1AJ, LL21 1AL, LL21 1AN, LL21 1AP, LL21 1AQ, LL21 1AR, LL21 1AS, LL21 1AT, LL21 9BF, LL21 9WA, LL21 9WB, LL21 9WD, LL21 9WF, LL21 9WG, LL21 9WH, LL21 9WJ, LL21 9WZ, LL21 9ZF",203,131,72
W00000750,LL22,"LL22 7HB, LL22 7HH, LL22 7HJ, LL22 7LE",221,168,53
W00000752,LL22,"LL22 7DU, LL22 7ED, LL22 7EE, LL22 7EF, LL22 7EG, LL22 7EH, LL22 8FA",229,189,40
W00000754,LL22,"LL22 7DF, LL22 7DL, LL22 7DY, LL22 7EL, LL22 7UY",199,165,34
W00000756,LL22,"LL22 7DE, LL22 7DS, LL22 7DT, LL22 7DX",190,150,40
W00000759,LL22,"LL22 7DG, LL22 7DJ, LL22 7DQ, LL22 7DZ, LL22 7JA, LL22 7JD, LL22 7JE, LL22 8FB, LL22 8QH",282,236,46
W00000758,LL22,"LL22 7AS, LL22 7AT, LL22 7AU, LL22 7AY, LL22 7HD, LL22 8DG, LL22 8DQ, LL22 9AP, LL22 9AQ, LL22 9AR, LL22 9AT, LL22 9AU, LL22 9AZ, LL22 9BF, LL22 9BJ, LL22 9BQ, LL22 9BX",470,334,136
W00000749,LL22,"LL22 7AJ, LL22 7HL, LL22 7HP, LL22 7HQ, LL22 7HW",390,312,78
W00000760,LL22,"LL22 8BQ, LL22 8DE, LL22 8DF, LL22 8DZ, LL22 8EZ, LL22 8JA, LL22 8JP",205,156,49
W00000757,LL22,"LL22 7BZ, LL22 7DW, LL22 7EZ, LL22 7HX, LL22 7JB, LL22 7JG, LL22 7JH, LL22 7JQ",285,234,51
W00000748,LL22,"LL22 8PX, LL22 8PZ, LL22 8QA, LL22 8QB, LL22 8QD, LL22 8QE, LL22 8QF, LL22 8QJ, LL22 8QL, LL22 8QN, LL22 8QP, LL22 8QR, LL22 8QW",456,348,108
W00000648,LL22,"LL22 8PE, LL22 8SA, LL22 8SB, LL22 8SF, LL22 8SH, LL22 8SJ, LL22 8SL, LL22 8SN, LL22 8SQ, LL22 8TH, LL22 8YP, LL22 8YR, LL22 8YU, LL22 8YY, LL22 8ZZ",280,173,107
W00000761,LL22,"LL22 7HZ, LL22 9AS, LL22 9AY, LL22 9BA, LL22 9BD, LL22 9BE, LL22 9BG, LL22 9BH, LL22 9BL, LL22 9BN, LL22 9BP, LL22 9BS, LL22 9BT, LL22 9BU, LL22 9BW, LL22 9BY, LL22 9DA, LL22 9RT, LL22 9SF, LL22 9SG, LL22 9SH, LL22 9WD",313,256,57
W00000646,LL22,"LL22 8DN, LL22 8DP, LL22 8DW, LL22 8PB, LL22 8PD, LL22 8PN, LL22 8YH, LL22 8YN, LL22 8YW, LL22 9BB, LL22 9DU, LL22 9DY, LL22 9PY, LL22 9RA, LL22 9RB, LL22 9RD, LL22 9RE, LL22 9RF, LL22 9RG, LL22 9RH, LL22 9RL, LL22 9RN, LL22 9RP, LL22 9RR, LL22 9RS, LL22 9RW",357,230,127
W00000645,LL22,"LL22 8AF, LL22 8AN, LL22 8AP, LL22 8AQ, LL22 8AW, LL22 8ZJ, LL22 8ZP",295,173,122
W00000644,LL22,"LL22 8AA, LL22 8AB, LL22 8AD, LL22 8AE, LL22 8AG, LL22 8AH, LL22 8AL, LL22 8AR, LL22 8AS, LL22 8AT, LL22 8AU, LL22 8AX, LL22 8AY, LL22 8AZ, LL22 8BU, LL22 8BX, LL22 8BY, LL22 8BZ, LL22 8DA, LL22 8DB, LL22 8EE, LL22 8EF, LL22 8FD, LL22 8NE, LL22 8NF, LL22 8NG, LL22 8NH, LL22 8NL, LL22 8NN, LL22 8NP, LL22 8PA, LL22 8PL, LL22 8YL, LL28 5LA, LL29 8AJ, LL29 8AQ",373,214,159
W00000643,LL22,"LL22 8BA, LL22 8BB, LL22 8BD, LL22 8BE, LL22 8BS, LL22 8BT, LL22 8NR, LL22 8NS, LL22 8NT, LL22 8NU, LL22 8NW, LL22 8NY, LL28 5EP, LL28 5ER, LL28 5ES, LL29 6AS, LL29 6AT, LL29 6AU, LL29 6AY, LL29 6BA, LL29 6BB, LL29 6BD, LL29 6BE, LL29 8EH, LL29 8EJ, LL29 8UU, LL29 8UY, LL29 8YA, LL29 8YR, LL29 8YS, LL29 8YT, LL29 8YU, LL29 8YY",303,160,143
W00000637,LL22,"LL22 9AB, LL22 9AF, LL22 9AG, LL22 9AH, LL22 9AJ, LL22 9AL, LL22 9AN, LL22 9AW, LL22 9YD, LL22 9YF, LL22 9YG, LL22 9YJ",265,246,19
W00000636,LL22,"LL22 7RG, LL22 7RH, LL22 7SQ",183,167,16
W00000635,LL22,"LL22 7PS, LL22 7RD, LL22 7RU, LL22 7SE, LL22 7SG",263,230,33
W00000634,LL22,"LL22 7PN, LL22 7PP, LL22 7PQ, LL22 7PR, LL22 7PT, LL22 7PU, LL22 7PW, LL22 7PX, LL22 7SD, LL22 7SF, LL22 7SX",179,149,30
W00000633,LL22,"LL22 9XZ, LL22 9YN, LL22 9YP, LL22 9YQ, LL22 9YS, LL22 9YW, LL22 9YZ, LL22 9ZY",388,328,60
W00000632,LL22,"LL22 9AA, LL22 9AD, LL22 9AE, LL22 9AX, LL22 9XX, LL22 9YA, LL22 9YB, LL22 9YE, LL22 9YH, LL22 9YL, LL22 9YU, LL22 9YY",421,355,66
W00000631,LL22,"LL22 7PY, LL22 7RA, LL22 7RB, LL22 7RN, LL22 7RW, LL22 7SB",214,192,22
W00000630,LL22,"LL22 7RJ, LL22 7RQ, LL22 7RR, LL22 7RS, LL22 7RT, LL22 7RX, LL22 7RZ",239,216,23
W00000629,LL22,"LL22 7RE, LL22 7RF, LL22 7RL, LL22 7RP, LL22 7RY, LL22 7SA",219,211,8
W00000731,LL22,"LL22 8BG, LL22 8BN, LL22 8BP, LL22 8BW, LL26 0DJ, LL26 0DQ, LL26 0LX, LL26 0LZ, LL26 0YH, LL28 5BF, LL28 5RD, LL28 5RE, LL28 5RF, LL28 5RL, LL28 5SB, LL28 5SD, LL28 5SE, LL28 5SF, LL28 5SG, LL28 5TP, LL28 5UE, LL28 5UG, LL28 5UL, LL28 5UN, LL28 5UW",372,170,202
W00000816,LL22,"LL22 8HR, LL22 8HT, LL22 8JF, LL22 8JG, LL22 8JH, LL22 8JQ, LL22 8JR, LL22 8LL, LL22 8LN, LL22 8LP, LL22 8LR, LL22 8LS, LL22 8LT, LL22 8LU, LL22 8LW, LL22 8LX, LL22 8LZ",277,225,52
W00000820,LL22,"LL22 8EG, LL22 8EH, LL22 8EL, LL22 8EP, LL22 8ER, LL22 8FH, LL22 8FR, LL22 8NJ",235,170,65
W00000818,LL22,"LL22 8JD, LL22 8JL, LL22 8JN, LL22 8JW, LL22 8LQ, LL22 8LY",232,196,36
W00000985,LL22,"LL22 9LN, LL22 9LS, LL22 9LY, LL22 9NG, LL22 9NJ, LL22 9NS, LL22 9PB, LL22 9PE",270,236,34
W00000984,LL22,"LL22 9ER, LL22 9HB, LL22 9HD, LL22 9HE, LL22 9HQ, LL22 9JA, LL22 9LR, LL22 9NA, LL22 9NN, LL22 9PG, LL22 9PH",306,276,30
W00000983,LL22,"LL22 9EL, LL22 9EN, LL22 9EP, LL22 9ES, LL22 9ET, LL22 9EU, LL22 9EW, LL22 9EY, LL22 9HH, LL22 9HL, LL22 9HN, LL22 9HP, LL22 9HR, LL22 9HS, LL22 9HT, LL22 9HU, LL22 9HW, LL22 9HY, LL22 9LA, LL22 9LB, LL22 9LD, LL22 9LP",249,225,24
W00000982,LL22,"LL22 9NH, LL22 9NL, LL22 9NT, LL22 9NW, LL22 9NY, LL22 9PA, LL22 9PF",207,187,20
W00000981,LL22,"LL22 9LE, LL22 9LQ, LL22 9LZ, LL22 9NB, LL22 9ND, LL22 9NP, LL22 9NX, LL22 9NZ, LL22 9SE",420,355,65
W00000980,LL22,"LL22 9LW, LL22 9NU, LL22 9YT, LL22 9YX",106,95,11
W00000979,LL22,"LL22 9LG, LL22 9LT, LL22 9LU, LL22 9NE, LL22 9NF, LL22 9NR, LL22 9PJ, LL22 9WA, LL22 9WB, LL22 9WG, LL22 9WP, LL22 9WR, LL22 9WS, LL22 9WT, LL22 9WU",307,267,40
W00000978,LL22,"LL22 9HA, LL22 9HF, LL22 9HG, LL22 9LF, LL22 9LH, LL22 9LJ, LL22 9LL, LL22 9LX, LL22 9NQ, LL22 9PD",360,336,24
W00000958,LL22,"LL22 7AZ, LL22 7NP, LL22 7NR, LL22 7NT, LL22 7NW, LL22 7NY, LL22 7PG, LL22 7PH, LL22 7PL",240,195,45
W00000957,LL22,"LL22 7LY, LL22 7NA, LL22 7ND, LL22 7PE",280,236,44
W00000956,LL22,"LL22 7HE, LL22 7HF, LL22 7HG, LL22 7HN, LL22 7HR, LL22 7HS, LL22 7HU, LL22 7LA, LL22 7LF",267,219,48
W00000955,LL22,"LL22 7BU, LL22 7BY, LL22 7SY, LL22 7TA, LL22 7TD, LL22 7TF, LL22 7TL, LL22 7TW",299,235,64
W00000817,LL22,"LL22 8EN, LL22 8ES, LL22 8HB, LL22 8HD, LL22 8HF, LL22 8HJ",314,261,53
W00000954,LL22,"LL22 7DA, LL22 7TN, LL22 7TP, LL22 7TR, LL22 7TS, LL22 7TT, LL22 7TU",224,175,49
W00000951,LL22,"LL22 7HT, LL22 7NH, LL22 7NS, LL22 7NU, LL22 7PB",302,242,60
W00000950,LL22,"LL22 7TG, LL22 7TH, LL22 7UD, LL22 7UE, LL22 7UF, LL22 7UG, LL22 7UR, LL22 7UU, LL22 7YR",229,195,34
W00000949,LL22,"LL22 7LN, LL22 7NG, LL22 7NL, LL22 7NN, LL22 7PA, LL22 7PD, LL22 7PF",296,210,86
W00000948,LL22,"LL22 7LG, LL22 7LH, LL22 7LL, LL22 7LP, LL22 7LQ, LL22 7LS, LL22 7LT, LL22 7LW, LL22 7LX, LL22 7NF, LL22 7SP, LL22 7SS, LL22 7TB",425,323,102
W00000947,LL22,"LL22 7LR, LL22 7LU, LL22 7NB, LL22 7NE, LL22 7TE, LL22 7UN, LL22 7UP, LL22 7UQ",310,250,60
W00000871,LL22,"LL22 8HP, LL22 8HS, LL22 8HU, LL22 8HY, LL22 8LA, LL29 8FA, LL29 8FB, LL29 8FE, LL29 8FF, LL29 8FH, LL29 8SD, LL29 8SF, LL29 8SH, LL29 8SQ, LL29 8SS, LL29 8ST, LL29 8TS, LL29 9HT, LL29 9YW, LL29 9ZA",302,232,70
W00000870,LL22,"LL22 8ND, LL29 8BJ, LL29 8BQ, LL29 8BX, LL29 8BZ, LL29 8LJ, LL29 8LQ, LL29 8LX, LL29 8LZ, LL29 8NU, LL29 8TD, LL29 8TE, LL29 8TF, LL29 8TG, LL29 8TH, LL29 8TL, LL29 8TP, LL29 8TQ, LL29 8TR, LL29 8TT, LL29 8TW",324,248,76
W00000867,LL22,"LL22 8LB, LL22 8LD, LL22 8LE, LL22 8LF, LL22 8LG, LL22 8LH, LL29 8FD, LL29 8FG, LL29 8FJ, LL29 8SA, LL29 8SU",391,318,73
W00000851,LL22,"LL22 8PU, LL22 8PY, LL22 8UA, LL22 8UE, LL22 8UF, LL22 8UG, LL22 8UH, LL22 8UJ, LL22 8UL, LL22 8UN, LL22 8UP, LL22 8UQ, LL22 8UR, LL22 8US, LL22 8UT, LL22 8UU, LL22 8UW, LL22 8UY, LL22 8WA, LL22 8YA, LL22 8YB, LL22 8YD, LL22 8YE, LL22 8YF, LL26 0NR, LL26 0NT",381,133,248
W00000850,LL22,"LL22 8BH, LL22 8BL, LL22 8PF, LL22 8PQ, LL22 8PR, LL22 8PS, LL22 8PT, LL22 8RA, LL22 8RB, LL22 8RD, LL22 8RE, LL22 8RF, LL22 8RG, LL22 8RH, LL22 8RP, LL22 8RR, LL22 8RS, LL22 8TD, LL22 8TE, LL22 8UB, LL22 8UD",348,180,168
W00000821,LL22,"LL22 8DU, LL22 8DX, LL22 8DY, LL22 8EA, LL22 8EB, LL22 8ED, LL22 8EU, LL22 8EY, LL22 8FG, LL22 8HA, LL22 8HZ, LL22 8NA, LL22 8NB",258,196,62
W00000819,LL22,"LL22 8EW, LL22 8FX, LL22 8HE, LL22 8HG, LL22 8HH, LL22 8HL, LL22 8HN, LL22 8HQ, LL22 8HW, LL22 8JB, LL22 8JE, LL22 8JJ",258,215,43
W00000953,LL22,"LL22 7AA, LL22 7AD, LL22 7AE, LL22 7AL, LL22 7AN, LL22 7AX, LL22 7BN, LL22 7HA, LL22 7HY, LL22 7LB, LL22 7LD, LL22 7LJ, LL22 7SH, LL22 7SJ, LL22 7SL, LL22 7SN, LL22 7SR, LL22 7ST, LL22 7SU, LL22 7SW, LL22 7SZ, LL22 7TJ, LL22 7WY, LL22 7ZB, LL22 7ZF, LL22 7ZG, LL22 7ZH, LL22 7ZL",417,359,58
W00000849,LL22,"LL22 8PG, LL22 8PH, LL22 8PJ, LL22 8PP, LL22 8PW, LL22 8QG, LL22 8RL, LL22 8RN, LL22 8RW, LL22 8TY",332,127,205
W00000762,LL22,"LL22 7BT, LL22 7DB, LL22 7DD, LL22 7DH, LL22 7DN, LL22 7DP, LL22 7DR, LL22 7FA, LL22 7YA, LL22 8ET",215,178,37
W00010105,LL22,"LL22 7JF, LL22 8DD, LL22 8DH, LL22 8DL, LL22 8DR, LL22 8DS, LL22 8DT, LL22 8FS, LL22 8FT, LL22 8FW",335,249,86
W00010106,LL22,"LL22 7AP, LL22 7BW, LL22 7EN, LL22 7EP, LL22 7ER, LL22 7ES, LL22 7ET, LL22 7EU, LL22 7EW, LL22 7EY, LL22 7UH, LL22 7YU, LL22 7YZ, LL22 8EJ, LL22 8EQ, LL22 8EX",332,252,80
W00010108,LL22,"LL22 7BL, LL22 7EA, LL22 7EB, LL22 7UL",268,199,69
W00010453,LL22,"LL22 7AB, LL22 7AF, LL22 7AG, LL22 7AH, LL22 7AR, LL22 7AW, LL22 7BA, LL22 7BB, LL22 7BD, LL22 7BE, LL22 7BG, LL22 7BH, LL22 7BP, LL22 7BS",327,254,73
W00010459,LL22,"LL22 7TY, LL22 7UA, LL22 7UB, LL22 7US, LL22 7UT, LL22 7UW, LL22 8FF, LL22 8LJ",286,238,48
W00010461,LL22,"LL22 8FE, LL22 8FJ, LL22 8FL, LL22 8FN, LL22 8FP",325,238,87
W00000446,LL23,"LL23 7NA, LL23 7SY, LL23 7TB, LL23 7TL, LL23 7TP, LL23 7TR, LL23 7TS, LL23 7TT, LL23 7TU, LL23 7TY, LL23 7UA, LL23 7UE, LL23 7UF, LL23 7UN",274,32,242
W00000447,LL23,"LL23 7DD, LL23 7DE, LL23 7DF, LL23 7SS, LL23 7ST, LL23 7SU, LL23 7TA, LL23 7TD, LL23 7TE, LL23 7TN, LL23 7TW, LL23 7UB, LL23 7UD, LL23 7UG, LL23 7UH, LL23 7UL, LL23 7YL, LL23 7YN, LL40 2BB",330,65,265
W00000264,LL23,"LL23 7AX, LL23 7BD, LL23 7BE",255,60,195
W00000263,LL23,"LL23 7AY, LL23 7BF, LL23 7BJ, LL23 7BN, LL23 7BP, LL23 7BW, LL23 7DG, LL23 7DH, LL23 7DX, LL23 7DZ, LL23 7GA, LL23 7TF",277,58,219
W00000262,LL23,"LL23 7AP, LL23 7AQ, LL23 7AT, LL23 7BG, LL23 7BQ, LL23 7SN, LL23 7UW, LL23 7YB, LL23 7YD, LL23 7YE, LL23 7YY, LL23 7YZ, LL23 7ZE",328,63,265
W00000261,LL23,"LL23 7AB, LL23 7AD, LL23 7AE, LL23 7AF, LL23 7AJ, LL23 7AL, LL23 7AW, LL23 7BH, LL23 7EH, LL23 7EL, LL23 7LT, LL23 7NB, LL23 7ND, LL23 7NE, LL23 7NF, LL23 7SP, LL23 7SR, LL23 7SW, LL23 7UR, LL23 7UT, LL23 7WY",265,139,126
W00000260,LL23,"LL23 7AU, LL23 7BA, LL23 7BL, LL23 7EN, LL23 7EQ, LL23 7HA, LL23 7NH, LL23 7NJ, LL23 7NL, LL23 7NN, LL23 7RR, LL23 7RS, LL23 7ZA, LL23 7ZB, LL23 7ZD, LL23 7ZF, LL23 7ZG, LL23 7ZH, LL23 7ZJ, LL23 7ZU, LL23 9AA, LL23 9AB, LL23 9AD, LL23 9AE, LL23 9ZZ",277,85,192
W00000445,LL23,"LL23 7BS, LL23 7BT, LL23 7BU, LL23 7BY, LL23 7DA, LL23 7DB, LL23 7EP, LL23 7ER, LL23 7ES, LL23 7ET, LL23 7EU, LL23 7EW, LL23 7EY, LL23 7PH, LL23 7PL, LL23 7PN, LL23 7PP, LL23 7PR, LL23 7PW, LL23 7RL, LL23 7RN, LL23 7TH, LL23 7UP",283,72,211
W00000265,LL23,"LL23 7AA, LL23 7AG, LL23 7BB, LL23 7LU, LL23 7LY, LL23 7NG, LL23 7PG, LL23 7RT, LL23 7RU, LL23 7RY, LL23 7YA",259,76,183
W00000422,LL23,"LL23 7NY, LL23 7PA, LL23 7PB, LL23 7PD, LL23 7SB, LL23 7SD, LL23 7SE, LL23 7SF, LL23 7SG, LL23 7SH, LL23 7SJ, LL23 7SL, LL23 7YF, LL23 7YG, LL23 7YH, LL23 7YP, LL23 7YR, LL23 7YS, LL23 7YT, LL23 7YU, LL23 7YW",432,85,347
W00000421,LL23,"LL23 7DP, LL23 7DR, LL23 7HH, LL23 7HL, LL23 7HN, LL23 7HP, LL23 7HQ, LL23 7HR, LL23 7HS, LL23 7HT, LL23 7HU, LL23 7HW, LL23 7PS, LL23 7PT, LL23 7PU, LL23 7PY, LL23 7RA, LL23 7RB, LL23 7RD, LL23 7RE, LL23 7RF, LL23 7RG, LL23 7RH",335,158,177
W00000259,LL23,"LL23 7AH, LL23 7AN, LL23 7AR, LL23 7AS, LL23 7UU, LL23 7UY",284,54,230
W00000795,LL24,"LL24 0ZD, LL24 0ZF, LL24 9AF, LL24 9AG, LL24 9AH, LL26 0BE, LL26 0BT, LL26 0BU, LL26 0BY, LL26 0DA, LL26 0DB, LL26 0DE, LL26 0DF, LL26 0DG, LL26 0DH, LL26 0DL, LL26 0DN, LL26 0ZA, LL26 0ZE, LL26 0ZF, LL26 0ZG, LL26 0ZP, LL26 9AA, LL26 9AB, LL26 9AD, LL26 9AE, LL26 9AF, LL26 9AG, LL26 9ZZ, LL27 0ZB",226,92,134
W00001009,LL24,"LL24 0RA, LL24 0RB, LL24 0RD, LL24 0RE, LL24 0RF, LL24 0RH, LL24 0RP, LL24 0RR, LL24 0RS, LL24 0RT, LL24 0RU, LL24 0RW, LL24 0RY, LL24 0SA, LL24 0SB, LL24 0SD, LL24 0UB, LL24 0UD, LL24 0UH, LL24 0UL, LL24 0UN, LL24 0UR, LL24 0UU, LL24 0UY, LL24 0YD, LL24 0YE, LL24 0YF, LL24 0YG, LL24 0YP, LL24 0YR, LL24 0YS, LL24 0YU, LL24 0YW",235,102,133
W00001007,LL24,"LL24 0HA, LL24 0HB, LL24 0HD, LL24 0HE, LL24 0HF, LL24 0HG, LL24 0HH, LL24 0HL, LL24 0HX, LL24 0LU, LL24 0LY, LL24 0PN, LL24 0SF, LL24 0SG, LL24 0SH, LL24 0SL, LL24 0SS, LL24 0ST, LL26 0PX, LL26 0PY, LL26 0RA, LL26 0RD, LL26 0RG, LL26 0RH, LL26 0RP, LL26 0RR, LL26 0RS, LL26 0RT, LL26 0RU, LL26 0RW, LL26 0SU, LL26 0TA, LL26 0TB, LL26 0TE, LL26 0TF, LL26 0TG, LL26 0TH, LL26 0TN, LL26 0TP",311,125,186
W00001011,LL24,"LL24 0HN, LL24 0HP, LL24 0HS, LL24 0HW, LL24 0NF, LL24 0NG, LL24 0NH, LL24 0NL, LL24 0NN, LL24 0NP, LL24 0NR, LL24 0NS, LL24 0NT, LL24 0NU, LL24 0NW, LL24 0NY, LL24 0PA, LL24 0PB, LL24 0PE, LL24 0PF, LL24 0PG",185,56,129
W00001010,LL24,"LL24 0AJ, LL24 0AQ, LL24 0AX, LL24 0AZ, LL24 0GD, LL24 0ND, LL24 0PP, LL24 0PR, LL24 0PS, LL24 0PT, LL24 0PU, LL24 0PW, LL24 0PY, LL24 0RG, LL24 0RL, LL24 0RN, LL24 0TY, LL24 0UA, LL24 0UE, LL24 0UF, LL24 0UG, LL24 0UJ, LL24 0UP, LL24 0UT, LL24 0UW, LL24 0YA, LL24 0YB, LL24 0YH, LL24 0YL, LL24 0YN, LL24 0YT, LL24 0YY, LL24 0ZB, LL24 0ZE, LL25 0HQ, LL25 0HX, LL25 0PZ",357,160,197
W00000852,LL24,"LL24 0AT, LL24 0HR, LL24 0HT, LL24 0HU, LL24 0HY, LL24 0LA, LL24 0LB, LL24 0LD, LL24 0LE, LL24 0LF, LL24 0LG, LL24 0LH, LL24 0LL, LL24 0LN, LL24 0LP, LL24 0LR, LL24 0LS, LL24 0LT, LL24 0LW, LL24 0PD, LL24 0SU, LL24 0SY, LL24 0TA, LL24 0TB, LL24 0TD, LL24 0TE, LL24 0TF, LL24 0TG, LL24 0TH, LL24 0TL, LL24 0TN, LL24 0TP, LL24 0TR, LL24 0TW",327,90,237
W00000640,LL24,"LL24 0DH, LL24 0DP, LL24 0DR, LL24 0DS, LL24 0DT, LL24 0DU, LL24 0DY, LL24 0EA, LL24 0EB, LL24 0ED, LL24 0EE, LL24 0EF, LL24 0EG, LL24 0EH, LL24 0EL, LL24 0EN, LL24 0EP, LL24 0ES, LL24 0ET, LL24 0EU, LL24 0EW, LL24 0SR, LL27 0JA",210,111,99
W00000639,LL24,"LL24 0AA, LL24 0AB, LL24 0AD, LL24 0AE, LL24 0AF, LL24 0AG, LL24 0AH, LL24 0AL, LL24 0AN, LL24 0AP, LL24 0AR, LL24 0AS, LL24 0AW, LL24 0AY, LL24 0BA, LL24 0BB, LL24 0BL, LL24 0BN, LL24 0BW, LL24 0ZA, LL24 0ZG, LL24 0ZH, LL24 9AA, LL24 9AB, LL24 9AD, LL24 9AE, LL25 0ZB",213,145,68
W00000638,LL24,"LL24 0BD, LL24 0BG, LL24 0BH, LL24 0BP, LL24 0BS, LL24 0BT, LL24 0BU, LL24 0BY, LL24 0DA, LL24 0DB, LL24 0DE, LL24 0DF, LL24 0DG, LL24 0DN, LL24 0DW, LL24 0HZ, LL24 0RQ, LL24 0SN, LL24 0SW, LL25 0LZ, LL25 0PX",259,122,137
W00000642,LL25,"LL25 0DZ, LL25 0EX, LL25 0JJ, LL25 0NJ, LL25 0NX, LL25 0NZ, LL25 0RJ, LL25 0SQ, LL25 0SX, LL25 0SZ, LL25 0TJ, LL25 0TQ, LL25 0TX, LL25 0TZ, LL25 0UQ, LL25 0UZ, LL25 0YJ, LL25 0YQ, LL25 0ZA",195,100,95
W00000641,LL25,"LL25 0DJ, LL25 0DQ, LL25 0DX, LL25 0EJ, LL25 0EQ, LL25 0EZ, LL25 0HJ, LL25 0JA, LL25 0JB, LL25 0JD, LL25 0JE, LL25 0JF, LL25 0JG, LL25 0JH, LL25 0JQ, LL25 0NQ, LL25 0PJ, LL25 0PQ, LL25 0RZ, LL25 0SJ, LL25 0UJ, LL25 0UX, LL25 0WA, LL25 0YX, LL25 0YZ",247,118,129
W00000715,LL26,"LL26 0AP, LL26 0AR, LL26 0HP, LL26 0HQ, LL26 0HS, LL26 0HT, LL26 0HU, LL26 0NF, LL26 0SZ, LL26 0ZB, LL26 0ZD",357,158,199
W00000713,LL26,"LL26 0AE, LL26 0AF, LL26 0AH, LL26 0AL, LL26 0AS, LL26 0AT, LL26 0BA, LL26 0BG, LL26 0BW, LL26 0EL, LL26 0LN, LL26 0LP",196,103,93
W00000796,LL26,"LL26 0AU, LL26 0BH, LL26 0BL, LL26 0DW",258,109,149
W00000711,LL26,"LL26 0HF, LL26 0HH, LL26 0LA, LL26 0ND, LL26 0NE, LL26 0PJ, LL26 0SB, LL26 0TS",247,102,145
W00000794,LL26,"LL26 0BD, LL26 0BN, LL26 0DT, LL26 0YT, LL26 0YU, LL26 0YY",285,113,172
W00000987,LL26,"LL26 0HA, LL26 0HB, LL26 0PL, LL26 0PN, LL26 0PW, LL27 0HQ, LL27 0HX, LL27 0HZ, LL27 0JB, LL27 0JD, LL27 0JZ, LL27 0YJ, LL27 0YQ, LL27 0YX, LL27 0YZ",164,103,61
W00000710,LL26,"LL26 0AY, LL26 0BB, LL26 0BP, LL26 0EW, LL26 0EX, LL26 0NG, LL26 0NH, LL26 0NL, LL26 0NN",311,122,189
W00001008,LL26,"LL26 0NS, LL26 0NU, LL26 0NW, LL26 0NY, LL26 0PA, LL26 0PB, LL26 0PD, LL26 0PE, LL26 0PF, LL26 0RB, LL26 0RE, LL26 0RF, LL26 0RJ, LL26 0RL, LL26 0RN, LL26 0SF, LL26 0SG, LL26 0SH, LL26 0SJ, LL26 0SL, LL26 0SP, LL26 0SR, LL26 0SW, LL26 0SY, LL26 0TD, LL26 0TL, LL26 0TR, LL26 0TW",341,103,238
W00000714,LL26,"LL26 0AA, LL26 0AB, LL26 0AD, LL26 0AG, LL26 0AW, LL26 0EP, LL26 0ER, LL26 0EY, LL26 0FZ, LL26 0GD, LL26 0HD, LL26 0LH, LL26 0LL, LL26 0LR, LL26 0LS, LL26 0LU, LL26 0LW, LL26 0LY, LL26 0NB, LL26 0WY",290,142,148
W00000712,LL26,"LL26 0PG, LL26 0PH, LL26 0PP, LL26 0PQ, LL26 0PR, LL26 0PS, LL26 0PT, LL26 0PU, LL26 0RY, LL26 0SA, LL26 0SD, LL26 0SE, LL26 0SN, LL26 0SS, LL26 0ST",314,110,204
W00000716,LL26,"LL26 0ES, LL26 0ET, LL26 0EU, LL26 0GA, LL26 0HE, LL26 0HG, LL26 0HJ, LL26 0HL, LL26 0HN, LL26 0HR, LL26 0HW, LL26 0LB, LL26 0LD, LL26 0LE, LL26 0LF, LL26 0LG, LL26 0LT, LL26 0NA",276,112,164
W00000793,LL26,"LL26 0DP, LL26 0DR, LL26 0DS, LL26 0DU, LL26 0DY, LL26 0EA, LL26 0EB, LL26 0ED, LL26 0EE, LL26 0EF, LL26 0EG, LL26 0EH",278,97,181
W00000734,LL26,"LL26 0BJ, LL26 0DD, LL26 0DX, LL26 0DZ, LL26 0LJ, LL26 0LQ, LL26 0TU, LL26 0UE, LL26 0UF, LL26 0UG, LL26 0UH, LL26 0UL, LL26 0UN, LL26 0UP, LL26 0UW, LL26 0UY, LL26 0YA, LL26 0YB, LL26 0YD, LL26 0YE, LL26 0YF, LL26 0YG, LL26 0YN, LL26 0YP, LL26 0YR",301,136,165
W00000732,LL26,"LL26 0YL, LL26 0YW, LL28 5RP, LL28 5RR, LL28 5RS, LL28 5RW, LL28 5RY, LL28 5SA, LL28 5UA, LL28 5UB, LL28 5UD, LL28 5UF, LL28 5UH, LL28 5UR",263,124,139
W00000735,LL26,"LL26 0AJ, LL26 0AQ, LL26 0AX, LL26 0AZ, LL26 0BQ, LL26 0BX, LL26 0BZ, LL26 0NP, LL26 0TT, LL26 0TY, LL26 0UA, LL26 0UB, LL26 0UD, LL26 0UR, LL26 0UT, LL26 0UU, LL26 0YS",298,103,195
W00000988,LL27,"LL27 0AA, LL27 0JF, LL27 0JH, LL27 0JL, LL27 0JN, LL27 0JP, LL27 0JR, LL27 0JS, LL27 0JT, LL27 0JU, LL27 0JY, LL27 0NJ, LL27 0NQ, LL27 0NX, LL27 0NZ, LL27 0QA, LL27 0RX, LL27 0SX, LL27 0SZ, LL27 0TX, LL27 0TZ, LL27 0UQ, LL32 8JG, LL32 8QD",278,178,100
W00000989,LL27,"LL27 0JE, LL27 0JG, LL27 0JJ, LL27 0JQ, LL27 0JW, LL27 0JX, LL27 0QD, LL27 0RJ, LL27 0RQ, LL27 0RY, LL27 0RZ, LL27 0SQ, LL27 0TJ, LL27 0TQ, LL27 0UJ, LL27 0UX, LL27 0UZ, LL27 0ZA",345,171,174
W00000830,LL28,"LL28 4PL, LL28 4RD, LL28 4RF, LL28 4RG, LL28 4RH, LL28 4RL, LL28 4RR, LL28 4RW",242,212,30
W00000831,LL28,"LL28 4AZ, LL28 4BQ, LL28 4LJ, LL28 4LQ, LL28 4LX",210,177,33
W00000832,LL28,"LL28 4HJ, LL28 4HQ, LL28 4HX, LL28 4NX, LL28 4PJ, LL28 4PX, LL28 4PZ, LL28 4SL, LL28 4YT",226,173,53
W00000833,LL28,"LL28 4AJ, LL28 4AX, LL28 4BX, LL28 4BZ, LL28 4SB, LL28 4SD, LL28 4SE",268,227,41
W00000834,LL28,"LL28 4EJ, LL28 4EX, LL28 4EZ, LL28 4NQ, LL28 4PQ, LL28 4RJ, LL28 4UH",296,227,69
W00000856,LL28,"LL28 5DR, LL28 5LJ, LL28 5LX, LL28 5NA, LL28 5ND, LL28 5NW",236,166,70
W00000829,LL28,"LL28 4BD, LL28 4ES, LL28 4TR, LL28 4TY, LL28 4UA, LL28 4UD, LL28 4YR, LL28 4YS",285,227,58
W00000836,LL28,"LL28 4DU, LL28 4EN, LL28 4EP, LL28 4EY, LL28 4HB, LL28 4PP, LL28 4PR, LL28 4PS, LL28 4PT, LL28 4RB",222,192,30
W00000837,LL28,"LL28 4AA, LL28 4HE, LL28 4TS, LL28 4TU, LL28 4UB, LL28 4UL, LL28 4UR, LL28 4UT, LL28 4UW, LL28 4UY",243,203,40
W00000893,LL28,"LL28 5AB, LL28 5AZ, LL28 5BU, LL28 5BW, LL28 5BY, LL28 5DA, LL28 5DB, LL28 5DD, LL28 5DE, LL28 5DH, LL28 5DN, LL28 5DP, LL28 5DW, LL28 5EG, LL28 5HL, LL29 7LH",347,275,72
W00000835,LL28,"LL28 4AQ, LL28 4BJ, LL28 4SA, LL28 4YU, LL28 4YY, LL28 4ZF, LL28 4ZG, LL28 4ZJ, LL28 4ZN, LL28 4ZQ, LL28 4ZR, LL28 4ZS, LL28 4ZT",219,191,28
W00000828,LL28,"LL28 4JB, LL28 4NG, LL28 4NH, LL28 4NW, LL28 4PN, LL28 4PU, LL28 4PY, LL28 4QA, LL28 4RA, LL28 4RE",225,196,29
W00000827,LL28,"LL28 4LP, LL28 4LR, LL28 4LT, LL28 4LU, LL28 4LW, LL28 4LY, LL28 4NA, LL28 4NB, LL28 4NZ",260,210,50
W00000826,LL28,"LL28 4HZ, LL28 4LZ, LL28 4NJ, LL28 4RQ, LL28 4RX, LL28 4RZ, LL28 4YX",243,213,30
W00000974,LL28,"LL28 5EJ, LL28 5EN, LL28 5ET, LL28 5EW, LL28 5YN, LL28 5YR, LL28 5YS, LL28 5YT, LL29 6AB, LL29 6DN, LL29 6DZ, LL29 7RB, LL29 7RD, LL29 7RF, LL29 7RP",384,301,83
W00000973,LL28,"LL28 5YL, LL28 5YX, LL29 6AP, LL29 6DG, LL29 6DU",298,225,73
W00000825,LL28,"LL28 4DJ, LL28 4DQ, LL28 4EQ, LL28 4EW, LL28 4LA, LL28 4LB, LL28 4LE, LL28 4LG, LL28 4NF",421,358,63
W00000971,LL28,"LL28 5UJ, LL28 5UT, LL28 5UU, LL28 5UY, LL28 5UZ, LL28 5WF, LL28 5YA, LL28 5YH, LL28 5YJ, LL28 5YP, LL28 5YQ, LL28 5YU, LL28 5YY, LL28 5YZ, LL28 5ZA, LL28 5ZF, LL29 6AJ",445,364,81
W00000824,LL28,"LL28 4HY, LL28 4LD, LL28 4LF, LL28 4LH, LL28 4LL, LL28 4NE, LL28 4NY, LL28 4PF, LL28 4PG, LL28 4PH",225,190,35
W00000823,LL28,"LL28 4LN, LL28 4LS, LL28 4NP, LL28 4NR, LL28 4PA, LL28 4PW, LL28 4UN",241,211,30
W00000822,LL28,"LL28 4SN, LL28 4SP, LL28 4SW, LL28 4SY, LL28 4TA, LL28 4YH",227,195,32
W00000967,LL28,"LL28 5LR, LL29 7LE, LL29 7LF, LL29 7LG, LL29 7LN, LL29 7YA, LL29 7YB, LL29 7YE, LL29 7YF, LL29 7YH, LL29 7YJ, LL29 7YN, LL29 8RR",266,209,57
W00000963,LL28,"LL28 4BP, LL28 4BS, LL28 4BT, LL28 4EG, LL29 7LL, LL29 7LP, LL29 8PL, LL29 8PP, LL29 8PW, LL29 8RP, LL29 8RS",389,326,63
W00000961,LL28,"LL28 4DA, LL28 4DB, LL28 4DD, LL28 4DE, LL28 4DF, LL28 4DG, LL28 4DH, LL28 4DL, LL28 4DN, LL28 4DP, LL28 4DR, LL28 4DS, LL28 4DT, LL28 4DX, LL28 4DZ, LL28 4EE, LL28 4EF, LL28 4EL, LL28 4FB, LL28 4HR, LL28 4TD, LL28 4TE",476,391,85
W00000960,LL28,"LL28 4BL, LL28 4BN, LL28 4BU, LL28 4BY, LL28 4EH, LL28 4FD, LL28 4HP, LL28 4WX, LL28 4WZ, LL28 4XA, LL28 4XJ, LL28 4XQ, LL28 4XR, LL28 4ZA, LL28 4ZB, LL28 4ZD, LL28 4ZE, LL28 4ZH, LL28 4ZL, LL28 4ZP, LL28 4ZU, LL28 4ZW, LL28 4ZY, LL28 5WD, LL28 5WE, LL28 5WH, LL28 5WL, LL28 5WN, LL28 5WQ, LL28 5WR, LL28 5ZD, LL28 5ZE, LL28 5ZG, LL28 5ZH, LL28 5ZJ, LL28 5ZR, LL28 5ZS, LL28 5ZT, LL28 5ZW, LL28 5ZY, LL29 0AA, LL29 0AB, LL29 0AD, LL29 0AE, LL29 0AF, LL29 0AG, LL29 0AH, LL29 0AL, LL29 0AN, LL29 0AP, LL29 0AQ, LL29 0AR, LL29 0AS, LL29 0AT, LL29 0AU, LL29 0AW, LL29 0AX, LL29 0AY, LL29 0AZ, LL29 0BA, LL29 0BB, LL29 0BD, LL29 0BE, LL29 0BF, LL29 0BG, LL29 0BH, LL29 0BJ, LL29 0BL, LL29 0BN, LL29 0BP, LL29 0BQ, LL29 0BR, LL29 0BS, LL29 0BT, LL29 0BU, LL29 0BW, LL29 0BX, LL29 0BY, LL29 0BZ, LL29 0DA, LL29 0DB, LL29 0DD, LL29 0DE, LL29 0DF, LL29 0DG, LL29 0DH, LL29 0DJ, LL29 0DL, LL29 0DN, LL29 0DP, LL29 0DQ, LL29 0DR, LL29 0DS, LL29 0DT, LL29 0DU, LL29 0DW, LL29 0DX, LL29 0DY, LL29 0DZ, LL29 0EA, LL29 0EB, LL29 0ED, LL29 0EE, LL29 0EF, LL29 0EG, LL29 0EH, LL29 0EJ, LL29 0EL, LL29 0EN, LL29 0EP, LL29 0EQ, LL29 0ER, LL29 0ES, LL29 0ET, LL29 0EU, LL29 0EW, LL29 0EX, LL29 0EY, LL29 0EZ, LL29 0FA, LL29 0FB, LL29 0FD, LL29 0FE, LL29 0FG, LL29 0FH, LL29 0FJ, LL29 0FL, LL29 0FN, LL29 0FP, LL29 0FQ, LL29 0FR, LL29 0FS, LL29 0FT, LL29 0FU, LL29 0FW, LL29 0FX, LL29 0FY, LL29 0FZ, LL29 6AD, LL29 6ZB, LL29 6ZD, LL29 6ZE, LL29 6ZF, LL29 6ZH, LL29 6ZU, LL29 7BL, LL29 7YQ, LL29 7ZA, LL29 7ZB, LL29 7ZD, LL29 7ZE, LL29 7ZF, LL29 7ZG, LL29 7ZH, LL29 7ZJ, LL29 7ZL, LL29 7ZP, LL29 7ZW, LL29 8HT, LL29 8HW, LL29 8HY, LL29 8LA, LL29 8NT, LL29 8PD, LL29 8PE, LL29 8PF, LL29 8PH, LL29 8PJ, LL29 8PQ, LL29 8PS, LL29 8PT, LL29 8PX, LL29 8PZ, LL29 8RJ, LL29 8WA, LL29 8WB, LL29 8WD, LL29 8WE, LL29 8WG, LL29 8WH, LL29 8WJ, LL29 8WL, LL29 8WP, LL29 8WR, LL29 8WT, LL29 8WW, LL29 8WX, LL29 8WY, LL29 8WZ, LL29 8XA, LL29 8XL, LL29 8XP, LL29 8XR, LL29 8XT, LL29 8XU, LL29 8ZL, LL29 8ZP, LL29 8ZU, LL29 9YJ, LL29 9ZD, LL29 9ZE, LL29 9ZF, LL29 9ZH, LL29 9ZL, LL29 9ZP, LL29 9ZR, LL29 9ZS, LL29 9ZT, LL29 9ZU",357,314,43
W00000733,LL28,"LL28 5AJ, LL28 5AQ, LL28 5BL, LL28 5LP, LL28 5RG, LL28 5RH, LL28 5RN, LL28 5RQ, LL28 5TS, LL28 5TT, LL28 5TU, LL28 5TY, LL28 5UP",273,166,107
W00000892,LL28,"LL28 5AA, LL28 5AD, LL28 5AE, LL28 5AF, LL28 5AH, LL28 5YB, LL28 5YD, LL28 5YE, LL28 5YF",266,206,60
W00000891,LL28,"LL28 5AR, LL28 5AS, LL28 5AT, LL28 5AU, LL28 5AX, LL28 5AY, LL28 5BA, LL28 5BB, LL28 5BD, LL28 5BE, LL28 5EY, LL28 5HG, LL28 5HN, LL28 5HQ, LL28 5HU, LL28 5YW",285,217,68
W00000838,LL28,"LL28 4HF, LL28 4HG, LL28 4RN, LL28 4RP, LL28 4RS, LL28 4RT, LL28 4RU, LL28 4WY, LL28 4XS",267,205,62
W00000889,LL28,"LL28 5AP, LL28 5AW, LL28 5BG, LL28 5DZ, LL28 5YG",298,249,49
W00000858,LL28,"LL28 5HY, LL28 5LU, LL28 5NH, LL28 5NL",211,142,69
W00000859,LL28,"LL28 5EQ, LL28 5LQ, LL28 5NE, LL28 5NF",210,104,106
W00000860,LL28,"LL28 5NG, LL28 5NN, LL28 5PR, LL28 5PT, LL28 5PU, LL28 5PY",274,189,85
W00000855,LL28,"LL28 5BZ, LL28 5LF, LL28 5LH, LL28 5NJ, LL28 5NS, LL28 5NT, LL28 5NU, LL28 5NX, LL28 5NY, LL28 5PA, LL28 5WA, LL28 5WB, LL28 5WG, LL28 5WJ, LL28 5ZB",246,172,74
W00000854,LL28,"LL28 5EH, LL28 5HP, LL28 5HR, LL28 5HS, LL28 5LB, LL28 5LD, LL28 5LE, LL28 5LG, LL28 5NR, LL28 5PB, LL28 5PD, LL28 5PE, LL28 5PF, LL28 5PG, LL28 5PH, LL28 5PL, LL28 5PN, LL28 5PP, LL28 5PS, LL28 5PW, LL28 5RA, LL28 5RB, LL28 5SH, LL28 5SL, LL28 5TE, LL28 5TF, LL28 5TG, LL28 5TH, LL28 5TL, LL28 5TN, LL28 5TW, LL28 5WP, LL31 9SX",457,299,158
W00000853,LL28,"LL28 5ED, LL28 5LL, LL28 5LN, LL28 5LS, LL28 5LT, LL28 5LW, LL28 5LY, LL28 5NB, LL28 5SP, LL28 5SR, LL28 5SS, LL28 5ST, LL28 5SU, LL28 5SW, LL28 5SX",194,155,39
W00000848,LL28,"LL28 4FA, LL28 4HS, LL28 4NL, LL28 4NN, LL28 4NS, LL28 4NT",262,224,38
W00000847,LL28,"LL28 4HT, LL28 4HU, LL28 4ND, LL28 4NU, LL28 4PB, LL28 4PD, LL28 4PE, LL28 4QB",272,212,60
W00000846,LL28,"LL28 4AD, LL28 4AE, LL28 4AG, LL28 4AH, LL28 4AL, LL28 4AN, LL28 4AR, LL28 4AS, LL28 4AT, LL28 4AW, LL28 4AY, LL28 4BE, LL28 4BF, LL28 4BH",354,289,65
W00000845,LL28,"LL28 4AB, LL28 4TB, LL28 4TG, LL28 4TH, LL28 4TJ, LL28 4TL, LL28 4TN, LL28 4TP, LL28 4TT, LL28 4TW",235,199,36
W00000890,LL28,"LL28 5DG, LL28 5DL, LL28 5DY, LL28 5EA, LL28 5EB, LL28 5EE, LL28 5EF, LL28 5EU, LL28 5HA, LL28 5HB, LL28 5HD, LL28 5HE, LL28 5HF, LL28 5HH, LL28 5HT, LL28 5HW, LL28 5HX",403,317,86
W00000843,LL28,"LL28 4UU, LL28 4XH, LL28 4YA, LL28 4YB, LL28 4YD, LL28 4YE, LL28 4YF",262,211,51
W00000659,LL28,"LL28 5RJ, LL28 5RT, LL28 5RU, LL28 5RX, LL32 8PA, LL32 8SR, LL32 8ST, LL32 8SU, LL32 8SX, LL32 8SY, LL32 8SZ, LL32 8TA, LL32 8TB, LL32 8TJ, LL32 8TQ, LL32 8TW, LL32 8TX, LL32 8UQ",310,190,120
W00000844,LL28,"LL28 4AF, LL28 4AP, LL28 4AU, LL28 4BA, LL28 4BB, LL28 4BG, LL28 4TF",265,215,50
W00000857,LL28,"LL28 5BJ, LL28 5BX, LL28 5NP, LL28 5SY, LL28 5TA, LL28 5TB, LL28 5TD",233,169,64
W00000888,LL28,"LL28 5AG, LL28 5AL, LL28 5AN, LL28 5BN, LL28 5DF, LL28 5DS, LL28 5DT, LL28 5DU",335,273,62
W00000839,LL28,"LL28 4SG, LL28 4SH, LL28 4UG, LL28 4UP",247,186,61
W00000840,LL28,"LL28 4SR, LL28 4SS, LL28 4ST, LL28 4SU, LL28 4YG, LL28 4YJ, LL28 4YL, LL28 4YN, LL28 5BP, LL28 5BS, LL28 5BT",282,236,46
W00000841,LL28,"LL28 4DW, LL28 4DY, LL28 4EA, LL28 4EB, LL28 4ED, LL28 4ER, LL28 4ET, LL28 4EU, LL28 4HA",316,269,47
W00000842,LL28,"LL28 4HD, LL28 4HH, LL28 4HL, LL28 4HN, LL28 4HW, LL28 4RY",311,252,59
W00000774,LL29,"LL29 7SY, LL29 8AA, LL29 8AB, LL29 8BF, LL29 8BW, LL29 8BY, LL29 8DJ, LL29 8HN, LL29 8LT, LL29 8RA, LL29 8RH",227,184,43
W00000681,LL29,"LL29 9LT, LL29 9NB, LL29 9ND, LL29 9NE, LL29 9NH, LL29 9UP, LL29 9UW",263,221,42
W00000737,LL29,"LL29 8UN, LL29 8YB, LL29 8YH, LL29 8YQ, LL29 8YZ",236,179,57
W00000738,LL29,"LL29 9SP, LL29 9ST, LL29 9SU, LL29 9SY, LL29 9TA, LL29 9TD",293,212,81
W00000739,LL29,"LL29 9BY, LL29 9LN, LL29 9PG, LL29 9RP, LL29 9RR, LL29 9RS, LL29 9RT, LL29 9RU",215,166,49
W00000747,LL29,"LL29 9PH, LL29 9SD, LL29 9SE, LL29 9SF, LL29 9SG, LL29 9SH, LL29 9SL, LL29 9SN, LL29 9SR, LL29 9SW, LL29 9TB",338,258,80
W00000743,LL29,"LL29 8BB, LL29 8BD, LL29 8BE, LL29 8HU, LL29 8WS, LL29 8WU, LL29 9TP, LL29 9TR, LL29 9TU, LL29 9TY, LL29 9UB, LL29 9UD",339,264,75
W00000874,LL29,"LL29 8PG, LL29 8SY, LL29 8SZ, LL29 8TA, LL29 8UG",287,229,58
W00000740,LL29,"LL29 9PF, LL29 9SS, LL29 9TE, LL29 9TF, LL29 9TH, LL29 9TN, LL29 9TW, LL29 9YF, LL29 9YH",260,215,45
W00000868,LL29,"LL29 8AX, LL29 8AZ, LL29 8DQ, LL29 8DX, LL29 8SB, LL29 8SE, LL29 8SG, LL29 8SJ, LL29 8SL, LL29 8SN, LL29 8SP, LL29 8SR, LL29 8SW, LL29 8TU, LL29 8TX, LL29 8TY, LL29 8UA, LL29 8UB, LL29 8UD, LL29 8UE, LL29 8UF, LL29 8UH",268,190,78
W00000869,LL29,"LL29 8BH, LL29 8EF, LL29 8FL, LL29 8LE, LL29 8TB, LL29 8TJ",316,252,64
W00000741,LL29,"LL29 8AD, LL29 8AE, LL29 8AF, LL29 8AG, LL29 8AL, LL29 8AN, LL29 8AS, LL29 8AU, LL29 8AY, LL29 8BA, LL29 8BG",346,264,82
W00000680,LL29,"LL29 8YF, LL29 8YJ, LL29 9AH, LL29 9AJ, LL29 9EY, LL29 9HA, LL29 9HB, LL29 9HD, LL29 9HE, LL29 9HF, LL29 9HG, LL29 9HH, LL29 9HJ, LL29 9HL, LL29 9HN",305,265,40
W00000679,LL29,"LL29 9AA, LL29 9AB, LL29 9AD, LL29 9AF, LL29 9AG, LL29 9DF, LL29 9DG, LL29 9DH, LL29 9DJ, LL29 9DW, LL29 9EA, LL29 9ET, LL29 9EU, LL29 9PA, LL29 9RD",260,218,42
W00000678,LL29,"LL29 8BT, LL29 9LP, LL29 9LR, LL29 9LS, LL29 9LU, LL29 9LW, LL29 9NA, LL29 9PD, LL29 9PL, LL29 9UR, LL29 9UT, LL29 9UU, LL29 9UY, LL29 9YA",272,217,55
W00000742,LL29,"LL29 9TG, LL29 9TS, LL29 9TT, LL29 9UA, LL29 9UF, LL29 9YG",205,161,44
W00000744,LL29,"LL29 8PA, LL29 8TZ, LL29 8UJ, LL29 8WF, LL29 8WN, LL29 8WQ, LL29 8YG, LL29 8ZA, LL29 9UE, LL29 9UG, LL29 9UH, LL29 9UL",227,200,27
W00000872,LL29,"LL29 9BS, LL29 9DD, LL29 9HX, LL29 9LH, LL29 9LL, LL29 9YN",409,342,67
W00000873,LL29,"LL29 9BA, LL29 9DL, LL29 9EG, LL29 9LG, LL29 9PT",346,307,39
W00000745,LL29,"LL29 8NY, LL29 8PY, LL29 8RU, LL29 8UR, LL29 8US, LL29 8UT, LL29 8UW, LL29 8UZ, LL29 8YD, LL29 8YL, LL29 8YN",292,217,75
W00000746,LL29,"LL29 8EE, LL29 8EN, LL29 8LL, LL29 8NG, LL29 8UL, LL29 8UP, LL29 8UQ, LL29 8UX",446,307,139
W00000775,LL29,"LL29 6AA, LL29 8QA, LL29 8QB, LL29 8RD, LL29 8RF, LL29 8RG, LL29 8RY, LL29 8RZ, LL29 8YP, LL29 8YW",302,224,78
W00000736,LL29,"LL29 8AH, LL29 8AT, LL29 8PN, LL29 8RL, LL29 8RN, LL29 8TN",268,218,50
W00000772,LL29,"LL29 7ET, LL29 7EY, LL29 7HB, LL29 7RL, LL29 7TR, LL29 7TT",269,211,58
W00000771,LL29,"LL29 7PU, LL29 7RA, LL29 7ST, LL29 7SU, LL29 8PU, LL29 8RB, LL29 8RE, LL29 8RQ, LL29 8RT, LL29 8RW, LL29 8RX",446,330,116
W00000770,LL29,"LL29 7RS, LL29 8AP, LL29 8AR, LL29 8AW, LL29 8BN, LL29 8BU, LL29 8DA, LL29 8DD, LL29 8DE, LL29 8DG, LL29 8DH, LL29 8DL, LL29 8DN, LL29 8DS, LL29 8DT, LL29 8DU, LL29 8DW, LL29 8ED, LL29 8EQ, LL29 8ET, LL29 8FQ, LL29 8GA, LL29 8HD, LL29 8HF, LL29 8HG, LL29 8HH, LL29 8NR",330,274,56
W00000769,LL29,"LL29 7EN, LL29 7ER, LL29 7EU, LL29 7RW, LL29 7TP, LL29 7TS, LL29 7UG",367,301,66
W00000965,LL29,"LL29 7AE, LL29 7AR, LL29 7AY, LL29 7BA, LL29 7BE, LL29 7BF, LL29 7BG, LL29 7BH, LL29 7BJ, LL29 7BN, LL29 7BP, LL29 7BQ, LL29 7BS, LL29 7BT, LL29 7BW, LL29 7DN, LL29 7DP, LL29 7DR, LL29 7DY, LL29 7NS, LL29 7PB, LL29 7UP, LL29 7UU, LL29 7UY, LL29 7WA, LL29 7YD, LL29 7YL, LL29 7YP, LL29 7YT, LL29 7YW, LL29 8LS",475,405,70
W00000968,LL29,"LL29 7AG, LL29 7AN, LL29 7AS, LL29 7AT, LL29 7AU, LL29 7AW, LL29 7AZ, LL29 7BU, LL29 7BY, LL29 7DA, LL29 7DB, LL29 7DD, LL29 7EB, LL29 7HR, LL29 7HY, LL29 7LA, LL29 7LB, LL29 7NP, LL29 8LP, LL29 8LR, LL29 8LU, LL29 8ND, LL29 8NN, LL29 8NQ",250,213,37
W00000969,LL29,"LL29 6AE, LL29 6AH, LL29 6AL, LL29 6AN, LL29 6DD, LL29 6DL, LL29 6DY, LL29 6HD",314,242,72
W00000970,LL29,"LL29 7AD, LL29 7AH, LL29 7AP, LL29 7DH, LL29 7DL, LL29 7DT, LL29 7DU, LL29 7EA, LL29 7HS, LL29 7NN, LL29 7NR, LL29 7NT, LL29 7NU, LL29 7NW, LL29 7NY, LL29 7WB, LL29 7WY, LL29 8BP, LL29 8DB, LL29 8DF, LL29 8FP, LL29 8LD, LL29 8LF, LL29 8LG, LL29 8LH, LL29 8LN, LL29 8LW, LL29 8PR",297,259,38
W00000972,LL29,"LL29 6AF, LL29 6AG, LL29 7BB, LL29 7BD, LL29 7EP, LL29 7ES, LL29 7HA, LL29 7HD, LL29 7HE, LL29 7HF, LL29 7RG",318,257,61
W00000975,LL29,"LL29 6AR, LL29 6AW, LL29 6DA, LL29 6DB, LL29 6DF, LL29 6HB",276,214,62
W00000773,LL29,"LL29 7PT, LL29 7PY, LL29 7RE, LL29 7RH, LL29 7RN, LL29 7SH, LL29 7UH, LL29 7UN, LL29 7UW",283,222,61
W00000976,LL29,"LL29 6DJ, LL29 6DQ, LL29 6DT, LL29 6DX, LL29 6EA, LL29 6EB, LL29 6ED, LL29 6EE, LL29 6EF, LL29 6ZA",330,266,64
W00000675,LL29,"LL29 9BU, LL29 9DS, LL29 9PP, LL29 9PR, LL29 9PS, LL29 9PU, LL29 9PY, LL29 9RF",294,232,62
W00000674,LL29,"LL29 9AL, LL29 9AN, LL29 9HP, LL29 9HR, LL29 9HS, LL29 9HW, LL29 9LE, LL29 9LF, LL29 9YP",328,277,51
W00000673,LL29,"LL29 8BL, LL29 9AP, LL29 9AR, LL29 9AW, LL29 9HU, LL29 9HY, LL29 9JA, LL29 9LA, LL29 9LB, LL29 9LD, LL29 9LJ, LL29 9LQ",399,347,52
W00000672,LL29,"LL29 9AS, LL29 9AT, LL29 9AU, LL29 9AY, LL29 9BD, LL29 9BE, LL29 9BT, LL29 9ER",330,288,42
W00000671,LL29,"LL29 9AE, LL29 9BH, LL29 9BL, LL29 9BN, LL29 9BQ, LL29 9BW, LL29 9DN",277,233,44
W00000670,LL29,"LL29 8BS, LL29 9EF, LL29 9EH, LL29 9EL, LL29 9EN, LL29 9PN, LL29 9PW, LL29 9RG, LL29 9RH, LL29 9RL, LL29 9RN, LL29 9RW, LL29 9RY",275,226,49
W00000669,LL29,"LL29 9BB, LL29 9BG, LL29 9BP, LL29 9DY, LL29 9EB, LL29 9ED, LL29 9EE",299,250,49
W00000668,LL29,"LL29 8EX, LL29 8YE, LL29 9DA, LL29 9NJ, LL29 9NS, LL29 9NT, LL29 9NU, LL29 9NY, LL29 9PB, LL29 9RA, LL29 9UN",479,329,150
W00000767,LL29,"LL29 7PF, LL29 7PW, LL29 7RR, LL29 7TN, LL29 7TY, LL29 7UA, LL29 7UB",294,225,69
W00000768,LL29,"LL29 7TU, LL29 7UD, LL29 7UE, LL29 7UF, LL29 7UL",288,222,66
W00000977,LL29,"LL29 6DH, LL29 6DP",236,180,56
W00000964,LL29,"LL29 7AJ, LL29 7AQ, LL29 7NB, LL29 7ND, LL29 7NE, LL29 7NF, LL29 7NG, LL29 7YR, LL29 7YS, LL29 7YU, LL29 7YY, LL29 7ZN",390,312,78
W00000966,LL29,"LL29 7AA, LL29 7AB, LL29 7AF, LL29 7AL, LL29 7HT, LL29 7HU, LL29 7LD, LL29 8LB, LL29 8LY, LL29 8NA, LL29 8NB, LL29 8NE, LL29 8NF, LL29 8NH, LL29 8NL, LL29 8NP, LL29 8NS, LL29 8NW, LL29 8NZ, LL29 8PB",268,223,45
W00000765,LL29,"LL29 7DS, LL29 7ED, LL29 7EE, LL29 7PA, LL29 7PE, LL29 7PG, LL29 7PP, LL29 7PR, LL29 7RT, LL29 7RU, LL29 7SA, LL29 7SE, LL29 7TF, LL29 8DP, LL29 8DR, LL29 8EL",296,248,48
W00000778,LL29,"LL29 7EF, LL29 7EG, LL29 7EH, LL29 7EL, LL29 7EW, LL29 7PD, LL29 7PH, LL29 7PL, LL29 7PN, LL29 7SB, LL29 7TE, LL29 7TG, LL29 7TH, LL29 7TL, LL29 7TW, LL29 8EG",305,242,63
W00000777,LL29,"LL29 8EA, LL29 8EB, LL29 8ES, LL29 8HE, LL29 8HL",227,185,42
W00000776,LL29,"LL29 7PS, LL29 7PX, LL29 7SD, LL29 7SF, LL29 8DY, LL29 8EP, LL29 8ER, LL29 8EW, LL29 8EY",405,351,54
W00000766,LL29,"LL29 7SG, LL29 7SL, LL29 7SN, LL29 7SP, LL29 7SR, LL29 7SS, LL29 7SW, LL29 8EU, LL29 8HA, LL29 8HB, LL29 8HJ",337,280,57
W00000677,LL29,"LL29 9LY, LL29 9NF, LL29 9NG, LL29 9NL, LL29 9NN, LL29 9NP, LL29 9NR, LL29 9NW",322,253,69
W00000959,LL29,"LL29 6DE, LL29 6DR, LL29 6DS, LL29 6DW",304,244,60
W00000676,LL29,"LL29 9DB, LL29 9DE, LL29 9DP, LL29 9DR, LL29 9DT, LL29 9DU, LL29 9EW, LL29 9RB, LL29 9RE, LL29 9ZG, LL29 9ZJ, LL29 9ZN, LL29 9ZQ",324,238,86
W00000962,LL29,"LL29 7AX, LL29 7LR, LL29 7LS, LL29 7LT, LL29 7LU, LL29 7LW, LL29 7LY, LL29 7NA, LL29 7YG",314,263,51
W00000702,LL30,"LL30 1TJ, LL30 1UA, LL30 1UB, LL30 1UE, LL30 1UR, LL30 1US, LL30 1UT, LL30 1UU, LL30 1XX, LL30 3BD",284,229,55
W00000703,LL30,"LL30 1AJ, LL30 1AU, LL30 1PP, LL30 1PZ, LL30 1UH, LL30 1UJ, LL30 1UX, LL30 1UZ, LL30 1YW",211,170,41
W00000704,LL30,"LL30 3AA, LL30 3AB, LL30 3AD, LL30 3AE, LL30 3AJ, LL30 3AL, LL30 3AN, LL30 3AP, LL30 3AW, LL30 3BG",170,143,27
W00000705,LL30,"LL30 1BF, LL30 1BG, LL30 1BH, LL30 1BN, LL30 1DJ, LL30 1DQ, LL30 1LX",258,212,46
W00000721,LL30,"LL30 1NA, LL30 1NY, LL30 1PA, LL30 1PE, LL30 1PF",204,168,36
W00001004,LL30,"LL30 1AH, LL30 1AL, LL30 1AN, LL30 1AR, LL30 1AS, LL30 1AT, LL30 1AW, LL30 1AY, LL30 1BA, LL30 1BB, LL30 1BU, LL30 1BZ, LL30 1HA, LL30 1PX, LL30 1RT, LL30 1TP, LL30 1XA, LL30 1YG, LL30 1YN, LL30 1YR, LL30 1YT",315,278,37
W00000706,LL30,"LL30 1BW, LL30 1DZ, LL30 1LZ",198,167,31
W00000707,LL30,"LL30 1AX, LL30 1AZ, LL30 1BD, LL30 1BE, LL30 1BJ, LL30 1BX, LL30 1LJ, LL30 1LQ, LL30 1WY, LL30 1YS, LL30 1YU",233,191,42
W00000708,LL30,"LL30 1AQ, LL30 1EJ, LL30 1EQ, LL30 1EZ, LL30 1PQ, LL30 1TF, LL30 1TG, LL30 1YY",258,214,44
W00001003,LL30,"LL30 1NJ, LL30 1NX, LL30 1PH, LL30 1PR, LL30 1PS, LL30 1PT, LL30 1PU, LL30 1QA, LL30 1RG",246,185,61
W00000709,LL30,"LL30 1TA, LL30 1TB, LL30 1TD, LL30 1TE, LL30 1TH, LL30 1TL",222,185,37
W00001002,LL30,"LL30 1GB, LL30 1GD, LL30 1GE, LL30 1GF, LL30 1GG, LL30 1LT, LL30 1ND",327,274,53
W00001001,LL30,"LL30 1JA, LL30 1JB, LL30 1JE, LL30 1JF, LL30 1JW, LL30 1LA, LL30 1LB, LL30 1LG, LL30 1NN, LL30 1NP, LL30 1NW",406,330,76
W00001000,LL30,"LL30 1GZ, LL30 1HZ, LL30 1JX, LL30 1LH, LL30 1LL, LL30 1QE, LL30 1RH, LL30 1RQ, LL30 1ZW",275,225,50
W00000999,LL30,"LL30 1HE, LL30 1HG, LL30 1HH, LL30 1HL, LL30 1HN, LL30 1HP, LL30 1HR, LL30 1HS, LL30 1HT, LL30 1HU, LL30 1HW, LL30 1HY, LL30 1QY",285,239,46
W00001005,LL30,"LL30 1TN, LL30 1TQ, LL30 1TX, LL30 1YA",231,194,37
W00001006,LL30,"LL30 1DB, LL30 1DR, LL30 1DU, LL30 1DY, LL30 1EB, LL30 1ED, LL30 1EE, LL30 1EF, LL30 1EG, LL30 1FB, LL30 1PJ",275,221,54
W00000701,LL30,"LL30 3AQ, LL30 3AR, LL30 3AS, LL30 3AT, LL30 3AU, LL30 3AX, LL30 3AY, LL30 3BA, LL30 3BB, LL30 3BE, LL30 3BF, LL30 3DS, LL30 3DT, LL30 3DU",244,201,43
W00000780,LL30,"LL30 2BT, LL30 2BU, LL30 2WA, LL30 2YG, LL30 2YP, LL30 2YR, LL30 2ZE, LL30 2ZF",271,227,44
W00000691,LL30,"LL30 9AF, LL30 9AL, LL30 9AZ, LL30 9SA, LL30 9SB, LL30 9YX, LL30 9YY, LL30 9ZX, LL30 9ZY, LL30 9ZZ, LL32 8AD, LL32 8AF, LL32 8AG, LL32 8AL, LL32 8AS, LL32 8AT, LL32 8AU, LL32 8AY, LL32 8BB, LL32 8BD, LL32 8BE, LL32 8BG, LL32 8BW, LL32 8BY, LL32 8DB, LL32 8DF, LL32 8DG, LL32 8DU, LL32 8HR, LL32 8HT, LL32 8HY, LL32 8LD, LL32 8RG, LL32 8UB, LL32 8WT, LL32 8WY, LL32 8XR",215,155,60
W00000792,LL30,"LL30 2AH, LL30 2DH, LL30 2DL, LL30 2DN, LL30 2SE, LL30 2UN",212,189,23
W00000791,LL30,"LL30 2DG, LL30 2FD, LL30 2YB, LL30 2YH, LL30 2YW",236,194,42
W00000875,LL30,"LL30 1RS, LL31 9AX, LL31 9AZ, LL31 9BF, LL31 9FP, LL31 9FQ, LL31 9HB, LL31 9HD, LL31 9JA, LL31 9NQ",376,276,100
W00000790,LL30,"LL30 2DW, LL30 2EA, LL30 2ED, LL30 2EE, LL30 2EF, LL30 2EG, LL30 2EP, LL30 2HF",245,198,47
W00000789,LL30,"LL30 2DD, LL30 2LL, LL30 2LN, LL30 2LR, LL30 2ND, LL30 2NP, LL30 2NR, LL30 2NY, LL30 2PA, LL30 2PB, LL30 2PD, LL30 2PE, LL30 2PL, LL30 2PN, LL30 2SB, LL30 2SH, LL30 2SN, LL30 2SR, LL30 2SS, LL30 2ST, LL30 2SU, LL30 2SY, LL30 2UP, LL30 2UT, LL30 2UY, LL30 2WY, LL30 2YA",320,289,31
W00000697,LL30,"LL30 1BQ, LL30 1DT, LL30 1DX, LL30 1RU, LL30 1TY, LL30 1UD, LL30 1UF, LL30 1UG, LL30 1UQ",243,209,34
W00000698,LL30,"LL30 1UL, LL30 1UN, LL30 1UP, LL30 1UW, LL30 1YB",291,227,64
W00000699,LL30,"LL30 1BP, LL30 1BS, LL30 1BT, LL30 1EX, LL30 1UY, LL30 1YD, LL30 1YE, LL30 1YF",308,241,67
W00000788,LL30,"LL30 2EU, LL30 2EY, LL30 2HA, LL30 2HB, LL30 2HG, LL30 2HH, LL30 2HL, LL30 2HN, LL30 2HR, LL30 2HU, LL30 2HW, LL30 2HY",239,198,41
W00000998,LL30,"LL30 1HX, LL30 1NQ, LL30 1NZ, LL30 1RZ, LL30 1SQ",208,168,40
W00000700,LL30,"LL30 1TR, LL30 1TS, LL30 1TT, LL30 1TU, LL30 1TW, LL30 1TZ, LL30 1YJ, LL30 1YQ",330,264,66
W00000787,LL30,"LL30 2JN, LL30 2JP, LL30 2JR, LL30 2JS, LL30 2JU, LL30 2QA, LL30 2QB, LL30 2QD, LL30 2QE, LL30 2QZ, LL30 2XA, LL30 2XB, LL30 2XD, LL30 2XE, LL30 2XF, LL30 2XG",245,212,33
W00000786,LL30,"LL30 2DR, LL30 2DS, LL30 2DT, LL30 2DU, LL30 2DY, LL30 2EB, LL30 2ER, LL30 2HD, LL30 2HE, LL30 2LP, LL30 2LS, LL30 2LW, LL30 2NA, LL30 2PF, LL30 2PH, LL30 2PW, LL30 2SD, LL30 2SP, LL30 2SW",267,240,27
W00000785,LL30,"LL30 2JH, LL30 2JJ, LL30 2JL, LL30 2JT, LL30 2JW, LL30 2JX, LL30 2JY, LL30 2JZ, LL30 2QF, LL30 2QG, LL30 2QH, LL30 2QJ, LL30 2QL, LL30 2QP, LL30 2QS",233,184,49
W00000784,LL30,"LL30 2BA, LL30 2BJ, LL30 2BN, LL30 2BS, LL30 2DB",168,145,23
W00000783,LL30,"LL30 2AJ, LL30 2AL, LL30 2AP, LL30 2AZ, LL30 2EH, LL30 2EL, LL30 2EN",237,214,23
W00000782,LL30,"LL30 2AG, LL30 2AN, LL30 2AR, LL30 2AS, LL30 2AT, LL30 2AU, LL30 2AW, LL30 2AX, LL30 2AY, LL30 2BB, LL30 2BE, LL30 2BP, LL30 2BW, LL30 2ET, LL30 2FB, LL30 2QY",343,296,47
W00000781,LL30,"LL30 2HP, LL30 2HS, LL30 2HT, LL30 2LT, LL30 2LU, LL30 2LY, LL30 2NB, LL30 2NE, LL30 2QN, LL30 2QQ, LL30 2QR, LL30 2QW",208,173,35
W00000779,LL30,"LL30 2DF, LL30 2DP, LL30 2YD, LL30 2YE, LL30 2YF, LL30 2YL, LL30 2YN",251,198,53
W00000997,LL30,"LL30 1PG, LL30 1SJ, LL30 1SX, LL30 1SZ",230,197,33
W00000719,LL30,"LL30 1JJ, LL30 1NR, LL30 1NS, LL30 1NT, LL30 1NU, LL30 1PL",244,189,55
W00000995,LL30,"LL30 1EH, LL30 1EN, LL30 1ER, LL30 1EW, LL30 1LP",288,215,73
W00000924,LL30,"LL30 3LY, LL30 3NA, LL30 3NB, LL30 3ND, LL30 3NH, LL30 3PP",224,187,37
W00000996,LL30,"LL30 1HJ, LL30 1HQ, LL30 1LN, LL30 1RJ, LL30 1RX, LL30 1ST, LL30 1SU, LL30 1ZG, LL30 1ZH, LL30 1ZL",264,208,56
W00000926,LL30,"LL30 3NY, LL30 3PG, LL30 3PH, LL30 3PL, LL30 3PR, LL30 3PS, LL30 3PT, LL30 3PU",269,209,60
W00000927,LL30,"LL30 3EH, LL30 3EP, LL30 3EW, LL30 3HA, LL30 3LG, LL30 3NL, LL30 3NN, LL30 3NP, LL30 3NW, LL30 3ZD, LL30 3ZE, LL30 3ZF, LL30 3ZJ, LL30 3ZL, LL30 3ZN",318,247,71
W00000928,LL30,"LL30 3ES, LL30 3EU, LL30 3EY, LL30 3EZ, LL30 3HD, LL30 3HE",262,191,71
W00000929,LL30,"LL30 3LN, LL30 3LP, LL30 3LR, LL30 3LS, LL30 3LT, LL30 3LW, LL30 3PW",250,199,51
W00000930,LL30,"LL30 3ER, LL30 3HB, LL30 3HF, LL30 3HG, LL30 3HH, LL30 3HX",220,181,39
W00000931,LL30,"LL30 3ET, LL30 3FB, LL30 3FD, LL30 3FF, LL30 3FG",264,198,66
W00000923,LL30,"LL30 3BH, LL30 3BL, LL30 3BN, LL30 3DB, LL30 3DD, LL30 3DY, LL30 3EE, LL30 3EF, LL30 3EG, LL30 3RD",206,174,32
W00000932,LL30,"LL30 1RD, LL30 1RN, LL30 3DR, LL31 9JG, LL31 9JH, LL31 9JJ, LL31 9JL, LL31 9JQ, LL31 9JT, LL31 9JU, LL31 9JX, LL31 9JY, LL31 9JZ, LL31 9QA, LL31 9QB, LL31 9QD, LL31 9QF",379,280,99
W00000934,LL30,"LL30 3AZ, LL30 3HR, LL30 3HS, LL30 3HT, LL30 3HU, LL30 3HW, LL30 3HZ, LL30 3LE, LL30 3LF",284,213,71
W00000935,LL30,"LL30 3EQ, LL30 3FA, LL30 3FH, LL30 3FJ, LL30 3HY, LL30 3LA, LL30 3LB, LL30 3LD, LL31 9JN, LL31 9JP, LL31 9JR, LL31 9JS, LL31 9JW",250,182,68
W00000936,LL30,"LL30 3AF, LL30 3AG, LL30 3AH, LL30 3ED, LL30 3NR, LL30 3NS, LL30 3RA, LL30 3RS, LL30 3RT, LL30 3RU, LL30 3RW",226,190,36
W00000937,LL30,"LL30 3PB, LL30 3PD, LL30 3PE, LL30 3PY, LL30 3RB, LL30 3RE, LL30 3RF, LL30 3RG, LL30 3RH, LL30 3RL, LL30 3RN",231,211,20
W00000726,LL30,"LL30 1RB, LL30 1RF, LL30 1RW, LL30 1SA, LL30 1SH, LL30 1SL, LL30 1SN, LL30 1SP, LL30 1SR, LL30 1SS, LL30 1SW",300,222,78
W00000725,LL30,"LL30 1JL, LL30 1NB, LL30 1NF, LL30 1NG, LL30 1NL",244,200,44
W00000723,LL30,"LL30 1PD, LL31 9BN, LL31 9BP, LL31 9BW, LL31 9DN, LL31 9HQ",229,182,47
W00000722,LL30,"LL30 1JU, LL30 1NE, LL30 1NH, LL30 1PB",247,208,39
W00000933,LL30,"LL30 3EL, LL30 3EN, LL30 3HL, LL30 3HN, LL30 3HP, LL30 3LH, LL30 3LL, LL30 3LU, LL30 3NE, LL30 3NF",270,218,52
W00000922,LL30,"LL30 3BP, LL30 3BS, LL30 3BT, LL30 3BU, LL30 3BW, LL30 3BY, LL30 3DA, LL30 3DE, LL30 3DF, LL30 3DG, LL30 3DH, LL30 3DL, LL30 3DN, LL30 3DW, LL30 3DX, LL30 3EA, LL30 3EX, LL30 3FQ",290,225,65
W00000925,LL30,"LL30 3NT, LL30 3NU, LL30 3PA, LL30 3PF, LL30 3PN",239,188,51
W00000898,LL30,"LL30 1DA, LL30 2FA, LL30 2RW, LL30 2SJ, LL30 2SQ, LL30 2UE, LL30 2UG, LL30 2UH, LL30 2UL",297,242,55
W00000994,LL30,"LL30 1EL, LL30 1EP, LL30 1ES, LL30 1HB, LL30 1JH",272,215,57
W00000894,LL30,"LL30 2AD, LL30 2AE, LL30 2AF, LL30 2DA, LL30 2DE, LL30 2FE, LL30 2NG, LL30 2NJ, LL30 2NN, LL30 2NQ, LL30 2NT, LL30 2NW, LL30 2NX, LL30 2NZ, LL30 2PT, LL30 2PU, LL30 2RA, LL30 2RB, LL30 2RD, LL30 2RE, LL30 2RF, LL30 2RG, LL30 2RH, LL30 2RL, LL30 2RN, LL30 2RP, LL30 2RS, LL30 2RT, LL30 2RU, LL30 2RX, LL30 2RY, LL30 2SA, LL30 2SF, LL30 2SG, LL30 2TB, LL30 2TD, LL30 2TE, LL30 2TG, LL30 2TH, LL30 2TL, LL30 2TS, LL30 2TT, LL30 2TW, LL30 2UA, LL30 2UR, LL30 2UU",283,244,39
W00000895,LL30,"LL30 1AF, LL30 1AP, LL30 2AA, LL30 2AB, LL30 2LD, LL30 2LE, LL30 2LF, LL30 2LG, LL30 2LH, LL30 2NF, LL30 2NL, LL30 2NS, LL30 2PR, LL30 2PS, LL30 2PY, LL30 2XS, LL30 2XT",227,189,38
W00000896,LL30,"LL30 2RR, LL30 2TP, LL30 2TR, LL30 2TU, LL30 2TY, LL30 2UB, LL30 2UD, LL30 2UF, LL30 2UW",293,247,46
W00000897,LL30,"LL30 2JF, LL30 2YS, LL30 2YT, LL30 2YY",224,179,45
W00000921,LL30,"LL30 1HF, LL30 3DP, LL30 3EJ, LL30 3FE, LL30 3FL, LL30 3FN, LL30 3FP",294,229,65
W00000899,LL30,"LL30 2BD, LL30 2BF, LL30 2BG, LL30 2BH, LL30 2BL, LL30 2BY, LL30 2EJ, LL30 2JB, LL30 2PQ",228,200,28
W00000900,LL30,"LL30 2BQ, LL30 2RJ, LL30 2SZ, LL30 2TQ, LL30 2YU",174,152,22
W00000901,LL30,"LL30 2BX, LL30 2LJ, LL30 2LQ, LL30 2LX, LL30 2TA, LL30 2TJ, LL30 2TN, LL30 2TZ, LL30 2UJ, LL30 2UQ",234,188,46
W00000903,LL30,"LL30 2DJ, LL30 2JD, LL30 2JE, LL30 2TX, LL30 2UX, LL30 2UZ, LL30 2YQ",349,300,49
W00000720,LL30,"LL30 1PY, LL30 1QB, LL30 1QD, LL30 1QF, LL30 1QG, LL30 1QH, LL30 1QQ, LL30 1RP, LL30 1RR, LL30 1SB, LL30 1SD, LL30 1SE, LL30 1SF, LL30 1SG",307,252,55
W00000904,LL30,"LL30 2BZ, LL30 2DQ, LL30 2LZ",324,247,77
W00000993,LL30,"LL30 1BL, LL30 1ET, LL30 1EU, LL30 1EY, LL30 1LR, LL30 1LS, LL30 1PN, LL30 1RY, LL30 2NU, LL30 2PG, LL30 2SL, LL30 2SX, LL30 2TF",252,204,48
W00000905,LL30,"LL30 2DZ, LL30 2ES, LL30 2HJ, LL30 2HQ, LL30 2HX, LL30 2PJ, LL30 2PX, LL30 2PZ",308,257,51
W00000906,LL30,"LL30 2DX, LL30 2EW, LL30 2HZ, LL30 2RQ",278,239,39
W00000990,LL30,"LL30 1BY, LL30 1LE, LL30 1LF, LL30 1LU, LL30 1LW, LL30 1QX, LL30 1QZ, LL30 1WA, LL30 1WB, LL30 1WD, LL30 1WE, LL30 1WQ, LL30 1WS, LL30 1WW, LL30 1WX, LL30 1WZ, LL30 1YH, LL30 1ZA, LL30 1ZB, LL30 1ZD, LL30 1ZE, LL30 1ZF, LL30 1ZJ, LL30 1ZN, LL30 1ZP, LL30 1ZQ, LL30 1ZR, LL30 1ZS, LL30 1ZT, LL30 1ZU, LL30 1ZY, LL30 2AQ, LL30 2WB, LL30 2WG, LL30 2WJ, LL30 2WL, LL30 2WQ, LL30 2WR, LL30 2WS, LL30 2WT, LL30 2WU, LL30 2WW, LL30 2WX, LL30 2ZA, LL30 2ZB, LL30 2ZD, LL30 2ZG, LL30 2ZH, LL30 2ZJ, LL30 2ZL, LL30 2ZN, LL30 2ZP, LL30 2ZQ, LL30 2ZR, LL30 2ZS, LL30 2ZT, LL30 3WZ, LL30 3ZA, LL30 3ZB, LL30 3ZG, LL30 3ZH, LL30 3ZP, LL30 3ZQ, LL30 3ZR, LL30 3ZT, LL30 9AA, LL30 9AB, LL30 9AD, LL30 9AE, LL30 9AG, LL30 9AH, LL30 9AJ, LL30 9AN, LL30 9AP, LL30 9AQ, LL30 9AR, LL30 9AS, LL30 9AT, LL30 9AU, LL30 9AW, LL30 9AX, LL30 9AY, LL30 9BA, LL30 9BB, LL30 9BD, LL30 9BE, LL30 9BF, LL30 9BG, LL30 9BH, LL30 9BJ, LL30 9BL, LL30 9BN, LL30 9BP, LL30 9BQ, LL30 9BR, LL30 9BS, LL30 9BT, LL30 9BU, LL30 9BW, LL30 9BX, LL30 9BY, LL30 9BZ, LL30 9DA, LL30 9DB, LL30 9DD, LL30 9DE, LL30 9DF, LL30 9DG, LL30 9DH, LL30 9DJ, LL30 9DL, LL30 9DN, LL30 9DP, LL30 9DQ, LL30 9DR, LL30 9DS, LL30 9DT, LL30 9DU, LL30 9DW, LL30 9DX, LL30 9DY, LL30 9DZ, LL30 9EA, LL30 9EB, LL30 9ED, LL30 9EE, LL30 9EF, LL30 9EG, LL30 9EH, LL30 9EJ, LL30 9EL, LL30 9EN, LL30 9EP, LL30 9EQ, LL30 9ER, LL30 9ES, LL30 9ET, LL30 9EW, LL30 9EX, LL30 9EY, LL30 9EZ, LL30 9FA, LL30 9FB, LL30 9FD, LL30 9FE, LL30 9FF, LL30 9FG, LL30 9FH, LL30 9FJ, LL30 9FL, LL30 9FN, LL30 9FP, LL30 9FQ, LL30 9FR, LL30 9FS, LL30 9FT, LL30 9FU, LL30 9FW, LL30 9FX, LL30 9FY, LL30 9FZ, LL30 9GA, LL30 9GB, LL30 9GD, LL30 9GE, LL30 9GF, LL30 9GG, LL30 9GH, LL30 9GJ, LL30 9GL, LL30 9GN, LL30 9GQ, LL30 9GR, LL30 9GT, LL30 9GU, LL30 9GW, LL30 9GX, LL30 9GY, LL30 9GZ, LL30 9HA, LL30 9HB, LL30 9HD, LL31 9RR, LL31 9WA, LL31 9WW, LL31 9WX, LL31 9WZ, LL31 9XL, LL31 9YE, LL31 9ZA, LL31 9ZB, LL31 9ZD, LL31 9ZG, LL31 9ZH, LL31 9ZJ, LL31 9ZN, LL31 9ZR, LL31 9ZY, LL32 8QH, LL32 8QN, LL32 8QS, LL32 8WP, LL32 8ZA, LL32 8ZB, LL32 8ZE, LL32 8ZF, LL32 8ZG, LL32 8ZJ, LL32 8ZL, LL32 8ZN, LL32 8ZP, LL32 8ZQ, LL32 8ZR, LL32 8ZS, LL32 8ZY, LL34 6ZA, LL34 6ZB, LL34 6ZE, LL34 6ZF, LL34 6ZG, LL34 6ZH",195,165,30
W00000902,LL30,"LL30 2EQ, LL30 2EX, LL30 2EZ, LL30 2JA, LL30 2YJ, LL30 2YX, LL30 2YZ",287,216,71
W00000992,LL30,"LL30 1AA, LL30 1AB, LL30 1AD, LL30 1AE, LL30 1AG, LL30 1DD, LL30 1DE, LL30 1DF, LL30 1DG, LL30 1DH, LL30 1DL, LL30 1DN, LL30 1DP, LL30 1DS, LL30 1DW, LL30 1EA, LL30 1FA, LL30 1GA, LL30 1PW, LL30 1YL, LL30 1YP",207,173,34
W00000991,LL30,"LL30 1HD, LL30 1JD, LL30 1LD, LL30 1LY",292,230,62
W00000718,LL31,"LL31 9SA, LL31 9TH, LL31 9TP, LL31 9TY, LL31 9UA, LL31 9UB, LL31 9UF, LL31 9UH",214,169,45
W00000717,LL31,"LL31 9DJ, LL31 9DQ, LL31 9DZ, LL31 9EQ, LL31 9FJ, LL31 9GA, LL31 9GB, LL31 9HX, LL31 9TT, LL31 9UD, LL31 9UE, LL31 9UL, LL31 9UN, LL31 9UP, LL31 9UR, LL31 9UW",325,263,62
W00000727,LL31,"LL31 9BU, LL31 9BY, LL31 9DA, LL31 9DD, LL31 9DH, LL31 9DL, LL31 9DS, LL31 9DW, LL31 9FA, LL31 9HJ, LL31 9UG",255,208,47
W00000728,LL31,"LL31 9DB, LL31 9DE, LL31 9DF, LL31 9EJ, LL31 9EX, LL31 9PJ, LL31 9PX, LL31 9PZ, LL31 9QH",269,203,66
W00000729,LL31,"LL31 9DT, LL31 9YA, LL31 9YF, LL31 9YG, LL31 9YJ, LL31 9YL, LL31 9YN, LL31 9YP, LL31 9YQ, LL31 9YS, LL31 9YT, LL31 9YW",385,301,84
W00000730,LL31,"LL31 9UT, LL31 9UU, LL31 9UY, LL31 9YB, LL31 9YH",276,189,87
W00010481,LL31,"LL31 9HF, LL31 9HR, LL31 9HT, LL31 9HU, LL31 9LB, LL31 9LD, LL31 9SE, LL32 8BQ, LL32 8PT",277,205,72
W00000724,LL31,"LL31 9BS, LL31 9BT, LL31 9DG, LL31 9DP, LL31 9DR, LL31 9YR",193,164,29
W00010489,LL31,"LL31 9AH, LL31 9EZ, LL31 9FD, LL31 9FE, LL31 9FF, LL31 9GF",562,387,175
W00000877,LL31,"LL31 9PP, LL31 9RU, LL31 9RY, LL31 9SB, LL31 9SF, LL31 9SG, LL31 9SH, LL31 9SL, LL31 9SN, LL31 9SP, LL31 9SR",278,207,71
W00000939,LL31,"LL31 9TJ, LL31 9TQ, LL31 9TZ, LL31 9UJ, LL31 9UQ",269,184,85
W00000881,LL31,"LL31 9HN, LL31 9HP, LL31 9HS, LL31 9HY, LL31 9LA, LL31 9LL",302,219,83
W00000882,LL31,"LL31 9SS, LL31 9ST, LL31 9TN",211,155,56
W00000876,LL31,"LL31 9GG, LL31 9GH, LL31 9LE, LL31 9LF, LL31 9LG, LL31 9LH, LL31 9LJ, LL31 9LP, LL31 9LR, LL31 9LW, LL31 9YX, LL31 9YZ, LL31 9ZF, LL31 9ZQ, LL31 9ZS, LL31 9ZT, LL31 9ZW",507,382,125
W00000883,LL31,"LL31 9FN, LL31 9HE, LL31 9HG, LL31 9HH, LL31 9HL, LL31 9LN, LL31 9LT, LL31 9LU, LL31 9LX, LL31 9NE, LL31 9NT, LL31 9NU",327,236,91
W00000884,LL31,"LL31 9AJ, LL31 9AQ, LL31 9BQ, LL31 9LQ, LL31 9LZ, LL31 9RE, LL31 9RF, LL31 9RL, LL31 9YU, LL31 9YY",250,199,51
W00000885,LL31,"LL31 9BJ, LL31 9BX, LL31 9BZ, LL31 9PH, LL31 9RD, LL31 9SW",256,190,66
W00000886,LL31,"LL31 9RG, LL31 9RW, LL31 9SU, LL31 9SY, LL31 9TB, LL31 9TD, LL31 9TE, LL31 9TF, LL31 9TG, LL31 9TL, LL31 9TS, LL31 9TU",266,195,71
W00000887,LL31,"LL31 9BH, LL31 9PY, LL31 9RA, LL31 9RH, LL31 9TA, LL31 9ZE, LL31 9ZL",278,211,67
W00000938,LL31,"LL31 9AF, LL31 9AS, LL31 9AU, LL31 9BB, LL31 9DX, LL31 9GE, LL31 9NJ, LL31 9NX, LL31 9NZ, LL31 9PL, LL31 9RT, LL31 9RX, LL31 9RZ, LL31 9SQ, LL31 9SZ, LL31 9UZ",278,202,76
W00000880,LL31,"LL31 9HW, LL31 9NY, LL31 9PA, LL31 9PB, LL31 9PE, LL31 9PF",318,215,103
W00000878,LL31,"LL31 9PD, LL31 9PG, LL31 9PQ, LL31 9PR, LL31 9PS, LL31 9PT, LL31 9PU, LL31 9RB, LL31 9RN, LL31 9RP, LL31 9SD, LL31 9ZP, LL31 9ZU",292,205,87
W00000941,LL31,"LL31 9EN, LL31 9ER, LL31 9ES, LL31 9ET, LL31 9EU",292,216,76
W00000942,LL31,"LL31 9DU, LL31 9DY, LL31 9ED, LL31 9EE, LL31 9EF, LL31 9EG, LL31 9EH, LL31 9EP, LL31 9EW, LL31 9EY, LL31 9HA, LL31 9WY",311,216,95
W00000943,LL31,"LL31 9AN, LL31 9AR, LL31 9BE, LL31 9TX, LL31 9UX",341,248,93
W00000944,LL31,"LL31 9AE, LL31 9AG, LL31 9AL, LL31 9AP, LL31 9AW, LL31 9AY, LL31 9BD",296,207,89
W00000945,LL31,"LL31 9AA, LL31 9AB, LL31 9AD, LL31 9BA, LL31 9BG, LL31 9BL, LL31 9EA, LL31 9EB, LL31 9GD, LL31 9NF, LL31 9NN, LL31 9NR, LL31 9NW, LL31 9PN, LL31 9PW, LL31 9XX, LL31 9XY, LL31 9XZ",323,243,80
W00000946,LL31,"LL31 9AT, LL31 9FB, LL31 9FG, LL31 9FH, LL31 9JB, LL31 9JD, LL31 9JE, LL31 9JF, LL31 9LS, LL31 9QE, LL31 9QG, LL31 9SJ",505,359,146
W00000940,LL31,"LL31 9EL, LL31 9LY, LL31 9NA, LL31 9NB, LL31 9ND, LL31 9NG, LL31 9NH, LL31 9NL, LL31 9NP, LL31 9NS, LL31 9QJ, LL31 9QN",334,227,107
W00000683,LL32,"LL32 8HP, LL32 8HZ, LL32 8NB, LL32 8NE, LL32 8PG, LL32 8RJ, LL32 8UE, LL32 8UF, LL32 8YF",264,158,106
W00000690,LL32,"LL32 8AR, LL32 8BA, LL32 8RR, LL32 8SB",362,249,113
W00000986,LL32,"LL32 8AE, LL32 8JE, LL32 8JH, LL32 8JL, LL32 8JN, LL32 8JP, LL32 8JR, LL32 8JS, LL32 8JT, LL32 8JU, LL32 8JW, LL32 8JX, LL32 8JY, LL32 8JZ, LL32 8QA, LL32 8QB, LL32 8QE",417,240,177
W00000665,LL32,"LL32 8BJ, LL34 6SP, LL34 6SR, LL34 6SS, LL34 6ST, LL34 6SU, LL34 6SW, LL34 6SY, LL34 6TA, LL34 6TB, LL34 6YS, LL34 6YT, LL34 6YU",133,99,34
W00000689,LL32,"LL32 8AB, LL32 8AH, LL32 8AN, LL32 8AW, LL32 8BH, LL32 8BL, LL32 8BN, LL32 8BP, LL32 8BS, LL32 8BT, LL32 8DA, LL32 8DD, LL32 8DE, LL32 8LA, LL32 8LB, LL32 8NG, LL32 8NH, LL32 8NS, LL32 8NU, LL32 8PZ, LL32 8RF, LL32 8RH, LL32 8RL",195,152,43
W00000682,LL32,"LL32 8BZ, LL32 8DN, LL32 8ER, LL32 8GA, LL32 8GH, LL32 8GJ, LL32 8GN, LL32 8GR, LL32 8GS, LL32 8GT, LL32 8GU, LL32 8GW, LL32 8HH",194,160,34
W00000695,LL32,"LL32 8RB, LL32 8RT, LL32 8WA, LL32 8WB, LL32 8WD, LL32 8WQ",335,223,112
W00000660,LL32,"LL32 8BX, LL32 8DZ, LL32 8EQ, LL32 8EZ, LL32 8HJ, LL32 8LJ, LL32 8LX, LL32 8LZ, LL32 8NZ, LL32 8PQ, LL32 8RQ, LL32 8SJ, LL32 8SP, LL32 8SS, LL32 8TH, LL32 8TL, LL32 8TY, LL32 8UA, LL32 8UD, LL32 8UJ, LL32 8UX, LL32 8YE, LL32 8YG, LL32 8YL, LL32 8YN, LL32 8YQ, LL32 8YY, LL32 8ZD, LL32 8ZH",331,197,134
W00000657,LL32,"LL32 8JF, LL32 8JJ, LL32 8JQ, LL32 8QP, LL32 8QQ, LL32 8QR, LL32 8SE, LL32 8SF, LL32 8SG, LL32 8SH, LL32 8SL",341,170,171
W00000694,LL32,"LL32 8FZ, LL32 8LL, LL32 8LP, LL32 8LT, LL32 8NP, LL32 8NR, LL32 8RU",291,225,66
W00000661,LL32,"LL32 8AX, LL32 8AZ, LL32 8DJ, LL32 8DQ, LL32 8DX, LL32 8EJ, LL32 8EX, LL32 8HL, LL32 8HQ, LL32 8LQ, LL32 8NJ, LL32 8NQ, LL32 8NX, LL32 8PJ, LL32 8RX, LL32 8RZ, LL32 8SQ, LL32 8TN, LL32 8TU, LL32 8TZ, LL32 8YB, LL32 8YD, LL32 8YH",332,245,87
W00000656,LL32,"LL32 8HX, LL32 8JA, LL32 8JB, LL32 8JD, LL32 8QF, LL32 8SD, LL32 8TD, LL32 8TE, LL32 8UG, LL32 8UH, LL32 8UL, LL32 8UN, LL32 8UP, LL32 8UR, LL32 8UT, LL32 8UU, LL32 8UW, LL32 8UY, LL32 8UZ, LL32 8YJ, LL32 8YX, LL32 8YZ",303,160,143
W00000693,LL32,"LL32 8AJ, LL32 8AP, LL32 8RE, LL32 8RP, LL32 8RS, LL32 8RW",375,242,133
W00000685,LL32,"LL32 8DP, LL32 8DR, LL32 8DY, LL32 8EB, LL32 8EF, LL32 8EN, LL32 8EU, LL32 8EY, LL32 8GP, LL32 8GY, LL32 8GZ, LL32 8HE, LL32 8QL",369,312,57
W00000696,LL32,"LL32 8HN, LL32 8HS, LL32 8HU, LL32 8HW, LL32 8LR, LL32 8LU, LL32 8LY, LL32 8NA, LL32 8ND, LL32 8NF, LL32 8NL, LL32 8NN",228,179,49
W00000658,LL32,"LL32 8SW, LL32 8TF, LL32 8TG, LL32 8TP, LL32 8TR, LL32 8TS, LL32 8TT, LL32 8YA, LL32 8YP, LL32 8YR, LL32 8YS, LL32 8YT, LL32 8YU, LL32 8YW",289,196,93
W00000692,LL32,"LL32 8AQ, LL32 8RA, LL32 8RD, LL32 8RN, LL32 8RY, LL32 8SA",232,173,59
W00000687,LL32,"LL32 8NT, LL32 8NY, LL32 8PB, LL32 8PD, LL32 8PE, LL32 8PF, LL32 8PH, LL32 8PL, LL32 8PN, LL32 8PP, LL32 8PW",228,183,45
W00000688,LL32,"LL32 8DL, LL32 8LE, LL32 8LF, LL32 8LG, LL32 8LH, LL32 8LN, LL32 8LS, LL32 8LW, LL32 8NW, LL32 8QG, LL32 8QZ",288,204,84
W00000684,LL32,"LL32 8DW, LL32 8ES, LL32 8ET, LL32 8FA, LL32 8FB, LL32 8HA, LL32 8HB, LL32 8HD, LL32 8HF, LL32 8HG",329,223,106
W00000686,LL32,"LL32 8AA, LL32 8DH, LL32 8DS, LL32 8DT, LL32 8EA, LL32 8ED, LL32 8EE, LL32 8EG, LL32 8EH, LL32 8EL, LL32 8EP, LL32 8EW, LL32 8PR, LL32 8PU, LL32 8PY, LL32 8ZT",258,183,75
W00000907,LL33,"LL33 0ES, LL33 0ET, LL33 0SL, LL33 0SN, LL33 0SP, LL33 0SR, LL33 0SS, LL33 0ST, LL33 0SW",349,174,175
W00000908,LL33,"LL33 0DN, LL33 0DT, LL33 0DU, LL33 0RY, LL33 0SA, LL33 0SB, LL33 0SD, LL33 0SE, LL33 0SF, LL33 0SG, LL33 0SH",270,131,139
W00000909,LL33,"LL33 0DP, LL33 0DR, LL33 0DS, LL33 0DW, LL33 0SJ, LL33 0SQ",278,151,127
W00000910,LL33,"LL33 0PU, LL33 0RA, LL33 0RB, LL33 0RD, LL33 0RE, LL33 0RJ",316,186,130
W00000650,LL33,"LL33 0UD, LL33 0UE, LL33 0UG, LL33 0UP, LL33 0UR, LL33 0UT, LL33 0UU",243,121,122
W00000393,LL33,"LL33 0WT, LL33 0ZA, LL33 0ZB, LL33 0ZF, LL33 0ZG, LL33 0ZL, LL56 4WA, LL56 4WB, LL56 4WD, LL56 4WE, LL56 4WF, LL56 4WH, LL56 4WQ, LL56 4WU, LL57 1AE, LL57 1DW, LL57 1WZ, LL57 1YZ, LL57 1ZA, LL57 1ZB, LL57 1ZF, LL57 1ZJ, LL57 1ZL, LL57 1ZS, LL57 2FZ, LL57 2JL, LL57 2TX, LL57 2TZ, LL57 2UL, LL57 2UT, LL57 2UU, LL57 2UY, LL57 2WA, LL57 2WF, LL57 2WG, LL57 2WH, LL57 2WX, LL57 2WY, LL57 2WZ, LL57 2XH, LL57 2YB, LL57 2YR, LL57 2YX, LL57 2YY, LL57 2ZA, LL57 2ZB, LL57 2ZE, LL57 2ZF, LL57 2ZG, LL57 2ZH, LL57 2ZJ, LL57 2ZL, LL57 2ZN, LL57 2ZP, LL57 2ZQ, LL57 2ZR, LL57 2ZS, LL57 2ZT, LL57 2ZU, LL57 3YZ, LL57 3ZA, LL57 3ZB, LL57 3ZE, LL57 3ZF, LL57 3ZJ, LL57 3ZP, LL57 3ZQ, LL57 3ZR, LL57 4LN, LL57 4LP, LL57 4LW, LL57 4RY, LL57 4SA, LL57 4WP, LL57 4WW, LL57 4WZ, LL57 4ZA, LL57 4ZB, LL57 4ZD, LL57 4ZF, LL57 4ZG, LL57 4ZH, LL57 4ZJ, LL57 4ZL, LL57 4ZN, LL57 4ZP, LL57 4ZQ, LL57 4ZR, LL57 4ZS, LL57 9AA, LL57 9AB, LL57 9AD, LL57 9AE, LL57 9AF, LL57 9AG, LL57 9AH, LL57 9AJ, LL57 9AL, LL57 9AN, LL57 9AP, LL57 9AQ, LL57 9AR, LL57 9AS, LL57 9AT, LL57 9AU, LL57 9AW, LL57 9AX, LL57 9AY, LL57 9AZ, LL57 9BA, LL57 9BB, LL57 9BD, LL57 9BE, LL57 9BF, LL57 9BG, LL57 9BH, LL57 9BJ, LL57 9BL, LL57 9BN, LL57 9BP, LL57 9BQ, LL57 9BR, LL57 9BS, LL57 9BT, LL57 9BU, LL57 9BW, LL57 9BX, LL57 9BY, LL57 9BZ, LL57 9DA, LL57 9DB, LL57 9DD, LL57 9DE, LL57 9DF, LL57 9DG, LL57 9DH, LL57 9DJ, LL57 9DL, LL57 9DN, LL57 9DQ, LL57 9DR, LL57 9DS, LL57 9DT, LL57 9DU, LL57 9DW, LL57 9DX, LL57 9DZ, LL57 9EA, LL57 9EB, LL57 9ED, LL57 9EE, LL57 9EF, LL57 9EG, LL57 9EH, LL57 9EJ, LL57 9EL, LL57 9EN, LL57 9EP, LL57 9EQ, LL57 9ER, LL57 9ES, LL57 9ET, LL58 8WX, LL58 8XJ, LL58 8ZA, LL58 8ZB, LL58 8ZD, LL58 8ZE, LL58 8ZJ, LL58 8ZW, LL59 5YZ, LL59 5ZA, LL59 5ZB, LL59 5ZD, LL59 5ZE, LL59 5ZF, LL59 5ZG, LL59 5ZH, LL59 5ZJ, LL59 5ZL, LL59 5ZN, LL59 5ZP, LL59 5ZS, LL59 5ZT, LL59 5ZU, LL59 5ZY, LL60 6WA, LL60 6WE, LL60 6WF, LL60 6WG, LL60 6WH, LL60 6WJ, LL61 5ZG, LL61 6WB, LL61 6WE, LL61 6WR",317,232,85
W00000649,LL33,"LL33 0AF, LL33 0AU, LL33 0AY, LL33 0BA, LL33 0BB, LL33 0BN, LL33 0NY, LL33 0PA, LL33 0PB, LL33 0PE, LL33 0PF, LL33 0RP",382,207,175
W00000653,LL33,"LL33 0AP, LL33 0AR, LL33 0AT, LL33 0BD, LL33 0BE, LL33 0BG, LL33 0BH, LL33 0BL, LL33 0BP, LL33 0BS, LL33 0BT, LL33 0BU, LL33 0BW, LL33 0BY, LL33 0DA, LL33 0GB, LL33 0PG, LL33 0PH, LL33 0PL, LL33 0PP, LL33 0PS",278,188,90
W00000911,LL33,"LL33 0AH, LL33 0EU, LL33 0EY, LL33 0HA, LL33 0HB, LL33 0HD, LL33 0NT, LL33 0PD, LL33 0PN, LL33 0PR, LL33 0PT, LL33 0PY, LL33 0RF, LL33 0RG, LL33 0RH, LL33 0RL, LL33 0RN",271,157,114
W00000254,LL33,"LL33 0HE, LL33 0HF, LL33 0HS, LL33 0HU, LL33 0HY, LL33 0LA, LL33 0LB, LL33 0LD, LL33 0LE, LL33 0LF, LL33 0LG, LL33 0LH, LL33 0LL, LL33 0LN, LL33 0LP, LL33 0LR, LL33 0LS, LL33 0LW, LL33 0LY",185,83,102
W00000912,LL33,"LL33 0AA, LL33 0AB, LL33 0AD, LL33 0AE, LL33 0AG, LL33 0DB, LL33 0DY, LL33 0NF, LL33 0NG, LL33 0NH, LL33 0NL, LL33 0NN, LL33 0NW, LL33 0RS, LL33 0RT, LL33 0RU, LL33 0RW, LL33 0ZE",267,157,110
W00000651,LL33,"LL33 0EA, LL33 0EB, LL33 0EN, LL33 0EW, LL33 0HL, LL33 0SU, LL33 0SY, LL33 0TA, LL33 0TB, LL33 0TD, LL33 0TE, LL33 0TF, LL33 0TQ, LL33 0TU, LL33 0TY, LL33 0UA, LL33 0UB, LL33 0UF, LL33 0UL, LL33 0UW, LL33 0ZD",248,134,114
W00000258,LL33,"LL33 0HT, LL33 0LT, LL33 0LU, LL57 3AJ, LL57 3AQ, LL57 3AX, LL57 3AZ, LL57 3DG, LL57 3DH, LL57 3DL, LL57 3DN, LL57 3EZ, LL57 3LA, LL57 3LB, LL57 3LD, LL57 3LE, LL57 3LF, LL57 3LG, LL57 3LH, LL57 3LJ, LL57 3LL, LL57 3LN, LL57 3LX, LL57 3UF, LL57 3UG, LL57 3UH, LL57 3YD, LL57 3YE, LL57 3YF, LL57 3YG, LL57 3YH, LL57 3YL, LL57 3YN, LL57 3YP, LL57 3YR, LL57 3YW",485,190,295
W00010103,LL33,"LL33 0AL, LL33 0AN, LL33 0AS, LL33 0AW, LL33 0ED, LL33 0EE, LL33 0EF, LL33 0EG, LL33 0EH, LL33 0EL, LL33 0EP, LL33 0ER, LL33 0HH, LL33 0HN, LL33 0HP, LL33 0HR, LL33 0HW, LL33 0HX, LL33 0NP, LL33 0NR, LL33 0NS, LL33 0NU",320,203,117
W00000655,LL33,"LL33 0PW, LL33 0TG, LL33 0TH, LL33 0TL, LL33 0TN, LL33 0TP, LL33 0TR, LL33 0TS, LL33 0TT, LL33 0TW, LL33 0UH, LL33 0UN, LL34 6EE, LL34 6LB",234,127,107
W00000919,LL34,"LL34 6JA, LL34 6LE, LL34 6LH, LL34 6LJ, LL34 6LS, LL34 6LU, LL34 6LY, LL34 6ND, LL34 6NE, LL34 6NP, LL34 6NQ",303,189,114
W00000917,LL34,"LL34 6HB, LL34 6HD, LL34 6HE, LL34 6HF, LL34 6HG, LL34 6HH, LL34 6HR, LL34 6HS, LL34 6HU",328,203,125
W00000916,LL34,"LL34 6AA, LL34 6AB, LL34 6AD, LL34 6AE, LL34 6AQ, LL34 6AR, LL34 6AS, LL34 6AU, LL34 6AX, LL34 6AY, LL34 6AZ, LL34 6BA, LL34 6BY, LL34 6DD, LL34 6DE, LL34 6DF, LL34 6DG, LL34 6DP, LL34 6ED, LL34 6EF, LL34 6EL, LL34 6UT, LL34 6UU, LL34 6UY, LL34 6WA, LL34 6YA",344,249,95
W00000914,LL34,"LL34 6EB, LL34 6EP, LL34 6ES, LL34 6ET, LL34 6EU, LL34 6EY, LL34 6GA, LL34 6HA, LL34 6HP, LL34 6HW, LL34 6LD, LL34 6LG, LL34 6LL, LL34 6LN, LL34 6LW, LL34 6NA, LL34 6NB, LL34 6PE, LL34 6PF, LL34 6PN",313,224,89
W00000667,LL34,"LL34 6RL, LL34 6RN, LL34 6RS, LL34 6RU, LL34 6RY, LL34 6SA, LL34 6SB, LL34 6SD, LL34 6UL",322,241,81
W00000666,LL34,"LL34 6TP, LL34 6TR, LL34 6TW, LL34 6TY, LL34 6UA, LL34 6UD, LL34 6UN, LL34 6UW",285,180,105
W00000920,LL34,"LL34 6AF, LL34 6AG, LL34 6AH, LL34 6AJ, LL34 6AL, LL34 6AN, LL34 6AP, LL34 6AW, LL34 6BS, LL34 6DA, LL34 6DB, LL34 6DJ, LL34 6LF, LL34 6LP, LL34 6LR, LL34 6LT, LL34 6WY",304,226,78
W00000918,LL34,"LL34 6BB, LL34 6BD, LL34 6BE, LL34 6BG, LL34 6BH, LL34 6BL, LL34 6BN, LL34 6BP, LL34 6BT, LL34 6BU, LL34 6BW, LL34 6EG, LL34 6EH, LL34 6EN, LL34 6PR, LL34 6SF, LL34 6UR, LL34 6WE, LL34 6YB, LL34 6YD, LL34 6YE, LL34 6YF, LL34 6YG, LL34 6YH, LL34 6YJ, LL34 6YR, LL34 6ZD",463,291,172
W00000915,LL34,"LL34 6AT, LL34 6NF, LL34 6NG, LL34 6NH, LL34 6NJ, LL34 6NL, LL34 6NN, LL34 6NR, LL34 6NS, LL34 6NT, LL34 6NU, LL34 6NW, LL34 6NY, LL34 6PA, LL34 6PB, LL34 6PD, LL34 6PG, LL34 6PH, LL34 6PL",276,195,81
W00000663,LL34,"LL34 6RB, LL34 6RD, LL34 6RF, LL34 6RG, LL34 6RH, LL34 6RP, LL34 6RW, LL34 6SG, LL34 6SH, LL34 6SL, LL34 6SN, LL34 6UB",262,163,99
W00000664,LL34,"LL34 6PS, LL34 6PT, LL34 6PU, LL34 6PY, LL34 6RA, LL34 6RE, LL34 6RR, LL34 6UH",251,170,81
W00000913,LL34,"LL34 6DH, LL34 6DL, LL34 6DN, LL34 6EQ, LL34 6ER, LL34 6EW, LL34 6YL, LL34 6YN, LL34 6YP, LL34 6YW",344,237,107
W00000662,LL34,"LL34 6PW, LL34 6TD, LL34 6TE, LL34 6TF, LL34 6TG, LL34 6TH, LL34 6TL, LL34 6TN, LL34 6UE, LL34 6UF, LL34 6UG",243,174,69
W00000233,LL35,"LL35 0PE, LL35 0PF, LL35 0PG, LL35 0RA, LL35 0RD, LL35 0RE, LL35 0RF, LL35 0RG, LL35 0RH, LL35 0RL, LL35 0RN, LL35 0RP, LL35 0RW, LL35 0SA, LL35 0SB, LL35 0SD, LL35 0SE, LL35 0SF, LL35 0SG, LL35 0SH, LL35 0SL, LL35 0SN, LL35 0SP, LL35 0SW, LL35 0TA, LL35 0TB, LL36 9HT",141,71,70
W00000232,LL35,"LL35 0DY, LL35 0HN, LL35 0HW, LL35 0HY, LL35 0NP, LL35 0NQ, LL35 0NR, LL35 0NS, LL35 0NT, LL35 0NU, LL35 0NX, LL35 0NY, LL35 0PA, LL35 0PB, LL35 0PD, LL35 0RB, LL35 0RU, LL35 0RY",222,138,84
W00000231,LL35,"LL35 0ER, LL35 0HH, LL35 0HL, LL35 0HT, LL35 0HU, LL35 0LA, LL35 0LB, LL35 0LD, LL35 0LE, LL35 0LF, LL35 0LL, LL35 0LR, LL35 0LS, LL35 0LU, LL35 0LW, LL35 0LY, LL35 0NA, LL35 0NB, LL35 0ND, LL35 0NF, LL35 0NG, LL35 0NH, LL35 0NL, LL35 0PH, LL35 0PL, LL35 0PN, LL35 0PT, LL35 0PU, LL35 0PW, LL35 0PY",195,149,46
W00000234,LL35,"LL35 0EA, LL35 0EB, LL35 0ED, LL35 0EE, LL35 0EF, LL35 0EG, LL35 0EH, LL35 0EL, LL35 0EN, LL35 0EP, LL35 0ES, LL35 0ET, LL35 0EU, LL35 0EW, LL35 0EY, LL35 0HA, LL35 0HB, LL35 0HD, LL35 0HE, LL35 0HF, LL35 0HG, LL35 0HP, LL35 0HR, LL35 0HS, LL35 0LG, LL35 0LN, LL35 0LP, LL35 0LT, LL35 0PS, LL35 0RT, LL35 0WY",114,83,31
W00000608,LL35,"LL35 0ZA, LL36 6AA, LL36 6AB, LL36 6AD, LL36 6AE, LL36 6AF, LL36 6AG, LL36 6AH, LL36 6AJ, LL36 6AL, LL36 6ZZ, LL36 9BD, LL36 9DE, LL36 9DQ, LL36 9DS, LL36 9EG, LL36 9EH, LL36 9EL, LL36 9EN, LL36 9HH, LL36 9LW, LL36 9RT, LL36 9RU, LL36 9YQ, LL36 9ZA, LL36 9ZE, LL36 9ZG, LL36 9ZP",275,143,132
W00000609,LL36,"LL36 0AY, LL36 0DA, LL36 0DE, LL36 0DL, LL36 0DP, LL36 0DT, LL36 0DU, LL36 0SU, LL36 0SY",201,154,47
W00000610,LL36,"LL36 0AJ, LL36 0AQ, LL36 0AR, LL36 0AU, LL36 0AX, LL36 0AZ, LL36 0BA, LL36 0BB, LL36 0BE, LL36 0BU, LL36 0DF, LL36 0DG, LL36 0DH, LL36 0DJ, LL36 0DQ, LL36 0DZ, LL36 0ST, LL36 0TA, LL36 0TB",265,186,79
W00000292,LL36,"LL36 9AJ, LL36 9AQ, LL36 9RH, LL36 9RL, LL36 9TH, LL36 9TL, LL36 9TN, LL36 9TP, LL36 9TR, LL36 9TS, LL36 9TT, LL36 9TU, LL36 9TW, LL36 9UP, LL36 9UR, LL36 9UT, LL36 9UU, LL36 9UY, LL36 9YA, LL36 9YB, LL36 9YD, LL36 9YE, LL36 9YF, LL36 9YG, LL36 9YH, LL36 9YL, LL36 9YN, LL36 9YP, LL36 9YR, LL36 9YS, LL36 9YT, LL36 9YU, LL36 9YW, LL36 9YY, LL36 9ZD, LL36 9ZN",283,151,132
W00000291,LL36,"LL36 9LF, LL36 9NT, LL36 9NU, LL36 9NY, LL36 9PD, LL36 9PE, LL36 9PL, LL36 9PT, LL36 9PU, LL36 9PY, LL36 9RA, LL36 9RB, LL36 9RD, LL36 9RE, LL36 9RF, LL36 9RG, LL36 9RN, LL36 9RP, LL36 9RW, LL36 9RY, LL36 9TG, LL36 9UH, LL36 9UL, LL36 9UN, LL36 9UW, LL36 9ZB, LL36 9ZH, LL36 9ZJ",311,176,135
W00000290,LL36,"LL36 9NS, LL36 9PA, LL36 9PB, LL36 9PF, LL36 9PG, LL36 9PH, LL36 9PN, LL36 9PP, LL36 9PR, LL36 9PS, LL36 9PW, LL36 9PX, LL36 9RR",283,133,150
W00000603,LL36,"LL36 9AA, LL36 9AD, LL36 9AE, LL36 9AF, LL36 9AG, LL36 9AL, LL36 9AN, LL36 9AX, LL36 9BA, LL36 9BB, LL36 9BE, LL36 9BF, LL36 9BG, LL36 9BS, LL36 9BT, LL36 9BU, LL36 9BY, LL36 9DT, LL36 9WY, LL36 9ZF, LL36 9ZL, LL36 9ZU",256,170,86
W00000434,LL36,"LL36 9LP, LL36 9LR, LL36 9LS, LL36 9LT, LL36 9LU, LL36 9LY, LL36 9NA, LL36 9NB, LL36 9ND, LL36 9NE, LL36 9NF, LL36 9NG, LL36 9NH, LL36 9NN, LL37 2QJ, LL37 2QL",122,45,77
W00000606,LL36,"LL36 0AL, LL36 0AN, LL36 0AP, LL36 0AS, LL36 0AT, LL36 0AW, LL36 9AW",243,164,79
W00000611,LL36,"LL36 9DU, LL36 9DY, LL36 9EA, LL36 9EB, LL36 9ED, LL36 9EP, LL36 9HA, LL36 9HB, LL36 9HD",275,141,134
W00000615,LL36,"LL36 0AA, LL36 0AB, LL36 0AD, LL36 9AS, LL36 9AT, LL36 9AU, LL36 9AY, LL36 9AZ",263,140,123
W00000613,LL36,"LL36 0DR, LL36 0DS, LL36 0DW, LL36 0DY, LL36 9EF, LL36 9HG, LL36 9LA",307,175,132
W00000612,LL36,"LL36 0AG, LL36 0BW, LL36 0DB, LL36 0DN, LL36 0TD, LL36 0TE, LL36 0TF, LL36 9ET, LL36 9EU, LL36 9EY",189,133,56
W00000607,LL36,"LL36 9BP, LL36 9BQ, LL36 9DA, LL36 9DB, LL36 9DD, LL36 9DF, LL36 9DG, LL36 9DH, LL36 9DJ, LL36 9DL, LL36 9DN, LL36 9DP, LL36 9DR, LL36 9DW, LL36 9EE, LL36 9EW",232,158,74
W00000431,LL36,"LL36 9BN, LL36 9LG, LL36 9LH, LL36 9LL, LL36 9LN, LL36 9NL, LL36 9SA, LL36 9SB, LL36 9SD, LL36 9SE, LL36 9SF, LL36 9SG, LL36 9SH, LL36 9SL, LL36 9SN, LL36 9SP, LL36 9SR, LL36 9SS, LL36 9ST, LL36 9SU, LL36 9SW, LL36 9SY, LL36 9TA, LL36 9TY, LL36 9UA, LL36 9UB, LL36 9UD, LL36 9UE, LL36 9UF, LL36 9UG, LL36 9UJ",301,120,181
W00000605,LL36,"LL36 9AB, LL36 9AP, LL36 9AR, LL36 9BH, LL36 9BJ, LL36 9BL",222,117,105
W00000614,LL36,"LL36 0AE, LL36 0AF, LL36 0AH, LL36 0BD, LL36 0BG, LL36 0BH, LL36 0BL, LL36 0BN, LL36 0BP, LL36 0BS, LL36 0BT, LL36 0BY, LL36 0TG, LL36 0ZA, LL36 0ZB, LL36 9AH",209,157,52
W00000604,LL36,"LL36 9HE, LL36 9HL, LL36 9HN, LL36 9HP, LL36 9HR, LL36 9HS, LL36 9HU, LL36 9HW, LL36 9HY",149,75,74
W00000347,LL37,"LL37 2WU, LL37 2WZ, LL37 2ZA, LL38 2WX, LL38 2ZA, LL38 2ZB, LL38 2ZE, LL39 1YQ, LL39 1ZB, LL40 1EP, LL40 1ES, LL40 1HB, LL40 1HF, LL40 1HH, LL40 1HL, LL40 1LN, LL40 1LP, LL40 1LR, LL40 1LU, LL40 1LY, LL40 1NA, LL40 1ND, LL40 1RB, LL40 1RD, LL40 1RF, LL40 1RH, LL40 1RL, LL40 1RS, LL40 1WW, LL40 1WZ, LL40 1ZA, LL40 1ZB, LL40 1ZD, LL40 2XX, LL40 2ZB, LL40 2ZE, LL40 2ZF, LL40 9AA, LL40 9AB, LL40 9AD, LL40 9AE, LL40 9AF, LL40 9AG, LL40 9AH, LL40 9AJ, LL40 9AL, LL40 9AN, LL40 9AP, LL40 9AQ, LL42 9AA, LL42 9ZZ",196,93,103
W00000432,LL37,"LL37 2JA, LL37 2JB, LL37 2JD, LL37 2JE, LL37 2JR, LL37 2JS, LL37 2JU, LL37 2JX, LL37 2JZ, LL37 2YJ, LL37 2YQ, LL37 2YX, LL37 2YZ",258,148,110
W00000433,LL37,"LL37 2JF, LL37 2JG, LL37 2JH, LL37 2JJ, LL37 2JL, LL37 2JP, LL37 2JQ, LL37 2JT, LL37 2JY, LL37 2LA, LL37 2QA, LL37 2QB, LL37 2QD, LL37 2QE, LL37 2QF, LL37 2QG, LL37 2QH, LL37 2QN, LL37 2QP, LL37 2QQ, LL37 2QR, LL37 2QS, LL37 2QW, LL37 2UJ, LL37 2UX, LL37 2UZ",249,157,92
W00000427,LL38,"LL38 2DX, LL38 2DZ, LL38 2EQ, LL38 2EX, LL38 2EY, LL38 2EZ, LL38 2HX, LL38 2LX, LL38 2NJ, LL38 2NQ, LL38 2NX, LL38 2NZ, LL38 2RJ, LL38 2RQ, LL38 2RX, LL38 2RZ, LL38 2SJ, LL38 2SQ, LL38 2SX, LL38 2SZ, LL38 2TJ, LL38 2TQ",221,168,53
W00000428,LL38,"LL38 2AJ, LL38 2AQ, LL38 2AX, LL38 2BJ, LL38 2BX, LL38 2BZ, LL38 2HJ, LL38 2HQ, LL38 2HZ, LL38 2LQ, LL38 2PX, LL38 2PZ, LL38 2QZ, LL38 2TX",230,156,74
W00000429,LL38,"LL38 2AZ, LL38 2BQ, LL38 2DJ, LL38 2DQ, LL38 2EJ, LL38 2LJ, LL38 2LZ, LL38 2PJ, LL38 2PQ, LL38 2QY, LL38 2TZ, LL38 2UQ",222,171,51
W00000430,LL39,"LL39 1AJ, LL39 1AQ, LL39 1AX, LL39 1AZ, LL39 1BJ, LL39 1BQ, LL39 1BX, LL39 1BZ, LL39 1DQ, LL39 1LJ, LL39 1LQ, LL39 1LX, LL39 1LZ, LL39 1YP, LL39 1YR, LL39 1YS, LL39 1YT, LL39 1YU, LL39 1YY, LL39 1ZA, LL40 1EA, LL40 1HT, LL40 1LE, LL40 1TB, LL40 1TN, LL40 1TP, LL40 1TR, LL40 1TS, LL40 1TW, LL40 1YE, LL40 1YF, LL40 1YG, LL40 1YH",288,167,121
W00000248,LL40,"LL40 2UU, LL42 1AJ, LL42 1AL, LL42 1AX, LL42 1AZ, LL42 1DJ, LL42 1DX, LL42 1DY, LL42 1DZ, LL42 1RR, LL42 1RT, LL42 1TE, LL42 1TF, LL42 1TG, LL42 1TH, LL42 1TL",157,96,61
W00000343,LL40,"LL40 1UA, LL40 1UD, LL40 1UE, LL40 1UT, LL40 1UU, LL40 1WA, LL40 2ER, LL40 2ES, LL40 2ET, LL40 2EW, LL40 2SW, LL40 2YB, LL40 2YN, LL40 2YP, LL40 2YQ, LL40 2YT, LL40 2YU, LL40 2YW, LL40 2YY",260,106,154
W00000345,LL40,"LL40 1AA, LL40 1AB, LL40 1AE, LL40 1AF, LL40 1AG, LL40 1AL, LL40 1AN, LL40 1AP, LL40 1AW, LL40 1BD, LL40 1BE, LL40 1BS, LL40 1BW, LL40 1DG, LL40 1DJ, LL40 1DN, LL40 1DP, LL40 1DR, LL40 1DS, LL40 1DY, LL40 1ET, LL40 1EU, LL40 1EY, LL40 1HW, LL40 1PR, LL40 1PS, LL40 1PU, LL40 1PY, LL40 1RE, LL40 1RG, LL40 1RJ, LL40 1RN, LL40 1SA, LL40 1SD, LL40 1SF",169,83,86
W00000344,LL40,"LL40 1AD, LL40 1AH, LL40 1AR, LL40 1AS, LL40 1AT, LL40 1AU, LL40 1AY, LL40 1BA, LL40 1BB, LL40 1BG, LL40 1BH, LL40 1BL, LL40 1BN, LL40 1BT, LL40 1BU, LL40 1BY, LL40 1DA, LL40 1DB, LL40 1DD, LL40 1DE, LL40 1DF, LL40 1DH, LL40 1DL, LL40 1DT, LL40 1DU, LL40 1DW, LL40 1EB, LL40 1ED, LL40 1EE, LL40 1EF, LL40 1EG, LL40 1EH, LL40 1EL, LL40 1HA, LL40 1HD, LL40 1HE, LL40 1HN, LL40 1HR, LL40 1HS, LL40 1LH, LL40 1SB, LL40 1SE, LL40 1WY",234,88,146
W00000349,LL40,"LL40 1GB, LL40 1NL, LL40 1NS, LL40 1NT, LL40 1NU, LL40 1NY, LL40 1PA, LL40 1PB, LL40 1PD, LL40 1PE, LL40 1PF, LL40 1PG, LL40 1PW, LL40 1PX, LL40 1UW",309,113,196
W00000348,LL40,"LL40 1GA, LL40 1GD, LL40 1GE, LL40 1LB, LL40 1NP, LL40 1NW, LL40 1PT, LL40 1RU, LL40 1RY, LL40 1SG, LL40 1SH, LL40 1SL, LL40 1SN, LL40 1SP, LL40 1SW, LL40 1TA, LL40 1UB, LL40 1UF, LL40 1UG, LL40 2PW",372,163,209
W00000341,LL40,"LL40 1TD, LL40 1TE, LL40 1TF, LL40 1TG, LL40 1TH, LL40 1TL, LL40 1YA, LL40 1YB, LL40 1YD, LL40 1YJ, LL40 2AB, LL40 2AF, LL40 2EU, LL40 2LS, LL40 2LT, LL40 2NB, LL40 2PP, LL40 2PR, LL40 2PS, LL40 2PT, LL40 2PU, LL40 2PY, LL40 2RA, LL40 2RB, LL40 2RD, LL40 2RE, LL40 2SP, LL40 2SR",250,106,144
W00000346,LL40,"LL40 1HP, LL40 1HU, LL40 1HX, LL40 1HY, LL40 1LD, LL40 1LF, LL40 1PH, LL40 1PL, LL40 1PN",320,85,235
W00000350,LL40,"LL40 1HG, LL40 1LS, LL40 1LT, LL40 1NB, LL40 1NE, LL40 1NF, LL40 1NG, LL40 1NH, LL40 1NN, LL40 1NR, LL40 1RP, LL40 1RR, LL40 1RT, LL40 1RW, LL40 1SR, LL40 1SS, LL40 1ST",180,78,102
W00000342,LL40,"LL40 1BP, LL40 1HZ, LL40 1LA, LL40 1LG, LL40 1LW, LL40 2AA, LL40 2AX, LL40 2YA, LL40 2YD, LL40 2YE, LL40 2YF, LL40 2YG, LL40 2YH, LL40 2YJ, LL40 2YL, LL40 2YS",253,84,169
W00000284,LL40,"LL40 2AD, LL40 2AE, LL40 2AG, LL40 2AH, LL40 2AP, LL40 2BY, LL40 2DE, LL40 2DF, LL40 2DG, LL40 2DH, LL40 2DL, LL40 2DN, LL40 2DP, LL40 2DS, LL40 2DT, LL40 2DW, LL40 2EG, LL40 2EH, LL40 2LU, LL40 2LY, LL40 2NA, LL40 2RF, LL40 2RG, LL40 2RH, LL40 2RL, LL40 2RN, LL40 2RP, LL40 2RR, LL40 2RW, LL40 2SB, LL40 2SD, LL40 2SF",207,77,130
W00000285,LL40,"LL40 2AL, LL40 2AN, LL40 2AR, LL40 2AW, LL40 2BE, LL40 2BG, LL40 2BH, LL40 2BN, LL40 2BT, LL40 2BW, LL40 2RS, LL40 2RT, LL40 2RU, LL40 2RY, LL40 2SA, LL40 2SE, LL40 2SG, LL40 2SH, LL40 2TY",235,106,129
W00000286,LL40,"LL40 2AJ, LL40 2AS, LL40 2AT, LL40 2AU, LL40 2AY, LL40 2BA, LL40 2BD, LL40 2BF, LL40 2BL, LL40 2BP, LL40 2BS, LL40 2BU, LL40 2DR, LL40 2DU, LL40 2DY, LL40 2EA, LL40 2EB, LL40 2ED, LL40 2EE, LL40 2EF, LL40 2LW, LL40 2NG, LL40 2NH, LL40 2NL, LL40 2NN, LL40 2NR, LL40 2NS, LL40 2NT, LL40 2NU, LL40 2NY, LL40 2PF, LL40 2UT, LL40 2YR",292,94,198
W00000287,LL40,"LL40 2HG, LL40 2HH, LL40 2HL, LL40 2HN, LL40 2HP, LL40 2HR, LL40 2HS, LL40 2HT, LL40 2HU, LL40 2HW, LL40 2HY, LL40 2HZ, LL40 2LA, LL40 2LB, LL40 2LD, LL40 2LE, LL40 2LF, LL40 2LG, LL40 2LH, LL40 2LL, LL40 2NP, LL40 2NW, LL40 2PA, LL40 2PB, LL40 2PD, LL40 2PE, LL40 2PH, LL40 2TF, LL40 2TG, LL40 2TH, LL40 2TL, LL40 2TN, LL40 2TP, LL40 2TW",161,69,92
W00000288,LL40,"LL40 2TD, LL40 2TT, LL40 2UA, LL40 2UB, LL40 2UD, LL40 2UE, LL40 2UF, LL40 2UG, LL40 2UH, LL40 2UL, LL40 2UN, LL40 2UP, LL40 2UR, LL40 2UW, LL42 1TN",155,82,73
W00000289,LL40,"LL40 2EY, LL40 2HA, LL40 2HB, LL40 2HD, LL40 2HE, LL40 2HF, LL40 2ND, LL40 2NE, LL40 2NF, LL40 2SS, LL40 2ST, LL40 2SU, LL40 2SY, LL40 2TA, LL40 2TB, LL40 2TE, LL40 2TU, LL40 2ZA, LL40 2ZD",310,114,196
W00000591,LL40,"LL40 2PG, LL41 4DS, LL41 4SA, LL41 4SB, LL41 4SD, LL41 4SE, LL41 4SH, LL41 4TF, LL41 4TL, LL41 4TN, LL41 4TP, LL41 4TR, LL41 4TS, LL41 4UD, LL41 4UN, LL41 4UP, LL41 4UR, LL41 4UT, LL41 4UU, LL41 4UW, LL41 4UY, LL41 4YA, LL41 4YB, LL41 4YD, LL41 4YE, LL41 4YF",289,63,226
W00000588,LL41,"LL41 3AQ, LL41 3YT, LL41 3YU, LL41 3YY, LL41 3ZA, LL41 4DT, LL41 4DU, LL41 4DY, LL41 4DZ, LL41 4EA, LL41 4ED, LL41 4EH, LL41 4EL, LL41 4EP, LL41 4ER, LL41 4ES, LL41 4EU, LL41 4EY, LL41 4HA, LL41 4HF, LL41 4HH, LL41 4HL, LL41 4HP, LL41 4RA, LL41 4RB, LL41 4RD, LL41 4RE, LL41 4ZA, LL41 4ZB",310,120,190
W00000278,LL41,"LL41 3PS, LL41 3PX, LL41 3PY, LL41 3RP, LL41 3RS, LL41 3RU, LL41 3RY, LL41 3SB, LL41 3SD, LL41 3SE, LL41 3SF, LL41 3SH, LL41 3SL, LL41 3SN, LL41 3SP, LL41 3SR, LL41 3SS, LL41 3ST, LL41 3SU, LL41 3SW, LL41 3SY, LL41 3TA, LL41 3TB, LL41 3TD, LL41 3TE, LL41 3TF, LL41 3TG, LL41 3TH, LL41 3TL, LL41 3TN, LL41 3TP, LL41 3TW, LL41 4BW",256,95,161
W00000279,LL41,"LL41 3AG, LL41 3BG, LL41 3BH, LL41 3BL, LL41 3BN, LL41 3BP, LL41 3BW, LL41 3DA, LL41 3ES, LL41 3ET, LL41 3EU, LL41 3EY, LL41 3HA, LL41 3HB, LL41 3HD, LL41 3HE, LL41 3HF, LL41 3HG, LL41 3HH, LL41 3HL, LL41 3HW, LL41 3NH, LL41 3UL, LL41 3UR, LL41 3UW",349,83,266
W00000280,LL41,"LL41 3HN, LL41 3NE, LL41 3NL, LL41 3NN, LL41 3NR, LL41 3NW, LL41 3PL, LL41 3UN, LL41 3UP, LL41 3UT, LL41 3WY, LL41 3YA, LL41 3YD, LL41 3YE, LL41 3YJ, LL41 3YP",313,45,268
W00000281,LL41,"LL41 3UH, LL41 3UU, LL41 3UY, LL41 3YB, LL41 3YF, LL41 3YG, LL41 3YH, LL41 3YL, LL41 3YN, LL41 3YW",291,42,249
W00000282,LL41,"LL41 3PB, LL41 3PD, LL41 3PG, LL41 3PH, LL41 3PJ, LL41 3PP, LL41 3PR, LL41 3PT, LL41 3PU, LL41 3PW, LL41 3RE, LL41 3RF, LL41 3RH, LL41 3RL, LL41 3RN, LL41 3RT, LL41 3RW, LL41 3SA, LL41 3SG",235,49,186
W00000388,LL41,"LL41 4HY, LL47 6TE, LL47 6TG, LL47 6TL, LL47 6TN, LL47 6TT, LL47 6UA, LL47 6UB, LL47 6UN, LL47 6UP, LL47 6UR, LL47 6UT, LL47 6UW, LL47 6UY, LL47 6YB, LL47 6YD, LL47 6YE, LL47 6YF, LL47 6YG, LL47 6YH, LL47 6YL, LL47 6YN, LL47 6YP, LL47 6YR, LL47 6YS, LL47 6YT, LL47 6YU, LL47 6YW, LL47 6YY, LL47 6ZA",272,103,169
W00000589,LL41,"LL41 4EB, LL41 4EE, LL41 4EF, LL41 4EG, LL41 4EN, LL41 4ET, LL41 4EW, LL41 4HN, LL41 4HR, LL41 4HS, LL41 4HT, LL41 4HU, LL41 4HW, LL41 4LB",218,69,149
W00000592,LL41,"LL41 4PD, LL41 4RP, LL41 4RS, LL41 4RT, LL41 4RU, LL41 4RW, LL41 4RY, LL41 4TA, LL41 4TB, LL41 4TD, LL41 4TE, LL41 4TG, LL41 4TH, LL41 4TW, LL41 4UB, LL41 4UE, LL41 4UF, LL41 4UG, LL41 4UH, LL41 4UL",255,65,190
W00000336,LL41,"LL41 3AN, LL41 3AP, LL41 3AS, LL41 3AT, LL41 3AY, LL41 3AZ, LL41 3BB, LL41 3BF, LL41 3BU, LL41 3BX, LL41 3DP, LL41 3DR, LL41 3DW, LL41 3DY, LL41 3EA, LL41 3EB, LL41 3ED, LL41 3EE, LL41 3EF, LL41 3EN, LL41 3EW, LL41 3LQ",238,59,179
W00000283,LL41,"LL41 3BD, LL41 3BE, LL41 3HP, LL41 3HR, LL41 3HS, LL41 3HT, LL41 3HU, LL41 3HY, LL41 3LA, LL41 3LB, LL41 3LD, LL41 3LE, LL41 3LF, LL41 3LG, LL41 3LH, LL41 3LL, LL41 3LN, LL41 3LP, LL41 3LR, LL41 3LS, LL41 3LT, LL41 3LU, LL41 3LW, LL41 3LY, LL41 3NA, LL41 3NB, LL41 3ND, LL41 3NP, LL41 3NS, LL41 3NT, LL41 3NU, LL41 3NY, LL41 3PA, LL41 3PE, LL41 3PF, LL41 3PN, LL41 3RA, LL41 3RB, LL41 3RD, LL41 3RG, LL41 3RR",277,92,185
W00000334,LL41,"LL41 3BS, LL41 3DE, LL41 3DG, LL41 3DL, LL41 3DN, LL41 3DS, LL41 3DT, LL41 3TU, LL41 3TY, LL41 3UA, LL41 3UB, LL41 3UD, LL41 3UE, LL41 3UF, LL41 3UG",275,43,232
W00000333,LL41,"LL41 3AA, LL41 3AB, LL41 3AD, LL41 3AE, LL41 3AF, LL41 3AH, LL41 3AL, LL41 3AU, LL41 3BA, LL41 3BY, LL41 3DB, LL41 3DD, LL41 3DF, LL41 3DH, LL41 3DU, LL41 3ZB, LL41 3ZR, LL41 4WY, LL41 4WZ, LL41 9AA, LL41 9AE, LL41 9AG, LL41 9AJ, LL41 9AL, LL41 9AN",236,72,164
W00000587,LL41,"LL41 4BB, LL41 4BG, LL41 4BH, LL41 4LF, LL41 4LG, LL41 4LH, LL41 4NF, LL41 4NL, LL41 4NN, LL41 4PA, LL41 4PE, LL41 4PL, LL41 4PN, LL41 4PP, LL41 4PQ, LL41 4PR, LL41 4PS, LL41 4PT, LL41 4PU, LL41 4PW, LL41 4PY, LL41 4RF, LL41 4RG",283,78,205
W00000586,LL41,"LL41 4LN, LL41 4LS, LL41 4LT, LL41 4LU, LL41 4LW, LL41 4LY, LL41 4NA, LL41 4NB, LL41 4ND, LL41 4NE, LL41 4NG, LL41 4NH, LL41 4NR",310,86,224
W00000585,LL41,"LL41 3EL, LL41 4AF, LL41 4AG, LL41 4AH, LL41 4AL, LL41 4AN, LL41 4AP, LL41 4AS, LL41 4AT, LL41 4AW, LL41 4BD, LL41 4BE, LL41 4BL, LL41 4PG",347,69,278
W00000584,LL41,"LL41 4AA, LL41 4AB, LL41 4AD, LL41 4BU, LL41 4BY, LL41 4DA, LL41 4DB, LL41 4DG, LL41 4DH, LL41 4DL",265,67,198
W00000583,LL41,"LL41 4AE, LL41 4AR, LL41 4AU, LL41 4AY, LL41 4BA, LL41 4DD, LL41 4DE, LL41 4DF, LL41 4DN",300,82,218
W00000582,LL41,"LL41 4BN, LL41 4HG, LL41 4LA, LL41 4LL, LL41 4LP, LL41 4LR, LL41 4NP, LL41 4NQ, LL41 4NS, LL41 4NT, LL41 4NU, LL41 4NW, LL41 4NY, LL41 4PB, LL41 4PH",288,74,214
W00000590,LL41,"LL41 4RR, LL41 4SF, LL41 4SG, LL41 4SL, LL41 4SN, LL41 4SP, LL41 4SR, LL41 4SS, LL41 4SW, LL41 4UA",305,59,246
W00000335,LL41,"LL41 3AJ, LL41 3AR, LL41 3AW, LL41 3AX, LL41 3BJ, LL41 3BQ, LL41 3BZ, LL41 3DJ, LL41 3DQ, LL41 3DX, LL41 3DZ, LL41 3EG, LL41 3EH, LL41 3EJ, LL41 3EQ, LL41 3EX, LL41 3LJ, LL41 3LX, LL41 3LZ",247,94,153
W00000243,LL42,"LL42 1AB, LL42 1AD, LL42 1AF, LL42 1AH, LL42 1EP, LL42 1HP, LL42 1LU, LL42 1NS, LL42 1NW, LL42 1PL, LL42 1PP, LL42 1RW",229,128,101
W00000244,LL42,"LL42 1AT, LL42 1AU, LL42 1AY, LL42 1BA, LL42 1BD, LL42 1BE, LL42 1BG, LL42 1BH, LL42 1BL, LL42 1BN, LL42 1BP, LL42 1BS, LL42 1BT, LL42 1BU, LL42 1BY, LL42 1DD, LL42 1DL, LL42 1DN, LL42 1DP, LL42 1DR, LL42 1DS, LL42 1DU, LL42 1DW, LL42 1ED, LL42 1EE, LL42 1LN, LL42 1LR, LL42 1LW, LL42 1WY",245,162,83
W00000245,LL42,"LL42 1AG, LL42 1BB, LL42 1BW, LL42 1DA, LL42 1DB, LL42 1DQ, LL42 1DT, LL42 1EG, LL42 1EH, LL42 1EL, LL42 1EQ, LL42 1ER, LL42 1ES, LL42 1ET, LL42 1EW, LL42 1GA, LL42 1HB, LL42 1LX, LL42 1LY, LL42 1NF, LL42 1NG, LL42 1SU, LL42 1SY, LL42 1TB, LL42 1TD",178,122,56
W00000246,LL42,"LL42 1AP, LL42 1AQ, LL42 1BJ, LL42 1BQ, LL42 1BX, LL42 1EN, LL42 1HS, LL42 1LZ, LL42 1PA, LL42 1PS, LL42 1PT, LL42 1PU, LL42 1PY, LL42 1RF, LL42 1RG, LL42 1RH, LL42 1RL, LL42 1RN, LL42 1YA, LL42 1YF, LL42 1YG, LL42 1YH, LL42 1YL, LL42 1YN, LL42 1YP, LL42 1YS, LL42 1YT, LL42 1YU, LL42 1YW, LL42 1YY",277,173,104
W00000352,LL42,"LL42 1RS, LL43 2AT, LL43 2AY, LL43 2BA, LL43 2BZ, LL43 2LQ, LL44 2DB, LL44 2DD, LL44 2DS, LL44 2DT, LL44 2DU, LL44 2DY, LL44 2EA, LL44 2EP, LL44 2HA, LL44 2HB, LL44 2HD, LL44 2HE, LL44 2HX, LL44 2HZ, LL44 2RQ, LL44 2RX, LL45 2LS, LL45 2LT",223,118,105
W00000242,LL42,"LL42 1AW, LL42 1EA, LL42 1EB, LL42 1EF, LL42 1EU, LL42 1EY, LL42 1HA, LL42 1LP, LL42 1LS, LL42 1LT, LL42 1NA, LL42 1NB, LL42 1ND, LL42 1NE, LL42 1NH, LL42 1NL, LL42 1NN, LL42 1NP, LL42 1NQ",219,137,82
W00000249,LL42,"LL42 1BF, LL42 1HD, LL42 1HF, LL42 1HG, LL42 1HH, LL42 1HL, LL42 1HN, LL42 1HR, LL42 1HT, LL42 1HU, LL42 1HW, LL42 1HX, LL42 1HY, LL42 1LA, LL42 1LB, LL42 1LE, LL42 1LH, LL42 1NR",257,124,133
W00000241,LL42,"LL42 1AA, LL42 1AE, LL42 1AN, LL42 1AR, LL42 1AS, LL42 1DE, LL42 1DF, LL42 1LL, LL42 1NY, LL42 1PB, LL42 1PD, LL42 1PE, LL42 1PF, LL42 1PG, LL42 1PH, LL42 1PN, LL42 1PR, LL42 1PW, LL42 1RB, LL42 1RD, LL42 1RE, LL42 1ZA, LL42 1ZB, LL42 1ZD, LL42 1ZE, LL42 1ZF, LL42 1ZG, LL42 1ZH, LL44 2ZA, LL44 2ZB, LL44 2ZD, LL45 2ZA",232,141,91
W00000247,LL42,"LL42 1LD, LL42 1LF, LL42 1LG, LL42 1YR",306,137,169
W00000351,LL43,"LL43 2AD, LL43 2AF, LL43 2AH, LL43 2AJ, LL43 2AP, LL43 2AQ, LL43 2AR, LL43 2AU, LL43 2AW, LL43 2AX, LL43 2AZ, LL43 2BB, LL43 2BF, LL43 2BJ, LL43 2BQ, LL43 2BX, LL44 2RJ",230,136,94
W00000356,LL43,"LL43 2AA, LL43 2AB, LL43 2AE, LL43 2AG, LL43 2AL, LL43 2AN, LL43 2AS, LL43 2ZA",226,120,106
W00000353,LL44,"LL44 2AB, LL44 2BE, LL44 2BF, LL44 2BG, LL44 2BP, LL44 2BS, LL44 2BT, LL44 2BU, LL44 2BY, LL44 2DA, LL44 2DL, LL44 2DR, LL44 2EB",224,161,63
W00000354,LL44,"LL44 2DH, LL44 2DJ, LL44 2DN, LL44 2DP, LL44 2DQ, LL44 2DW, LL44 2EG, LL44 2EH, LL44 2EL, LL44 2EN, LL44 2EQ, LL44 2ER, LL44 2ET, LL44 2EW",285,112,173
W00000355,LL44,"LL44 2BH, LL44 2BL, LL44 2BN, LL44 2BW, LL44 2DG, LL44 2EE, LL44 2EF, LL44 2ES, LL44 2EU, LL44 2EY, LL44 2HF",254,144,110
W00010652,LL45,"LL45 2DX, LL45 2DZ, LL45 2EJ, LL45 2EQ, LL45 2EX, LL45 2EZ, LL45 2HR, LL45 2HU, LL45 2HW, LL45 2LN, LL45 2LP, LL45 2LR, LL45 2LU, LL45 2LY, LL45 2NA, LL45 2NB, LL45 2NN, LL45 2NP, LL45 2NR, LL45 2NT, LL45 2NU, LL45 2NY, LL45 2PA, LL45 2PB, LL45 2PE, LL45 2PF, LL45 2PG, LL45 2PH, LL45 2PJ, LL45 2PL, LL45 2PQ, LL45 2PX, LL45 2PZ, LL46 2SA, LL46 2SB, LL46 2SD",287,149,138
W00000406,LL45,"LL45 2AA, LL45 2DJ, LL45 2DQ, LL45 2HH, LL45 2HL, LL45 2HN, LL45 2LA, LL45 2LD, LL45 2LE, LL45 2LF, LL45 2LG, LL45 2LH, LL45 2LL, LL45 2LW, LL45 2ND, LL45 2NH, LL45 2NL, LL45 2NS, LL45 2NW, LL45 2PD",329,154,175
W00000408,LL45,"LL45 2HP, LL45 2HS, LL45 2HT, LL46 2RB, LL46 2RD, LL46 2RE, LL46 2RF, LL46 2RG, LL46 2RH, LL46 2RL, LL46 2RN, LL46 2RP, LL46 2RR, LL46 2RS, LL46 2RT, LL46 2RU, LL46 2RW, LL46 2RY, LL46 2SE, LL46 2SU, LL46 2SY, LL46 2TA, LL46 2TB, LL46 2TD, LL46 2TE, LL46 2TF, LL46 2TG, LL46 2TH, LL46 2TL, LL46 2TN, LL46 2TW",279,152,127
W00000544,LL46,"LL46 2WQ, LL48 6WZ, LL48 6ZA, LL49 0AA, LL49 0AB, LL49 0AE, LL49 0AF, LL49 0AG, LL49 0AH, LL49 0AJ, LL49 0AL, LL49 0AN, LL49 0AP, LL49 0AQ, LL49 0AR, LL49 0AS, LL49 0AT, LL49 0AU, LL49 0AW, LL49 0AX, LL49 0AY, LL49 0AZ, LL49 0DA, LL49 9AF, LL49 9AG, LL49 9AH, LL49 9AL, LL49 9AN, LL49 9BW, LL49 9GB, LL49 9HF, LL49 9HG, LL49 9HH, LL49 9HL, LL49 9HN, LL49 9HP, LL49 9HW, LL49 9HX, LL49 9JJ, LL49 9LF, LL49 9LH, LL49 9NJ, LL49 9NP, LL49 9NR, LL49 9NS, LL49 9NT, LL49 9NU, LL49 9NW, LL49 9NX, LL49 9NY, LL49 9PB, LL49 9PD, LL49 9PE, LL49 9PF, LL49 9PN, LL49 9WZ, LL49 9ZB, LL49 9ZD, LL49 9ZJ, LL49 9ZP, LL49 9ZR, LL49 9ZY, LL52 0BR, LL52 0WA, LL52 0WZ, LL52 0ZB",300,81,219
W00000384,LL46,"LL46 2AB, LL46 2SH, LL46 2UE, LL46 2UJ, LL46 2UN, LL46 2UP, LL46 2WA, LL46 2WZ, LL46 2YE, LL46 2YL, LL46 2YT, LL48 6ES",276,105,171
W00000387,LL46,"LL46 2UR, LL47 6TA, LL47 6TB, LL47 6TD, LL47 6TF, LL47 6TH, LL47 6TJ, LL47 6TP, LL47 6TR, LL47 6TS, LL47 6TU, LL47 6TW, LL47 6TY, LL47 6UD, LL47 6UE, LL47 6UF, LL47 6UG, LL47 6UH, LL47 6UL, LL47 6UU, LL47 6YA",258,130,128
W00000382,LL46,"LL46 2SR, LL46 2SS, LL46 2SX, LL46 2UA, LL46 2YA, LL46 2YB, LL46 2YF, LL46 2YH",200,133,67
W00000386,LL46,"LL46 2GS, LL46 2GX, LL46 2GY, LL46 2GZ, LL46 2NJ, LL46 2NX, LL46 2NZ, LL46 2US",284,107,177
W00000385,LL46,"LL46 2GA, LL46 2GT, LL46 2GU, LL46 2PR, LL46 2PS, LL46 2PT, LL46 2PU, LL46 2PY, LL46 2RA, LL46 2SP, LL46 2SW, LL46 2UB, LL46 2UD, LL46 2UF, LL46 2UL, LL46 2YD, LL46 2YG, LL46 2YN, LL46 2YP, LL46 2YR, LL46 2YS, LL46 2YW",174,73,101
W00000383,LL46,"LL46 2AA, LL46 2SG, LL46 2SJ, LL46 2SL, LL46 2SN, LL46 2SQ, LL46 2ST, LL46 2TP, LL46 2TR, LL46 2TS, LL46 2TT, LL46 2TU, LL46 2UG, LL46 2UH, LL46 2UT, LL46 2UU, LL46 2UW",306,152,154
W00000511,LL48,"LL48 6AJ, LL48 6AQ, LL48 6AZ, LL48 6BZ, LL48 6DJ, LL48 6DQ, LL48 6DX, LL48 6LQ, LL48 6LZ, LL48 6SE, LL48 6SF, LL48 6SG, LL48 6SH, LL48 6SP, LL48 6SR, LL48 6SS, LL48 6ST, LL48 6SW",275,78,197
W00000518,LL48,"LL48 6DA, LL48 6DF, LL48 6DH, LL48 6DL, LL48 6DN, LL48 6DP, LL48 6DS, LL48 6DT, LL48 6DW, LL48 6LE, LL48 6LH, LL48 6LS, LL48 6NB, LL48 6ND, LL48 6NE, LL48 6NF, LL48 6NG, LL48 6NH, LL48 6NL, LL48 6NN, LL48 6NQ, LL48 6NR, LL48 6NW, LL48 6RA, LL48 6RB, LL48 6RD, LL48 6RE, LL48 6RF, LL48 6RH, LL48 6RL, LL48 6RT",277,108,169
W00000510,LL48,"LL48 6AX, LL48 6BH, LL48 6BJ, LL48 6BQ, LL48 6BX, LL48 6DR, LL48 6DU, LL48 6DY, LL48 6DZ, LL48 6EQ, LL48 6HR, LL48 6LJ, LL48 6LU, LL48 6LX, LL48 6RU",150,59,91
W00000516,LL48,"LL48 6AA, LL48 6AB, LL48 6AD, LL48 6AE, LL48 6AF, LL48 6AG, LL48 6AH, LL48 6AU, LL48 6AW, LL48 6HA, LL48 6HB, LL48 6LA, LL48 6LD, LL48 6LF, LL48 6LL, LL48 6LN, LL48 6LP, LL48 6LR, LL48 6LT, LL48 6LW, LL48 6LY, LL48 6NA, LL48 6NU, LL48 6PE, LL48 6SL",290,85,205
W00000513,LL48,"LL48 6BA, LL48 6BB, LL48 6BD, LL48 6BE, LL48 6BG, LL48 6EA, LL48 6PG, LL48 6PL, LL48 6PN, LL48 6PP, LL48 6PR, LL48 6PS, LL48 6PT, LL48 6PU, LL48 6PW, LL48 6RN, LL48 6RP, LL48 6RR, LL48 6RS, LL48 6RW, LL48 6RX, LL48 6RY",331,67,264
W00000515,LL48,"LL48 6AN, LL48 6AP, LL48 6AR, LL48 6AS, LL48 6AT",285,49,236
W00000514,LL48,"LL48 6BL, LL48 6BN, LL48 6BP, LL48 6BS, LL48 6BT, LL48 6BU, LL48 6BW, LL48 6BY, LL48 6DB, LL48 6DD, LL48 6DE, LL48 6DG, LL48 6NP, LL48 6NY, LL48 6PA, LL48 6PB, LL48 6PD, LL48 6PF, LL48 6PH, LL48 6PY, LL48 6RG",244,79,165
W00000517,LL48,"LL48 6ED, LL48 6EF, LL48 6EG, LL48 6EH, LL48 6EL, LL48 6EN, LL48 6EP, LL48 6ER, LL48 6ET, LL48 6EW, LL48 6HL, LL48 6HP, LL48 6HT, LL48 6HU, LL48 6HW, LL48 6HY",221,54,167
W00000512,LL48,"LL48 6AL, LL48 6AY, LL48 6BF, LL48 6EE, LL48 6HD, LL48 6HE, LL48 6HF, LL48 6HG, LL48 6HH, LL48 6HN, LL48 6HS, LL48 6LG",290,72,218
W00000546,LL48,"LL48 6SN, LL55 4NE, LL55 4NF, LL55 4NG, LL55 4NH, LL55 4NL, LL55 4NN, LL55 4NP, LL55 4NQ, LL55 4NR, LL55 4NS, LL55 4NT, LL55 4NW, LL55 4SF, LL55 4UU, LL55 4YF, LL55 4YG, LL55 4YH, LL55 4YL, LL55 4YN",214,94,120
W00000542,LL48,"LL48 6ZB, LL49 9BX, LL49 9SL, LL49 9TN, LL49 9TP, LL49 9TR, LL49 9TS, LL49 9TU, LL49 9TW, LL49 9UG, LL49 9UH, LL49 9UP, LL49 9UR, LL49 9UT, LL49 9YW, LL49 9ZA, LL49 9ZE, LL49 9ZH, LL51 9ZA, LL52 0ZD, LL52 0ZE, LL52 0ZN",180,83,97
W00000543,LL49,"LL49 9JA, LL49 9YB, LL49 9YE, LL49 9YF, LL49 9YG, LL49 9YH, LL49 9YJ, LL49 9YL, LL49 9YQ, LL49 9YS, LL49 9YU",194,102,92
W00000537,LL49,"LL49 9LA, LL49 9LB, LL49 9LD, LL49 9PW",381,61,320
W00000536,LL49,"LL49 9AB, LL49 9AW, LL49 9BU, LL49 9DB, LL49 9DD, LL49 9DE, LL49 9DF, LL49 9DG, LL49 9DH, LL49 9DL, LL49 9DU, LL49 9EP, LL49 9LY, LL49 9NA, LL49 9NB, LL49 9NG, LL49 9NH, LL49 9PG, LL49 9PQ",253,82,171
W00000535,LL49,"LL49 9DY, LL49 9HR, LL49 9HS, LL49 9HT, LL49 9HU, LL49 9HY, LL49 9LE, LL49 9PP, LL49 9PR",295,62,233
W00000534,LL49,"LL49 9BT, LL49 9BY, LL49 9DP, LL49 9DR, LL49 9DS, LL49 9DT, LL49 9ET, LL49 9EU, LL49 9JN, LL49 9LR, LL49 9NL, LL49 9NN",236,74,162
W00000533,LL49,"LL49 9BF, LL49 9EB, LL49 9ED, LL49 9EG, LL49 9EH, LL49 9EJ, LL49 9EN, LL49 9EQ, LL49 9EW, LL49 9EY, LL49 9HA, LL49 9HB, LL49 9HD, LL49 9HE, LL49 9LS, LL49 9PH",270,69,201
W00000532,LL49,"LL49 9AX, LL49 9DJ, LL49 9DN, LL49 9DW, LL49 9EA, LL49 9EE, LL49 9EF, LL49 9EL",253,46,207
W00000538,LL49,"LL49 9TT, LL49 9TY, LL49 9UA, LL49 9UB, LL49 9UD, LL49 9UE, LL49 9UF",144,68,76
W00000539,LL49,"LL49 9UU, LL49 9UY, LL49 9WY, LL49 9YA, LL49 9YD, LL49 9YP, LL49 9YR",276,149,127
W00000540,LL49,"LL49 9AA, LL49 9AD, LL49 9AE, LL49 9AJ, LL49 9AR, LL49 9AS, LL49 9AY, LL49 9AZ, LL49 9BP, LL49 9BS, LL49 9DA, LL49 9LL, LL49 9LN, LL49 9LP, LL49 9LT, LL49 9LU, LL49 9LW, LL49 9ND, LL49 9NE, LL49 9NF",121,61,60
W00010653,LL49,"LL49 9AQ, LL49 9BJ, LL49 9PS, LL49 9RA, LL49 9RB, LL49 9RD, LL49 9RE, LL49 9RF, LL49 9RG, LL49 9RH, LL49 9RL, LL49 9RN, LL49 9RW, LL49 9SN, LL49 9SP, LL49 9SR, LL49 9SS, LL49 9ST, LL49 9SU, LL49 9SW, LL49 9SY, LL49 9TA, LL49 9TB, LL49 9TD, LL49 9TE, LL49 9TF, LL49 9TG, LL51 9BQ",440,107,333
W00000549,LL49,"LL49 9PT, LL49 9PU, LL49 9PY",276,82,194
W00000541,LL49,"LL49 9AP, LL49 9AT, LL49 9AU, LL49 9BA, LL49 9BB, LL49 9BD, LL49 9BE, LL49 9BG, LL49 9BH, LL49 9BL, LL49 9BN, LL49 9GA, LL49 9NZ, LL49 9PA, LL49 9UN, LL49 9UW, LL49 9ZF, LL49 9ZG, LL49 9ZL, LL49 9ZN",259,108,151
W00000339,LL49,"LL49 9RP, LL49 9RR, LL49 9RS, LL49 9RT, LL49 9RU, LL49 9RY, LL49 9SA, LL49 9SB, LL49 9SD, LL49 9SE, LL49 9SF, LL49 9SG, LL49 9SH, LL49 9YN, LL51 9AQ, LL51 9AZ, LL51 9HX, LL51 9YT, LL51 9YU, LL52 0PU, LL52 0RD",297,82,215
W00000337,LL51,"LL51 9AL, LL51 9EX, LL51 9EZ, LL51 9LX, LL51 9NX, LL51 9NZ, LL51 9SJ, LL51 9SQ, LL51 9SX, LL51 9SZ, LL51 9TQ, LL51 9TX, LL51 9UJ, LL54 5DP, LL54 6WH, LL54 6XA",298,80,218
W00000338,LL51,"LL51 9AJ, LL51 9AX, LL51 9HZ, LL51 9LJ, LL51 9LQ, LL51 9NJ, LL51 9NQ, LL51 9PQ, LL51 9RJ, LL51 9RQ, LL51 9RX, LL51 9RZ, LL51 9TJ, LL51 9TZ, LL51 9UQ, LL51 9UX, LL51 9YY, LL52 0RF",276,110,166
W00000302,LL51,"LL51 9DJ, LL51 9DQ, LL51 9DX, LL51 9DZ, LL51 9EJ, LL51 9EQ, LL51 9LZ, LL54 5DD, LL54 5DE, LL54 5DF, LL54 5DG, LL54 5DL, LL54 5DN, LL54 5EU, LL54 5HA, LL54 5NR, LL54 5NS, LL54 5NT, LL54 5NW, LL54 5PB, LL54 5PF, LL54 5PN, LL54 6DS, LL54 6SY",374,133,241
W00000456,LL51,"LL51 9PJ, LL52 0LW, LL52 0NB, LL52 0ND, LL52 0NF, LL52 0NG, LL52 0NH, LL52 0NL, LL52 0NN, LL52 0NP, LL52 0NR, LL52 0NW, LL52 0PN, LL52 0SE, LL52 0SF",302,88,214
W00000455,LL52,"LL52 0LY, LL52 0NA, LL52 0NS, LL52 0NT, LL52 0NU, LL52 0NY, LL52 0PA, LL52 0PB, LL52 0PD, LL53 6DQ, LL53 6DX, LL53 6DZ, LL53 6LJ, LL53 6LX, LL53 6LZ, LL53 6SP, LL53 6SR, LL53 6SY, LL53 6SZ, LL53 6TA, LL53 6TB, LL53 6TQ",323,85,238
W00000458,LL52,"LL52 0LJ, LL52 0LR, LL52 0LS, LL52 0SA, LL52 0SB, LL52 0SD, LL52 0SG, LL52 0SH, LL52 0SJ, LL52 0SL, LL52 0SN, LL52 0SQ, LL52 0SR, LL52 0SS, LL52 0ST, LL52 0SU, LL52 0SW, LL52 0SY, LL53 6HJ, LL53 6HX, LL53 6NZ, LL53 6RJ, LL53 6RQ, LL53 6SJ, LL53 6SQ, LL53 6TX, LL53 6TZ",292,98,194
W00000457,LL52,"LL52 0LP, LL52 0LT, LL52 0LU, LL52 0SP, LL53 6SG, LL53 6SH, LL53 6SN, LL53 6SW, LL53 6SX, LL53 6TE, LL53 6TG, LL53 6TH, LL53 6TJ",299,69,230
W00000308,LL52,"LL52 0AA, LL52 0AB, LL52 0AD, LL52 0AE, LL52 0AF, LL52 0AG, LL52 0AN, LL52 0AP, LL52 0AQ, LL52 0AY, LL52 0BA, LL52 0BS, LL52 0BT, LL52 0BU, LL52 0BY, LL52 0DA, LL52 0DF, LL52 0EY, LL52 0HA, LL52 0HB, LL52 0HD, LL52 0HQ, LL52 0HS, LL52 0RN, LL52 0RW, LL52 0WY",230,111,119
W00000340,LL52,"LL52 0PE, LL52 0PT, LL52 0PW, LL52 0PY, LL52 0RA, LL52 0RB, LL52 0RE",270,121,149
W00000309,LL52,"LL52 0DB, LL52 0DD, LL52 0DE, LL52 0DG, LL52 0DH, LL52 0DL, LL52 0DN, LL52 0DP, LL52 0DR, LL52 0DS, LL52 0HE, LL52 0HF, LL52 0HG, LL52 0HH, LL52 0HL, LL52 0HN, LL52 0HP, LL52 0HW",268,121,147
W00000310,LL52,"LL52 0BW, LL52 0DW, LL52 0ED, LL52 0EE, LL52 0EJ, LL52 0EP, LL52 0ER, LL52 0ES, LL52 0LL, LL52 0RP, LL52 0RR, LL52 0RT, LL52 0RY, LL52 0TA, LL52 0TB, LL52 0TD, LL52 0YY",301,88,213
W00000311,LL52,"LL52 0DT, LL52 0DU, LL52 0DY, LL52 0EA, LL52 0EB, LL52 0EF, LL52 0EG, LL52 0EH, LL52 0EL, LL52 0EN, LL52 0RS, LL52 0RU",234,122,112
W00000312,LL52,"LL52 0AT, LL52 0AU, LL52 0BB, LL52 0BD, LL52 0BE, LL52 0BF, LL52 0BG, LL52 0BH, LL52 0BJ, LL52 0BL, LL52 0BN, LL52 0BP, LL52 0LN, LL52 0RG, LL52 0ZA",418,110,308
W00000313,LL52,"LL52 0AH, LL52 0AL, LL52 0AR, LL52 0AS, LL52 0AW, LL52 0HR, LL52 0HT, LL52 0HU, LL52 0HY, LL52 0HZ, LL52 0LA, LL52 0LB, LL52 0LD, LL52 0LE, LL52 0LF, LL52 0LG, LL52 0PF, LL52 0PH, LL52 0PL, LL52 0PP, LL52 0PR, LL52 0PS",247,119,128
W00000600,LL53,"LL53 8AQ, LL53 8AZ, LL53 8NB, LL53 8ND, LL53 8NE, LL53 8NF, LL53 8NG, LL53 8NH, LL53 8PB, LL53 8PD, LL53 8PE, LL53 8PF",295,41,254
W00000228,LL53,"LL53 8AP, LL53 8AW, LL53 8BD, LL53 8BE, LL53 8BG, LL53 8BL, LL53 8BP, LL53 8BS, LL53 8DA, LL53 8DB, LL53 8DE",246,49,197
W00000277,LL53,"LL53 7SP, LL53 7SR, LL53 7SS, LL53 8BJ, LL53 8DL, LL53 8DN, LL53 8DP, LL53 8DW, LL53 8HA, LL53 8HG, LL53 8PR, LL53 8PS, LL53 8PT, LL53 8PU, LL53 8PY, LL53 8RE, LL53 8RG, LL53 8RH, LL53 8RL, LL53 8RN, LL53 8RR, LL53 8RS, LL53 8RT, LL53 8SE, LL53 8TD, LL53 8TE, LL53 8ZA",314,85,229
W00000602,LL53,"LL53 8AJ, LL53 8AX, LL53 8NA, LL53 8NL, LL53 8NN, LL53 8NS, LL53 8NT, LL53 8NU, LL53 8PA, LL53 8SR, LL53 8SS, LL53 8SU, LL53 8TA",277,64,213
W00000403,LL53,"LL53 6NP, LL53 6NR, LL53 6NS, LL53 6NW",126,36,90
W00000276,LL53,"LL53 8DR, LL53 8DS, LL53 8DT, LL53 8DU, LL53 8EA, LL53 8ED, LL53 8EU, LL53 8EY, LL53 8HD, LL53 8RA, LL53 8RB, LL53 8RD, LL53 8RF",334,52,282
W00000275,LL53,"LL53 8BQ, LL53 8DY, LL53 8EB, LL53 8EE, LL53 8EF, LL53 8EG, LL53 8EH, LL53 8EL, LL53 8EN, LL53 8EP, LL53 8ER, LL53 8ES, LL53 8ET, LL53 8EW, LL53 8HF, LL53 8HL, LL53 8NP, LL53 8NR, LL53 8NW, LL53 8NY, LL53 8RP, LL53 8RW",313,89,224
W00000562,LL53,"LL53 5AU, LL53 5AY, LL53 5AZ, LL53 5BA",252,54,198
W00000229,LL53,"LL53 8BH, LL53 8BN, LL53 8BT, LL53 8BU, LL53 8BW, LL53 8BY, LL53 8DD, LL53 8HP, LL53 8HR, LL53 8HW, LL53 8LA, LL53 8LB, LL53 8LD, LL53 8LE, LL53 8LF, LL53 8LG, LL53 8LH, LL53 8LL, LL53 8LN, LL53 8LP, LL53 8LR, LL53 8LW",344,93,251
W00000601,LL53,"LL53 8SD, LL53 8SF, LL53 8SG, LL53 8SH, LL53 8SL, LL53 8SN, LL53 8SP, LL53 8ST, LL53 8SW, LL53 8SY, LL53 8TB, LL53 8TF, LL53 8TG, LL53 8UB, LL53 8UD, LL53 8UE",287,85,202
W00000563,LL53,"LL53 5AA, LL53 5AB, LL53 5AE, LL53 5AS, LL53 5AT, LL53 5BB, LL53 5BE",295,67,228
W00000482,LL53,"LL53 6BE, LL53 6JA, LL53 6JB, LL53 6JD, LL53 6JE, LL53 6YJ, LL53 6YX, LL53 6YZ, LL53 6ZD, LL53 6ZY, LL53 8YN, LL53 8YP, LL53 8YR, LL53 8YS, LL53 8YT, LL53 8YU, LL53 8YW, LL53 8YY",376,99,277
W00000359,LL53,"LL53 5TL, LL53 5TR, LL53 5UG, LL53 5UH, LL53 5UL, LL53 5UP, LL53 5UR, LL53 6DH, LL53 6DL, LL53 6DN, LL53 6DW, LL53 7NF, LL53 7NG, LL53 8TN, LL53 8TR, LL53 8TS, LL53 8TT",252,77,175
W00000358,LL53,"LL53 5UN, LL53 5UT, LL53 5UW, LL53 6YB, LL53 6YD, LL53 6YE, LL53 6ZB, LL53 8DJ, LL53 8DQ, LL53 8DX, LL53 8DZ, LL53 8EJ, LL53 8EQ, LL53 8EX, LL53 8EZ, LL53 8LJ, LL53 8LX, LL53 8LZ, LL53 8PQ",278,70,208
W00000481,LL53,"LL53 6AA, LL53 6AB, LL53 6AD, LL53 6AE, LL53 6AF, LL53 6AG, LL53 6AH, LL53 6AL, LL53 6AN, LL53 6BP, LL53 6BS, LL53 6BW, LL53 6EJ, LL53 6EU, LL53 6EX, LL53 8UN, LL53 8UP",393,86,307
W00000404,LL53,"LL53 6EY, LL53 6EZ, LL53 6LP, LL53 6LR, LL53 6LS, LL53 6LT, LL53 6LU, LL53 6LW, LL53 6LY, LL53 6NA, LL53 6NH, LL53 6NL, LL53 6NN, LL53 6NT, LL53 6NU, LL53 6NY, LL53 6PA, LL53 6PB, LL53 6PD, LL53 6PE",361,125,236
W00000483,LL53,"LL53 6BD, LL53 6BG, LL53 6BL, LL53 6BN, LL53 6BT, LL53 6BU, LL53 6DD, LL53 6DE, LL53 6DF, LL53 6ER, LL53 6ES, LL53 6EW, LL53 6YN",213,69,144
W00000484,LL53,"LL53 6AP, LL53 6AR, LL53 6AS, LL53 6AT, LL53 6AU, LL53 6AW, LL53 6AY, LL53 6BA, LL53 6BB, LL53 6BH, LL53 6BY, LL53 6DA, LL53 6DB, LL53 6DG, LL53 6EQ, LL53 8UL, LL53 8UW",206,75,131
W00000485,LL53,"LL53 6HD, LL53 6HE, LL53 6HF, LL53 6HG, LL53 6HH, LL53 6HL, LL53 6HN, LL53 6HP, LL53 6HY, LL53 6JF, LL53 6LA",264,48,216
W00000486,LL53,"LL53 6DU, LL53 6ET, LL53 6HW, LL53 6LB, LL53 6LD, LL53 6LE, LL53 6LH",233,54,179
W00000487,LL53,"LL53 6EB, LL53 6ED, LL53 6EE, LL53 6EF, LL53 6EG, LL53 6EH, LL53 6EL, LL53 6EN, LL53 6EP",208,67,141
W00000488,LL53,"LL53 6DY, LL53 6EA, LL53 6HA, LL53 6HB, LL53 6HU, LL53 6NB, LL53 6ND, LL53 6NE",282,80,202
W00000489,LL53,"LL53 6HR, LL53 6HS, LL53 6HT, LL53 6LF, LL53 6LG, LL53 6LL, LL53 6LN, LL53 6TL, LL53 6TN, LL53 6TW",275,89,186
W00000236,LL53,"LL53 6NF, LL53 6NG, LL53 6RG, LL53 6RH, LL53 6RN, LL53 6RR, LL53 6RS, LL53 6RT, LL53 6RU, LL53 6TT, LL53 6TU, LL53 6UT, LL53 6UU, LL53 6UY, LL53 6WA, LL53 6YA, LL53 6YF, LL53 6YG",274,75,199
W00000237,LL53,"LL53 6BZ, LL53 6LQ, LL53 6PL, LL53 6PN, LL53 6PW, LL53 6PZ, LL53 6RP, LL53 6RW, LL53 6SB, LL53 6SD, LL53 6TY, LL53 6UA, LL53 6UB, LL53 6UD, LL53 6UH, LL53 6UJ, LL53 6UL, LL53 6UN, LL53 6US, LL53 6UW, LL53 6YH, LL53 6YS, LL53 6YU, LL53 6YY",272,51,221
W00000360,LL53,"LL53 5TG, LL53 5TH, LL53 5TJ, LL53 5TN, LL53 5TP, LL53 5TW, LL53 7HF, LL53 7NE, LL53 7NH, LL53 7TA, LL53 7TB, LL53 7TD, LL53 7TE, LL53 8TP, LL53 8TW",269,61,208
W00000409,LL53,"LL53 5PT, LL53 7AJ, LL53 7HG, LL53 7HH, LL53 7HL, LL53 7HN, LL53 7NL, LL53 7NN, LL53 7NR, LL53 7NS, LL53 7NT, LL53 7NW, LL53 7PH, LL53 7PU, LL53 7TF, LL53 7TN, LL53 7TP, LL53 7TW, LL53 7UR, LL53 7UT",343,185,158
W00000357,LL53,"LL53 6DP, LL53 6DR, LL53 6DS, LL53 6DT, LL53 6YQ, LL53 7PL, LL53 7PN, LL53 7PT, LL53 7PW, LL53 7YH, LL53 7YL, LL53 7YN, LL53 7YP, LL53 7YR, LL53 7YS, LL53 7YW, LL53 8PJ, LL53 8PL, LL53 8PX, LL53 8PZ, LL53 8SB, LL53 8TU, LL53 8TY, LL53 8UA, LL53 8UF, LL53 8UG, LL53 8UH, LL53 8UR, LL53 8UT, LL53 8UU, LL53 8UY, LL53 8YE, LL53 8YF, LL53 8YG, LL53 8YH, LL53 8YL",464,139,325
W00000411,LL53,"LL53 7AQ, LL53 7PD, LL53 7PG, LL53 7PY, LL53 7RE, LL53 7RP, LL53 7TG, LL53 7TH, LL53 7TL, LL53 7TR, LL53 7TS, LL53 7TT, LL53 7TU, LL53 7TY, LL53 7UA, LL53 7UB, LL53 7UN, LL53 7UP, LL53 7UW",227,84,143
W00000561,LL53,"LL53 5BP, LL53 5ND, LL53 5NT, LL53 5PA, LL53 5PB, LL53 5PD, LL53 5PG, LL53 5PH, LL53 5PL, LL53 5PN, LL53 5WA, LL53 5WB, LL53 5WD, LL53 5WE, LL53 5WF, LL53 5WJ, LL53 5WT, LL53 5WZ, LL53 6ZA, LL53 7WA, LL53 7WB, LL53 7WD, LL53 7WF, LL53 7WG, LL53 8ZB, LL53 8ZD, LL53 8ZE, LL53 8ZF, LL53 8ZG, LL53 8ZH, LL53 8ZU, LL53 9AA, LL53 9AD, LL53 9AE, LL53 9AF, LL53 9AG, LL53 9AH, LL53 9AJ, LL53 9AL, LL53 9AN, LL53 9AP, LL53 9AQ, LL53 9AR, LL53 9AS, LL53 9AT, LL53 9AU, LL53 9AW, LL53 9AX",276,102,174
W00000560,LL53,"LL53 5AX, LL53 5NE, LL53 5NU, LL53 5NY, LL53 5PF, LL53 5PU, LL53 5PW, LL53 5PY",305,57,248
W00000559,LL53,"LL53 5PP, LL53 5PR, LL53 5PS, LL53 5RA, LL53 5RP",228,47,181
W00000558,LL53,"LL53 5AD, LL53 5AL, LL53 5AN",155,76,79
W00000253,LL53,"LL53 7AP, LL53 7AR, LL53 7AS, LL53 7AW, LL53 7DL, LL53 7DR, LL53 7DS, LL53 7EA, LL53 7HP, LL53 7HQ, LL53 7HR, LL53 7HS, LL53 7HU, LL53 7HW, LL53 7HX, LL53 7HY, LL53 7HZ, LL53 7LB, LL53 7LY",165,96,69
W00000252,LL53,"LL53 7AA, LL53 7AB, LL53 7AD, LL53 7AE, LL53 7AF, LL53 7AG, LL53 7AH, LL53 7AL, LL53 7AN, LL53 7AX, LL53 7LA, LL53 7UD, LL53 7UE, LL53 7UF, LL53 7UG, LL53 7UH, LL53 7UJ, LL53 7UL, LL53 7UQ, LL53 7WE",163,65,98
W00000251,LL53,"LL53 7DE, LL53 7DJ, LL53 7ED, LL53 7EG, LL53 7EH, LL53 7EN",137,61,76
W00000250,LL53,"LL53 7AT, LL53 7AU, LL53 7AY, LL53 7BA, LL53 7BB, LL53 7BD, LL53 7BE, LL53 7DN, LL53 7DP, LL53 7DT, LL53 7DU, LL53 7DW, LL53 7DX, LL53 7DY, LL53 7DZ, LL53 7EB, LL53 7EE, LL53 7EF, LL53 7EL, LL53 7EP, LL53 7ER, LL53 7EW, LL53 7EY, LL53 7HT, LL53 7WY",134,84,50
W00000557,LL53,"LL53 5AF, LL53 5AG, LL53 5AH, LL53 5AJ, LL53 5AP, LL53 5AR, LL53 5AW, LL53 5BD, LL53 5PE",301,58,243
W00000410,LL53,"LL53 7NP, LL53 7NU, LL53 7NY, LL53 7PA, LL53 7PB, LL53 7PE, LL53 7PF",254,69,185
W00000551,LL53,"LL53 5BL, LL53 5BN, LL53 5BT, LL53 5BW, LL53 5HW, LL53 5RH, LL53 5SR, LL53 5ST, LL53 5TA, LL53 5WG",317,58,259
W00000238,LL53,"LL53 6UE, LL53 6UF, LL53 6UG, LL53 6UP, LL53 6UQ, LL53 6UR",263,42,221
W00000552,LL53,"LL53 5BY, LL53 5DA, LL53 5DD, LL53 5DE, LL53 5DF, LL53 5DG, LL53 5DH, LL53 5DL, LL53 5DN, LL53 5DP, LL53 5DW, LL53 5HA, LL53 5HB, LL53 5HD, LL53 5HE, LL53 5HF, LL53 5HG, LL53 5HH, LL53 5HL, LL53 5HN, LL53 5HP, LL53 5HR, LL53 5HS, LL53 5NF, LL53 5NH, LL53 5NJ, LL53 5NL, LL53 5NN, LL53 5NP, LL53 5NR, LL53 5NS, LL53 5NW, LL53 5RL, LL53 5RN, LL53 5RR, LL53 5RS, LL53 5RU, LL53 5RW, LL53 5SA, LL53 5SB, LL53 5YR",361,129,232
W00000556,LL53,"LL53 5ER, LL53 5ES, LL53 5EU, LL53 5LB, LL53 5LR, LL53 5LS, LL53 5LT, LL53 5LU",325,52,273
W00000555,LL53,"LL53 5EH, LL53 5EJ, LL53 5LF, LL53 5LG, LL53 5LH, LL53 5LL, LL53 5LN, LL53 5LP, LL53 5LW, LL53 5UD, LL53 5YA, LL53 5YQ, LL53 5YS, LL53 5YT, LL53 5YU, LL53 5YW, LL53 5YY",233,67,166
W00000554,LL53,"LL53 5DY, LL53 5EA, LL53 5EB, LL53 5ED, LL53 5EE, LL53 5EL, LL53 5EN, LL53 5EW, LL53 5GA, LL53 5SN, LL53 5SP, LL53 5SW, LL53 5TB, LL53 5TF, LL53 5UA, LL53 5UB, LL53 5UE, LL53 5UF",320,65,255
W00000230,LL53,"LL53 8AA, LL53 8AB, LL53 8AD, LL53 8AE, LL53 8AF, LL53 8AG, LL53 8AH, LL53 8AL, LL53 8AN, LL53 8AR, LL53 8AS, LL53 8AT, LL53 8AU, LL53 8HH, LL53 8HN, LL53 8HS, LL53 8HT, LL53 8HU, LL53 8HY",283,92,191
W00000553,LL53,"LL53 5BU, LL53 5DB, LL53 5DS, LL53 5DT, LL53 5DU, LL53 5NX, LL53 5RB, LL53 5RE, LL53 5RF, LL53 5RG, LL53 5SH, LL53 5SL, LL53 5WH",242,51,191
W00000240,LL53,"LL53 6BJ, LL53 6BQ, LL53 6HQ, LL53 6PJ, LL53 6PQ, LL53 6PX",169,45,124
W00000459,LL53,"LL53 6DJ, LL53 6PG, LL53 6PT, LL53 6PU, LL53 6PY, LL53 6RA, LL53 6RB, LL53 6RD, LL53 6RE, LL53 6RF, LL53 6RL, LL53 6SE, LL53 6SS, LL53 6ST, LL53 6SU, LL53 6TD, LL53 6YL",326,71,255
W00000550,LL53,"LL53 5DR, LL53 5EF, LL53 5EG, LL53 5EP, LL53 5ET, LL53 5HT, LL53 5HU, LL53 5HY, LL53 5LA, LL53 5LD, LL53 5LE, LL53 5RT, LL53 5RY, LL53 5SD, LL53 5SE, LL53 5SF, LL53 5SG, LL53 5WY",237,65,172
W00000239,LL53,"LL53 5TY, LL53 5YB, LL53 5YD, LL53 5YE, LL53 5YF, LL53 5YG, LL53 5YH, LL53 6AJ, LL53 6AQ, LL53 6AX, LL53 6AZ, LL53 6BF, LL53 6BX, LL53 6YP, LL53 6YR, LL53 6YT",256,64,192
W00000426,LL53,"LL53 7BH, LL53 7BL, LL53 7BN, LL53 7BP, LL53 7BS, LL53 7BT, LL53 7BU, LL53 7BW, LL53 7BY, LL53 7DA, LL53 7DB, LL53 7DD, LL53 7DF, LL53 7DG, LL53 7DH, LL53 7ET, LL53 7EU, LL53 7LE, LL53 7LF",215,102,113
W00000425,LL53,"LL53 7BG, LL53 7ES, LL53 7LD, LL53 7LG, LL53 7LH, LL53 7LL, LL53 7LN, LL53 7LP, LL53 7LR, LL53 7LS, LL53 7LT, LL53 7LU, LL53 7LW, LL53 7PP, LL53 7PR, LL53 7PS, LL53 7SL, LL53 7SN, LL53 7SW, LL53 7YA, LL53 7YB, LL53 7YD",290,87,203
W00000454,LL53,"LL53 6HZ, LL53 6NJ, LL53 6NQ, LL53 6NX, LL53 6PF, LL53 6PP, LL53 6PR, LL53 6PS, LL53 6RX, LL53 6RZ, LL53 6SF, LL53 6SL, LL53 6TF",329,66,263
W00000424,LL53,"LL53 7RL, LL53 7RR, LL53 7RU, LL53 7RY, LL53 7SA, LL53 7SB, LL53 7SD, LL53 7SE, LL53 7SF, LL53 7SG, LL53 7SJ, LL53 7SQ, LL53 7ST",277,110,167
W00000423,LL53,"LL53 7RD, LL53 7RF, LL53 7RG, LL53 7RH, LL53 7RJ, LL53 7RN, LL53 7RS, LL53 7RT, LL53 7RW, LL53 7SH",263,100,163
W00000453,LL54,"LL54 7AZ, LL54 7LQ, LL54 7LR, LL54 7LS, LL54 7LY, LL54 7NA, LL54 7NB, LL54 7NG, LL54 7NN, LL54 7NT, LL54 7NY, LL54 7PB, LL54 7PE, LL54 7PF, LL54 7PH, LL54 7PN, LL54 7PP",380,54,326
W00000576,LL54,"LL54 7AG, LL54 7AH, LL54 7AL, LL54 7AN, LL54 7AU, LL54 7BE, LL54 7BG, LL54 7BP, LL54 7BS, LL54 7BT, LL54 7BW, LL54 7BX, LL54 7PT, LL54 7PU, LL54 7PY, LL54 7RB, LL54 7RD, LL54 7RE, LL54 7RF, LL54 7RQ",253,114,139
W00000577,LL54,"LL54 7AE, LL54 7AF, LL54 7AY, LL54 7BA, LL54 7BB, LL54 7BD, LL54 7BH, LL54 7BL, LL54 7BN, LL54 7RS, LL54 7RT, LL54 7RU, LL54 7RY, LL54 7SA, LL54 7SD, LL54 7SF, LL54 7SG, LL54 7SH",271,88,183
W00000578,LL54,"LL54 7AA, LL54 7AB, LL54 7AD, LL54 7AR, LL54 7AS, LL54 7AT, LL54 7DR, LL54 7DS, LL54 7RL, LL54 7RN, LL54 7RP, LL54 7RR, LL54 7RW, LL54 7SB, LL54 7SE, LL54 7SL, LL54 7SN, LL54 7SP",315,54,261
W00000448,LL54,"LL54 7BY, LL54 7EU, LL54 7HB, LL54 7HE, LL54 7HF, LL54 7HG, LL54 7HH, LL54 7HL, LL54 7HR, LL54 7HS, LL54 7HU, LL54 7HX, LL54 7HY, LL54 7LB, LL54 7LD, LL54 7LE, LL54 7LF, LL54 7PL, LL54 7RA",318,102,216
W00000579,LL54,"LL54 6AB, LL54 6AD, LL54 6AH, LL54 6AJ, LL54 6AL, LL54 6AR, LL54 6AS, LL54 6AW, LL54 6AX, LL54 6HP, LL54 6HR, LL54 6HT",373,112,261
W00000449,LL54,"LL54 5UD, LL54 7NH, LL54 7PW, LL54 7UY, LL54 7YA, LL54 7YB, LL54 7YG, LL54 7YH, LL54 7YJ, LL54 7YL, LL54 7YN, LL54 7YP, LL54 7YQ, LL54 7YW",339,49,290
W00000529,LL54,"LL54 6DA, LL54 6LS, LL54 6LT, LL54 6NA, LL54 6NB, LL54 6ND, LL54 6NE, LL54 6NF, LL54 6NH, LL54 6NL, LL54 6NW, LL54 6PF, LL54 6TU",270,48,222
W00000528,LL54,"LL54 6PR, LL54 6PU, LL54 6RE, LL54 6RF, LL54 6RG, LL54 6RH, LL54 6RL, LL54 6SD",310,38,272
W00000526,LL54,"LL54 6AA, LL54 6DB, LL54 6EU, LL54 6EY, LL54 6HB, LL54 6HD, LL54 6HE, LL54 6HJ, LL54 6LY, LL54 6RN, LL54 6RW",328,52,276
W00000501,LL54,"LL54 5WA, LL54 5WD, LL54 5WE, LL54 5ZB, LL54 5ZF, LL54 6ZA, LL54 6ZH, LL54 6ZU, LL54 6ZY, LL54 7ZA, LL54 7ZB, LL54 7ZG, LL54 7ZN, LL54 7ZS, LL55 1ZA, LL55 1ZB, LL55 1ZE, LL55 1ZG, LL55 1ZP, LL55 1ZU, LL55 2AN, LL55 2BD, LL55 2BF, LL55 2BG, LL55 2BN, LL55 2BU, LL55 2BX, LL55 2DU, LL55 2EA, LL55 2EB, LL55 2ED, LL55 2EE, LL55 2HB, LL55 2WB, LL55 2WE, LL55 2WF, LL55 2WG, LL55 2WH, LL55 2WL, LL55 2WN, LL55 2WP, LL55 2WT, LL55 3XW, LL55 3ZB, LL55 3ZD, LL55 3ZE, LL55 3ZJ, LL55 3ZL, LL55 3ZN, LL55 3ZY, LL55 4WA, LL55 4WB, LL55 4WD, LL55 4WE, LL55 4WG, LL55 4WH, LL55 4WJ, LL55 4WL, LL55 4WN, LL55 4WP, LL55 4WR, LL55 4WX, LL55 4WY, LL55 4WZ, LL55 4XA, LL55 9AA, LL55 9AD, LL55 9AE, LL55 9AF, LL55 9AG, LL55 9AH, LL55 9AJ, LL55 9AN, LL55 9AP, LL55 9AQ, LL55 9AR, LL55 9AS, LL55 9AT, LL55 9AU, LL55 9AW, LL55 9AX, LL55 9AY, LL55 9AZ, LL55 9BA, LL55 9BB, LL55 9BD, LL55 9BE, LL55 9BF, LL55 9BG, LL55 9BH, LL55 9BJ, LL55 9BL, LL55 9BN, LL55 9BP, LL55 9BQ, LL55 9BR, LL55 9BS, LL55 9BT, LL55 9BU, LL55 9BW, LL55 9BX, LL55 9BY, LL55 9BZ, LL55 9DA, LL55 9DB, LL55 9DD, LL55 9DE, LL55 9DF",345,55,290
W00000450,LL54,"LL54 5RB, LL54 5SD, LL54 5TG, LL54 5TL, LL54 5UA, LL54 5UB, LL54 5UE, LL54 5UF, LL54 5UG, LL54 5UH, LL54 5UL, LL54 5UN, LL54 5UP, LL54 5UW, LL54 5YA",357,68,289
W00000527,LL54,"LL54 6BF, LL54 6ES, LL54 6ET, LL54 6LP, LL54 6LQ, LL54 6LR, LL54 6LU, LL54 6LW, LL54 6NU, LL54 6NY, LL54 6PA, LL54 6PH",242,45,197
W00000581,LL54,"LL54 6HF, LL54 6HG, LL54 6HH, LL54 6HL, LL54 6HN, LL54 6HU, LL54 6HW, LL54 6HY, LL54 6LA, LL54 6LB, LL54 6LD, LL54 6LL, LL54 6PY, LL54 6ZB, LL54 6ZD, LL54 6ZE, LL54 6ZF, LL54 6ZG",341,100,241
W00000452,LL54,"LL54 7BU, LL54 7ET, LL54 7EY, LL54 7HA, LL54 7HD, LL54 7HN, LL54 7HP, LL54 7HT, LL54 7HW, LL54 7LA, LL54 7LG, LL54 7PA",320,52,268
W00000580,LL54,"LL54 6AE, LL54 6AF, LL54 6AN, LL54 6AP, LL54 6AQ, LL54 6AT, LL54 6AU, LL54 6BY, LL54 6HA, LL54 6HS, LL54 6LE, LL54 6LF, LL54 6LG, LL54 6PT",324,98,226
W00000451,LL54,"LL54 7LH, LL54 7LN, LL54 7LP, LL54 7LT, LL54 7LU, LL54 7LW, LL54 7ND, LL54 7NE, LL54 7NF, LL54 7NS, LL54 7NU, LL54 7PD",295,55,240
W00000436,LL54,"LL54 6DN, LL54 6DP, LL54 6DR, LL54 6DT, LL54 6DU, LL54 6DW, LL54 6DY, LL54 6EA, LL54 6EB, LL54 6ED, LL54 6EE, LL54 6EF, LL54 6EG, LL54 6EH, LL54 6EL, LL54 6EN, LL54 6EW, LL54 6RT, LL54 6RU, LL54 6RY, LL54 6SA, LL54 6SB, LL54 6ST, LL54 6SU, LL54 6TA",345,129,216
W00000531,LL54,"LL54 6NG, LL54 6NN, LL54 6NP, LL54 6NR, LL54 6NS, LL54 6NT, LL54 6NZ, LL54 6PB, LL54 6PD, LL54 6PE",285,52,233
W00000402,LL54,"LL54 5AE, LL54 5AF, LL54 5AG, LL54 5AH, LL54 5AJ, LL54 5AL, LL54 5AN, LL54 5AP, LL54 5AR, LL54 5AS, LL54 5AT, LL54 5AU, LL54 5AW, LL54 5AY, LL54 5BE, LL54 5BG, LL54 5DW",295,101,194
W00000401,LL54,"LL54 5BJ, LL54 5HE, LL54 5HR, LL54 5HS, LL54 5HT, LL54 5HU, LL54 5HY, LL54 5LB, LL54 5LD, LL54 5LF, LL54 5LH, LL54 5LP, LL54 5LR, LL54 5LW, LL54 5NA",232,68,164
W00000400,LL54,"LL54 5HF, LL54 5HG, LL54 5HH, LL54 5HL, LL54 5HP, LL54 5HW, LL54 5LA, LL54 5LN, LL54 5LS, LL54 5LU, LL54 5LY",208,40,168
W00000399,LL54,"LL54 5AA, LL54 5AB, LL54 5AD, LL54 5AZ, LL54 5BA, LL54 5BB, LL54 5BD, LL54 5BH, LL54 5HN, LL54 5LE, LL54 5LT, LL54 5NB, LL54 5PS, LL54 5PT",293,83,210
W00000616,LL54,"LL54 6TF, LL54 6TG, LL54 6TH, LL54 6TL, LL54 6TN, LL54 6TP, LL54 6TW, LL54 7AJ, LL54 7AQ, LL54 7AX, LL54 7BJ, LL54 7BQ, LL54 7YR, LL54 7YS, LL54 7YT, LL54 7YU, LL54 7YY, LL54 7ZW, LL55 4AQ, LL55 4LP",240,105,135
W00000381,LL54,"LL54 5DU, LL54 5DY, LL54 7DE, LL54 7DF, LL54 7DG, LL54 7ST, LL54 7SY, LL54 7TD, LL54 7TE, LL54 7TR, LL54 7TS, LL54 7TT, LL54 7UE, LL54 7UG, LL54 7UL",241,53,188
W00000530,LL54,"LL54 6NX, LL54 6PG, LL54 6PJ, LL54 6PL, LL54 6PN, LL54 6PP, LL54 6PS, LL54 6PW, LL54 6RA",309,62,247
W00000379,LL54,"LL54 7DH, LL54 7SU, LL54 7TA, LL54 7TB, LL54 7TF, LL54 7TG, LL54 7TJ, LL54 7TL, LL54 7TQ",318,52,266
W00000378,LL54,"LL54 5LL, LL54 5SE, LL54 5SF, LL54 5SG, LL54 5SH, LL54 5SJ, LL54 5SL, LL54 5SN, LL54 5SP, LL54 5SR, LL54 5SS, LL54 5ST, LL54 5SW, LL54 5SY, LL54 5TB, LL54 5TD, LL54 5TE, LL54 5TH, LL54 5TJ, LL54 5TQ, LL54 5TR, LL54 5TS, LL54 7DD, LL54 7EE, LL54 7EF, LL54 7UF",292,62,230
W00000380,LL54,"LL54 7AP, LL54 7AW, LL54 7BF, LL54 7DL, LL54 7DP, LL54 7DW, LL54 7EN, LL54 7NL, LL54 7PG, LL54 7SW, LL54 7TP, LL54 7TU, LL54 7TW, LL54 7TY, LL54 7UA, LL54 7UB, LL54 7UD, LL54 7ZD, LL54 7ZE, LL54 7ZF",277,71,206
W00000376,LL54,"LL54 7DN, LL54 7DT, LL54 7DU, LL54 7DY, LL54 7EA, LL54 7EB, LL54 7ED, LL54 7EG, LL54 7EH, LL54 7EL, LL54 7EW, LL54 7TH, LL54 7TN",238,57,181
W00000273,LL54,"LL54 7UN, LL54 7UP, LL54 7UW, LL55 2EZ, LL55 2UB, LL55 2UD, LL55 2UW",297,35,262
W00000271,LL54,"LL54 7UR, LL54 7UT, LL54 7YE, LL55 2TB, LL55 2TD, LL55 2TE, LL55 2TF, LL55 2TH, LL55 2TP, LL55 2UF, LL55 2UG, LL55 2UL, LL55 2UN, LL55 2YA",294,57,237
W00000575,LL54,"LL54 5RG, LL54 5RL, LL54 5RR, LL54 5RS, LL54 5RT, LL55 2NR, LL55 2NT, LL55 2NU, LL55 2NY, LL55 2PB, LL55 2PE, LL55 2PF, LL55 2PP, LL55 2RZ, LL55 2YB, LL55 2YD, LL55 2YG, LL55 2YN, LL55 2YP, LL55 2YR, LL55 2YS, LL55 2YT, LL55 2YU, LL55 2YW",236,75,161
W00000301,LL54,"LL54 5AQ, LL54 5BP, LL54 5BS, LL54 5BT, LL54 5BU, LL54 5BW, LL54 5DA, LL54 5DB, LL54 5DH, LL54 5NG, LL54 5NH, LL54 5NL, LL54 5NN, LL54 5NP, LL54 5PD, LL54 5PE, LL54 5PG, LL54 5PH, LL54 5PL, LL54 5PP, LL54 5PR, LL54 5PW",294,81,213
W00000303,LL54,"LL54 5ED, LL54 5EE, LL54 5EF, LL54 5EG, LL54 5EH, LL54 5EJ, LL54 5EL, LL54 5EN, LL54 5EP, LL54 5ER, LL54 5ES, LL54 5ET, LL54 5EW, LL54 5EY, LL54 5WB, LL54 5WF, LL54 5WH, LL54 5WJ, LL54 5ZA",262,68,194
W00000435,LL54,"LL54 6AZ, LL54 6DD, LL54 6DF, LL54 6DJ, LL54 6SG, LL54 6SL, LL54 6SN, LL54 6SP, LL54 6SW",335,67,268
W00000437,LL54,"LL54 6DE, LL54 6DG, LL54 6DH, LL54 6DL, LL54 6RP, LL54 6RR, LL54 6SH, LL54 6SR, LL54 6SS",303,58,245
W00000438,LL54,"LL54 6AG, LL54 6AY, LL54 6BA, LL54 6BB, LL54 6BD, LL54 6BE, LL54 6BG, LL54 6BH, LL54 6BL, LL54 6BN, LL54 6BP, LL54 6BS, LL54 6BT, LL54 6BU, LL54 6BW, LL54 6RS",200,69,131
W00000377,LL54,"LL54 5EA, LL54 5EB, LL54 5SU, LL54 5TA, LL54 5TF, LL54 5TN, LL54 5TP, LL54 5TT, LL54 5TW",252,76,176
W00000274,LL54,"LL54 5RA, LL54 5RD, LL54 5RE, LL54 5RF, LL54 5RH, LL54 5RN, LL54 5RP, LL54 5RU, LL54 5RW, LL54 5TU, LL54 5TY, LL54 7YF",180,47,133
W00000571,LL55,"LL55 2AG, LL55 2DQ, LL55 2UR, LL55 2YE, LL55 2YF, LL55 2YL",282,40,242
W00000572,LL55,"LL55 2GA, LL55 2GB, LL55 2LP, LL55 2LS, LL55 2LT, LL55 2LW, LL55 2TU, LL55 2WJ",288,30,258
W00000573,LL55,"LL55 2LQ, LL55 2LY, LL55 2UP, LL55 2US, LL55 2UT, LL55 2UU, LL55 2UY, LL55 2WA",322,47,275
W00000570,LL55,"LL55 2LJ, LL55 2LR, LL55 2LU",243,37,206
W00000574,LL55,"LL55 2DJ, LL55 2DX, LL55 2LX",268,47,221
W00000617,LL55,"LL55 2BE, LL55 2NG, LL55 2NH, LL55 2NJ, LL55 2NL, LL55 2NS, LL55 2PA, LL55 2PD, LL55 2PL, LL55 2PY, LL55 2SE, LL55 2SG, LL55 2SH, LL55 2SS, LL55 2ST, LL55 2SU, LL55 2SY, LL55 2TA, LL55 2TW",242,43,199
W00000566,LL55,"LL55 2HE, LL55 2HL, LL55 2LA, LL55 2LH, LL55 2LL, LL55 2RF",270,46,224
W00000565,LL55,"LL55 2AF, LL55 2PH, LL55 2PS, LL55 2PT, LL55 2RB, LL55 2RD",160,59,101
W00000564,LL55,"LL55 1AB, LL55 1AF, LL55 1AG, LL55 1NL, LL55 1NT, LL55 1NU, LL55 1RB, LL55 1RD, LL55 1RF, LL55 1RL, LL55 1RN, LL55 1RP, LL55 1RR, LL55 1SD, LL55 1SE, LL55 1SF, LL55 1SG, LL55 1SH, LL55 1SL, LL55 1SN, LL55 1TL, LL55 1ZH, LL55 2AA, LL55 2AB, LL55 2AS, LL55 2AU, LL55 2AY, LL55 2NA, LL55 2NB, LL55 2ND, LL55 2NF, LL55 2NN, LL55 2NP, LL55 2NW, LL55 2PG, LL55 2PN, LL55 2PQ, LL55 2PR, LL55 2PU, LL55 2PW, LL55 2WY, LL55 9AB, LL55 9ZX, LL55 9ZY, LL55 9ZZ",205,75,130
W00000618,LL55,"LL55 4AJ, LL55 4LZ, LL55 4PJ, LL55 4YT, LL55 4YU, LL55 4YX, LL55 4YY, LL55 4YZ, LL55 4ZA, LL55 4ZY",320,58,262
W00000619,LL55,"LL55 4AX, LL55 4BJ, LL55 4BX, LL55 4BZ, LL55 4DZ, LL55 4EJ, LL55 4EQ, LL55 4EX, LL55 4LQ, LL55 4SB",268,88,180
W00000620,LL55,"LL55 2TG, LL55 2TL, LL55 4EZ, LL55 4HQ, LL55 4PQ, LL55 4SD, LL55 4YP, LL55 4YR, LL55 4YS",282,79,203
W00000621,LL55,"LL55 4AZ, LL55 4BQ, LL55 4DJ, LL55 4DQ, LL55 4DX, LL55 4LJ, LL55 4LX, LL55 4PZ",303,65,238
W00000545,LL55,"LL55 4LR, LL55 4LS, LL55 4LT, LL55 4LU, LL55 4LY, LL55 4NA, LL55 4NB, LL55 4ND, LL55 4NJ, LL55 4UY, LL55 4YA, LL55 4YB, LL55 4YD, LL55 4YE, LL55 4YJ, LL55 4YQ, LL55 4YW",237,118,119
W00000567,LL55,"LL55 2HG, LL55 2HH, LL55 2HP, LL55 2HY, LL55 2LB, LL55 2LD, LL55 2LE, LL55 2YH",179,44,135
W00000625,LL55,"LL55 1TR, LL55 1TS, LL55 1TT, LL55 1TU, LL55 1TY, LL55 1UE, LL56 4LY, LL56 4NJ, LL56 4NX, LL56 4NY, LL56 4NZ, LL56 4RJ, LL56 4RX, LL56 4SZ, LL56 4TQ",331,79,252
W00000568,LL55,"LL55 2HR, LL55 2HS, LL55 2HT, LL55 2HU, LL55 2HW",238,30,208
W00000508,LL55,"LL55 3AN, LL56 4QF, LL57 4EB, LL57 4ED, LL57 4EF, LL57 4EH, LL57 4EN, LL57 4EW, LL57 4EX, LL57 4GD, LL57 4HB, LL57 4HE, LL57 4HF, LL57 4HH, LL57 4UA",420,119,301
W00000315,LL55,"LL55 1UD, LL55 2AH, LL55 2AQ, LL55 2BA, LL55 2BB, LL55 2BH, LL55 2BP, LL55 2SL, LL55 2SN, LL55 2SP, LL55 2SR, LL55 2SW, LL55 2TN, LL55 4HJ, LL55 4HX, LL55 4RA, LL55 4RT, LL55 4RY, LL55 4SA",316,80,236
W00000314,LL55,"LL55 4DA, LL55 4DB, LL55 4DU, LL55 4EA, LL55 4EB, LL55 4FD, LL55 4PY, LL55 4RB, LL55 4RE, LL55 4RF, LL55 4RG, LL55 4RH, LL55 4RJ, LL55 4RL, LL55 4RN, LL55 4RP, LL55 4RR, LL55 4RS, LL55 4RU, LL55 4RW",319,89,230
W00000300,LL55,"LL55 1AD, LL55 1ND, LL55 1NE, LL55 1NF, LL55 1NG, LL55 1NH, LL55 1NN, LL55 1NP, LL55 1NS, LL55 1NW, LL55 1PP, LL55 1PT, LL55 1QL, LL55 2AD, LL55 2AW, LL55 2NE, LL55 2RA",234,66,168
W00000298,LL55,"LL55 1BY, LL55 1DA, LL55 1DB, LL55 1DD, LL55 1DH, LL55 1HD, LL55 1HE, LL55 1HF, LL55 1HG",333,65,268
W00000444,LL55,"LL55 2AJ, LL55 2AX, LL55 2AZ, LL55 2BQ, LL55 2DA, LL55 2EQ, LL55 4AD, LL55 4AE, LL55 4BP, LL55 4BS, LL55 4BU, LL55 4FG, LL55 4PE, LL55 4PF, LL55 4PG",330,50,280
W00000443,LL55,"LL55 4AA, LL55 4PH, LL55 4PL, LL55 4PP, LL55 4PS, LL55 4PT, LL55 4PU, LL55 4PW, LL55 4QA, LL55 4RD",314,54,260
W00000442,LL55,"LL55 4AN, LL55 4AP, LL55 4AR, LL55 4AS, LL55 4AT, LL55 4AW, LL55 4BG, LL55 4BH, LL55 4BT",286,40,246
W00000441,LL55,"LL55 4AH, LL55 4PN, LL55 4PR, LL55 4SE",297,36,261
W00000440,LL55,"LL55 4AB, LL55 4AF, LL55 4AG, LL55 4AL, LL55 4BL, LL55 4BN, LL55 4BW, LL55 4JA",277,26,251
W00000439,LL55,"LL55 3BE, LL55 4AU, LL55 4AY, LL55 4BA, LL55 4BB, LL55 4BD, LL55 4BE",274,43,231
W00000569,LL55,"LL55 2BZ, LL55 2LZ, LL55 2RX, LL55 2SB, LL55 2SD, LL55 2SF, LL55 2SX, LL55 2SZ",385,47,338
W00000297,LL55,"LL55 1DL, LL55 1DN, LL55 1DP, LL55 1DR",268,33,235
W00000296,LL55,"LL55 1EA, LL55 1EB, LL55 1SB, LL55 1UH, LL55 1ZD, LL55 1ZF, LL55 2BJ, LL55 2BL, LL55 2BS, LL55 2BT, LL55 2BW, LL55 2EJ",247,28,219
W00000295,LL55,"LL55 1DT, LL55 1DW, LL55 1ED, LL55 1EF",206,45,161
W00000316,LL55,"LL55 4DD, LL55 4DE, LL55 4DF, LL55 4DG, LL55 4DH, LL55 4DL, LL55 4DN, LL55 4DP, LL55 4DR, LL55 4DS, LL55 4DT, LL55 4DW, LL55 4DY, LL55 4ED, LL55 4FB",289,110,179
W00000266,LL55,"LL55 1BX, LL55 1GA, LL55 1UY, LL55 1WA, LL55 1YA, LL55 1YB, LL55 1YE, LL55 1YG, LL55 1YH, LL55 1YR",270,34,236
W00000268,LL55,"LL55 1AJ, LL55 1AQ, LL55 1AX, LL55 1UU",232,27,205
W00000269,LL55,"LL55 1AZ, LL55 1BQ, LL55 1UA, LL55 1UB, LL55 1UL, LL55 3AB, LL55 3AD, LL55 3AE, LL55 3AF, LL55 3AG, LL55 3AH, LL55 3AL, LL55 3AS, LL55 3AW, LL55 3PS, LL56 4QU",222,75,147
W00000270,LL55,"LL55 1RE, LL55 1UN, LL55 1UP, LL55 1UR, LL55 1UT, LL55 1UW",291,45,246
W00000294,LL55,"LL55 1DJ, LL55 1DS, LL55 1HH, LL55 1HL",256,37,219
W00000272,LL55,"LL55 2TY, LL55 2UA, LL55 2UE, LL55 2UH",218,34,184
W00000418,LL55,"LL55 4EG, LL55 4FE, LL55 4GA, LL55 4HD, LL55 4HE, LL55 4HZ, LL55 4LE, LL55 4LF, LL55 4LH, LL55 4SH, LL55 4SL, LL55 4SN, LL55 4SW",365,115,250
W00000417,LL55,"LL55 4HF, LL55 4HG, LL55 4HH, LL55 4HL, LL55 4HT, LL55 4HU, LL55 4HW, LL55 4HY, LL55 4LA, LL55 4LB, LL55 4LD, LL55 4LG, LL55 4LL, LL55 4LN, LL55 4LW",241,93,148
W00000509,LL55,"LL55 3AP, LL55 3AR, LL55 3AX, LL55 3AY, LL55 3BA, LL55 3BB, LL55 3BD, LL55 3BN, LL55 3BS, LL55 3NH, LL55 3PG, LL55 3PP, LL55 3PR, LL55 3PW, LL57 4EE",368,127,241
W00000293,LL55,"LL55 1BU, LL55 1DE, LL55 1DF, LL55 1DG, LL55 1EE, LL55 1PS, LL55 1PU, LL55 1RS",274,72,202
W00000416,LL55,"LL55 4BF, LL55 4EP, LL55 4ER, LL55 4ES, LL55 4EU, LL55 4EW, LL55 4EY, LL55 4HA, LL55 4HB, LL55 4JB, LL55 4SU, LL55 4SY, LL55 4SZ, LL55 4TA",275,97,178
W00000415,LL55,"LL55 4BY, LL55 4EE, LL55 4EF, LL55 4EH, LL55 4EL, LL55 4EN, LL55 4ET, LL55 4FA, LL55 4HN, LL55 4HP, LL55 4HR, LL55 4HS, LL55 4PX",289,89,200
W00000414,LL55,"LL55 4TD, LL55 4TN, LL55 4UP",287,51,236
W00000413,LL55,"LL55 4NU, LL55 4NY, LL55 4SG, LL55 4SS, LL55 4TG, LL55 4TH, LL55 4UA, LL55 4UB, LL55 4UD, LL55 4UE, LL55 4UF, LL55 4UG, LL55 4UH, LL55 4UL, LL55 4UN, LL55 4UW",169,67,102
W00000412,LL55,"LL55 4SP, LL55 4SR, LL55 4ST, LL55 4TB, LL55 4TE, LL55 4TF, LL55 4TL, LL55 4TP, LL55 4TR, LL55 4TS, LL55 4TT, LL55 4TU, LL55 4TW, LL55 4UR, LL55 4WF",338,87,251
W00000267,LL55,"LL55 1BJ, LL55 1YD, LL55 1YF, LL55 1YL, LL55 1YN, LL55 1YP, LL55 1YS, LL55 1YT, LL55 1YU, LL55 1YW, LL55 1YY, LL55 3AA",268,44,224
W00000322,LL55,"LL55 3DF, LL55 3DH, LL55 3EA, LL55 3EB, LL55 3EJ, LL55 3EQ, LL55 3EZ, LL55 3HG, LL55 3HL, LL55 3HN, LL55 3HP, LL55 3LJ, LL55 3LL, LL55 3LR, LL55 3LS, LL55 3NU, LL55 3UA",354,70,284
W00000299,LL55,"LL55 1BS, LL55 1BT, LL55 1NA, LL55 1NB, LL55 2AR, LL55 2DE",209,40,169
W00000324,LL55,"LL55 3HR, LL55 3HS, LL55 3HT, LL55 3HU, LL55 3HW, LL55 3HX, LL55 3HY, LL55 3LA, LL55 3LB, LL55 3LD, LL55 3LE, LL55 3LF, LL55 3LH, LL55 3LT",325,84,241
W00000503,LL55,"LL55 2ER, LL55 2ES, LL55 2ET, LL55 2EU, LL55 2EX, LL55 2LF, LL55 2LG, LL55 2LN, LL55 2RN, LL55 2RR",288,41,247
W00000323,LL55,"LL55 3DY, LL55 3LG, LL55 3LN, LL55 3LP, LL55 3LW",369,50,319
W00000502,LL55,"LL55 2AT, LL55 2DP, LL55 2EG, LL55 2EH, LL55 2EL, LL55 2EN, LL55 2SQ",544,73,471
W00000500,LL55,"LL55 2AE, LL55 2AL, LL55 2AP, LL55 2DB, LL55 2DD, LL55 2RE, LL55 2RG, LL55 2RH, LL55 2RL, LL55 2RY",296,53,243
W00000499,LL55,"LL55 2DR, LL55 2DS, LL55 2DT, LL55 2DW, LL55 2DY, LL55 2EF, LL55 2SJ",352,38,314
W00000498,LL55,"LL55 2DG, LL55 2DL, LL55 2EP, LL55 2EW, LL55 2RS, LL55 2RT",297,45,252
W00000504,LL55,"LL55 2DF, LL55 2DH, LL55 2DN, LL55 2DZ, LL55 2RJ, LL55 2RP, LL55 2RQ, LL55 2RU, LL55 2RW, LL55 2SA",297,65,232
W00000506,LL55,"LL55 3DB, LL55 3DD, LL55 3NL, LL55 3NP, LL55 3NR, LL55 3NS, LL55 3NT, LL55 3NY, LL55 3PB, LL55 3PD, LL55 3PE, LL55 3PF, LL55 3PJ, LL55 3PT",304,104,200
W00000327,LL55,"LL55 3DT, LL55 3DU, LL55 3ED, LL55 3EG, LL55 3EH, LL55 3HA, LL55 3HB, LL55 3HD, LL55 3HH, LL55 3PA",233,89,144
W00000326,LL55,"LL55 3BY, LL55 3DA, LL55 3DE, LL55 3DG, LL55 3DL, LL55 3DN, LL55 3DP, LL55 3DR, LL55 3DS, LL55 3DW, LL55 3LU, LL55 3NE, LL55 3NF, LL55 3NG, LL55 3ZA, LL55 3ZF, LL55 3ZG, LL55 3ZH",298,85,213
W00000325,LL55,"LL55 3EE, LL55 3EF, LL55 3EL, LL55 3EN, LL55 3EP, LL55 3ER, LL55 3ES, LL55 3ET, LL55 3EU, LL55 3EW, LL55 3EY, LL55 3LY, LL55 3NA, LL55 3NB, LL55 3ND, LL55 4TY",270,118,152
W00000507,LL55,"LL55 3BL, LL55 3BP, LL55 3BT, LL55 3BU, LL55 3BW, LL55 3HE, LL55 3PH, LL55 3PL, LL55 3PN",225,65,160
W00000479,LL55,"LL55 1PH, LL55 1PN, LL55 1PW",193,43,150
W00000473,LL55,"LL55 1AE, LL55 1AH, LL55 1AL, LL55 1AN, LL55 1AP, LL55 1AT, LL55 1AU, LL55 1AW, LL55 1RG, LL55 1RH, LL55 1RT, LL55 1RU, LL55 1RW, LL55 1SA, LL55 1SP, LL55 1SR, LL55 1SS, LL55 1ST, LL55 1SU, LL55 1SW, LL55 1SY, LL55 1SZ, LL55 1TA, LL55 1TB, LL55 1TG",253,90,163
W00000480,LL55,"LL55 1EN, LL55 1LE, LL55 1LF, LL55 1LN, LL55 1LP, LL55 1LW",280,48,232
W00000475,LL55,"LL55 1BE, LL55 1BF, LL55 1BG, LL55 1BH, LL55 1BL, LL55 1ER, LL55 1ES, LL55 1HJ, LL55 1HR, LL55 1HS, LL55 1HT, LL55 1HU, LL55 1LA",336,65,271
W00000476,LL55,"LL55 1AA, LL55 1AR, LL55 1AS, LL55 1AY, LL55 1BA, LL55 1BB, LL55 1BD, LL55 1BN, LL55 1BW, LL55 1BZ, LL55 1EG, LL55 1EH, LL55 1EL, LL55 1EP, LL55 1EW, LL55 1LH, LL55 1NR, LL55 1NY, LL55 1PA, LL55 1PB, LL55 1PR, LL55 1RY, LL55 1SQ, LL55 1TD, LL55 1TE, LL55 1TF, LL55 1TH, LL55 2HN",354,85,269
W00000474,LL55,"LL55 1DU, LL55 1DY, LL55 1LL, LL55 1LR, LL55 1LS, LL55 1TP, LL55 1TW",284,66,218
W00000477,LL55,"LL55 1ET, LL55 1EU, LL55 1EY, LL55 1HA, LL55 1HB, LL55 1HN, LL55 1HP, LL55 1HW, LL55 1HY, LL55 1LB",268,39,229
W00000478,LL55,"LL55 1BP, LL55 1PD, LL55 1PE, LL55 1PF, LL55 1PG, LL55 1PL",218,36,182
W00000622,LL56,"LL56 4PF, LL56 4TJ, LL56 4TX, LL56 4TZ, LL56 4UQ",446,87,359
W00000627,LL56,"LL56 4JG, LL56 4JN, LL56 4JP, LL56 4JS, LL56 4JT, LL56 4JW, LL56 4QJ, LL56 4QS, LL56 4QX, LL56 4QY, LL56 4QZ, LL56 4XA",338,192,146
W00000623,LL56,"LL56 4NQ, LL56 4RQ, LL56 4RZ, LL56 4SJ, LL56 4SQ, LL56 4SX",247,70,177
W00000522,LL56,"LL56 4JU, LL56 4JX, LL56 4QA, LL56 4QB, LL56 4QD, LL56 4QE, LL56 4QT, LL57 2NP, LL57 2NX, LL57 2RX, LL57 2SQ, LL57 4BF, LL57 4BH, LL57 4BL, LL57 4BN, LL57 4BP, LL57 4BS, LL57 4BT, LL57 4BU, LL57 4BW, LL57 4DE, LL57 4DF, LL57 4DY, LL57 4EA, LL57 4EG, LL57 4EZ, LL57 4FA, LL57 4FB, LL57 4FD, LL57 4FE, LL57 4FG, LL57 4FH, LL57 4FN, LL57 4FP, LL57 4HJ, LL57 4UY, LL57 4YA, LL57 4YB",282,131,151
W00000624,LL56,"LL56 4HJ, LL56 4HQ, LL56 4HX, LL56 4UJ, LL56 4UX, LL56 4UZ, LL56 4YJ, LL56 4YQ, LL56 4YX, LL56 4ZY",265,74,191
W00000626,LL56,"LL56 4AB, LL56 4JB, LL56 4JD, LL56 4JH, LL56 4JJ, LL56 4JL, LL56 4JQ, LL56 4JR, LL56 4JY, LL56 4JZ, LL56 4QG, LL56 4QH, LL56 4QL, LL56 4QN, LL56 4QP, LL56 4QQ, LL56 4QW",327,82,245
W00000628,LL56,"LL56 4HZ, LL56 4JA, LL56 4JE, LL56 4JF, LL56 4PA, LL56 4PB, LL56 4PD, LL56 4PE, LL56 4PJ, LL56 4PX, LL56 4PZ, LL56 4QR, LL56 4XD, LL57 1HA, LL57 1HP",302,132,170
W00000372,LL57,"LL57 2TP, LL57 2TS, LL57 2UD, LL57 2UE, LL57 2UF, LL57 2UH",292,164,128
W00000373,LL57,"LL57 2TT, LL57 2TU, LL57 2UA, LL57 2UB, LL57 2WJ, LL57 2WL, LL57 2ZD",261,153,108
W00000374,LL57,"LL57 2EZ, LL57 2HS, LL57 2HT, LL57 2HU, LL57 2HY, LL57 2TR",264,110,154
W00000375,LL57,"LL57 2GY, LL57 2GZ, LL57 2LA, LL57 2LF, LL57 2PA",277,135,142
W00000367,LL57,"LL57 3SN, LL57 3SU, LL57 3SY, LL57 3TA, LL57 3TB, LL57 3TD, LL57 3TE, LL57 3TF, LL57 3TG, LL57 3TJ, LL57 3UE, LL57 3UL",338,92,246
W00000362,LL57,"LL57 2BS, LL57 2BU, LL57 2DA, LL57 2RR, LL57 2SF, LL57 2SH, LL57 2SL, LL57 2SN, LL57 2SP, LL57 2SR, LL57 2SS, LL57 2ST, LL57 2SU, LL57 2SW, LL57 2SY, LL57 2TB, LL57 2TG",360,213,147
W00000370,LL57,"LL57 2AZ, LL57 2LB, LL57 2LG, LL57 2LH, LL57 2LL, LL57 2TY",255,100,155
W00000319,LL57,"LL57 1EX, LL57 1HF, LL57 1HG, LL57 1HH, LL57 1HN, LL57 1HR, LL57 1HS, LL57 1HT, LL57 1HY, LL57 1PA, LL57 1RH, LL57 1RR, LL57 1SA",255,197,58
W00000318,LL57,"LL57 1AA, LL57 1DN, LL57 1DR, LL57 1DS, LL57 1DT, LL57 1DX, LL57 1DY, LL57 1EB, LL57 1ED, LL57 1EE, LL57 1EF, LL57 1EL, LL57 1EN, LL57 1ER, LL57 1ES, LL57 1ET, LL57 1EU, LL57 1EY, LL57 1EZ, LL57 1HB, LL57 1HD, LL57 1HE, LL57 1HJ, LL57 1HL, LL57 1HW, LL57 1LA, LL57 1LH, LL57 1LL, LL57 1LN, LL57 1LP, LL57 1NT, LL57 1NU, LL57 1NW, LL57 1NX, LL57 1NY, LL57 1NZ, LL57 1PB, LL57 1PE, LL57 1PR, LL57 1PT, LL57 1PU, LL57 1RB, LL57 1RE, LL57 1RF, LL57 1RL, LL57 1RN, LL57 1RP, LL57 1RS, LL57 1RT, LL57 1RU, LL57 1RW, LL57 1RY, LL57 1UA, LL57 1UB, LL57 1UR, LL57 1UU, LL57 1UW, LL57 1WY, LL57 1XA, LL57 2RE, LL57 2RF, LL57 2RG, LL57 2RN, LL57 2RW",367,266,101
W00000317,LL57,"LL57 1AG, LL57 1BF, LL57 1BQ, LL57 1EP, LL57 1EW, LL57 1HX, LL57 1PD, LL57 1PL, LL57 1PQ, LL57 1PW, LL57 1UD, LL57 1UE, LL57 1UH, LL57 1UL, LL57 1UP, LL57 1US, LL57 1UT, LL57 1UY, LL57 1YA, LL57 1YB, LL57 1YD, LL57 1YE, LL57 1YF, LL57 1YG, LL57 1YH, LL57 1YL, LL57 1ZD, LL57 1ZP, LL57 1ZQ, LL57 1ZR",275,204,71
W00000389,LL57,"LL57 2AJ, LL57 2AQ, LL57 2UJ, LL57 2UQ, LL57 2YE, LL57 2YG, LL57 2YJ, LL57 4LS, LL57 4LT",239,140,99
W00000328,LL57,"LL57 4SJ, LL57 4SR, LL57 4ST, LL57 4SU, LL57 4TB, LL57 4TE, LL57 4TG, LL57 4TU, LL57 4TY",327,178,149
W00000329,LL57,"LL57 4DG, LL57 4SG, LL57 4SH, LL57 4SL, LL57 4SN, LL57 4SW, LL57 4SX, LL57 4SY, LL57 4TA, LL57 4TJ, LL57 4TP",293,164,129
W00000371,LL57,"LL57 2BJ, LL57 2HX, LL57 2HZ, LL57 2LD, LL57 2LE, LL57 2LN, LL57 2LX, LL57 2RJ",279,102,177
W00000330,LL57,"LL57 2AW, LL57 2BX, LL57 2DJ, LL57 2DQ, LL57 2LJ, LL57 2LQ, LL57 2LZ, LL57 4TN, LL57 4TW",584,228,356
W00000332,LL57,"LL57 2BQ, LL57 4TF, LL57 4TH, LL57 4TL, LL57 4TR, LL57 4XF, LL57 4XG",279,118,161
W00000363,LL57,"LL57 3EE, LL57 3EF, LL57 3EL, LL57 3EN, LL57 3EP, LL57 3EU, LL57 3EW, LL57 3EX, LL57 3LW",288,81,207
W00000364,LL57,"LL57 3DY, LL57 3ER, LL57 3ES, LL57 3ET, LL57 3EY, LL57 3HA, LL57 3HB, LL57 3HD, LL57 3HE, LL57 3HF, LL57 3HG, LL57 3HH, LL57 3HJ, LL57 3HL, LL57 3HN, LL57 3HP, LL57 3HR, LL57 3HS, LL57 3HT, LL57 3HU, LL57 3HW, LL57 3HY, LL57 3SD",278,99,179
W00000365,LL57,"LL57 3DP, LL57 3DU, LL57 3EA, LL57 3EB, LL57 3ED, LL57 3EG, LL57 3EH, LL57 3EJ, LL57 3UN",306,53,253
W00000369,LL57,"LL57 3BX, LL57 3BZ, LL57 3LQ, LL57 3PS, LL57 3PT, LL57 3PU, LL57 3PY, LL57 3PZ, LL57 3RA, LL57 3RB, LL57 3RD, LL57 3RE, LL57 3RF, LL57 3RG, LL57 3TY, LL57 3UB, LL57 3UD",290,92,198
W00000366,LL57,"LL57 3DT, LL57 3RS, LL57 3RT, LL57 3RU, LL57 3RX, LL57 3RY, LL57 3SA, LL57 3SB, LL57 3SE, LL57 3SF, LL57 3SH, LL57 3SJ, LL57 3SL",364,79,285
W00000331,LL57,"LL57 2AX, LL57 4SP, LL57 4TD, LL57 4TQ, LL57 4TS, LL57 4TT",460,248,212
W00000390,LL57,"LL57 2WB, LL57 2WD, LL57 2WE, LL57 2XZ, LL57 2YA, LL57 2YF, LL57 2YH, LL57 2YQ, LL57 4LR, LL57 4LU",328,180,148
W00010660,LL57,"LL57 1LE, LL57 1LF, LL57 1LG, LL57 1PF, LL57 1PG, LL57 1PN, LL57 1PS, LL57 1PY, LL57 1RG, LL57 1TU, LL57 1TY, LL57 1UF, LL57 1UG, LL57 1YN, LL57 2UN, LL57 2UX",93,47,46
W00000392,LL57,"LL57 2UG, LL57 2YL, LL57 2YN, LL57 2YP, LL57 2YS, LL57 2YT, LL57 2YU, LL57 2YW",276,168,108
W00000469,LL57,"LL57 2DP, LL57 2DR, LL57 2DS, LL57 2DU, LL57 2DY, LL57 2EA, LL57 2EB, LL57 2ED, LL57 2EE, LL57 2EF, LL57 2EH, LL57 2EL, LL57 2FA, LL57 2HN, LL57 2HW, LL57 2JW, LL57 2PY, LL57 2TW, LL57 2UW",367,271,96
W00000470,LL57,"LL57 2ER, LL57 2EY, LL57 2HA, LL57 2HB, LL57 2HD, LL57 2HF",302,209,93
W00000472,LL57,"LL57 2AA, LL57 2EG, LL57 2ET, LL57 2EU, LL57 2GA, LL57 2HE, LL57 2JB, LL57 2PT, LL57 2RA, LL57 2RB, LL57 2RD",305,242,63
W00000490,LL57,"LL57 3DR, LL57 3DW, LL57 3LT, LL57 3LU, LL57 3LY, LL57 3ND, LL57 3NP, LL57 3NQ, LL57 3NR, LL57 3NW, LL57 4AQ",317,51,266
W00000491,LL57,"LL57 3AD, LL57 3AF, LL57 3AG, LL57 3AN, LL57 3AP, LL57 3AR, LL57 3AS, LL57 3AT, LL57 3AU, LL57 3AW, LL57 3AY, LL57 3BA, LL57 3BU, LL57 3DA, LL57 3DD",267,115,152
W00000492,LL57,"LL57 3DE, LL57 3DS, LL57 3NF, LL57 3NG, LL57 3NH, LL57 3NN",311,51,260
W00000493,LL57,"LL57 3AA, LL57 3AB, LL57 3AE, LL57 3AH, LL57 3AL, LL57 3NA, LL57 3NB, LL57 3NE, LL57 3NJ, LL57 3NL, LL57 3NX, LL57 3WY",210,69,141
W00000494,LL57,"LL57 3BB, LL57 3BD, LL57 3BH, LL57 3BN, LL57 3BS, LL57 3BT, LL57 3BW, LL57 3BY, LL57 3DB, LL57 3LP, LL57 3RZ, LL57 3SQ, LL57 3ZD, LL57 3ZG, LL57 3ZH, LL57 3ZL, LL57 3ZN",297,88,209
W00000495,LL57,"LL57 3BE, LL57 3BF, LL57 3BG, LL57 3BJ, LL57 3BL, LL57 3BP, LL57 3NS, LL57 3NT, LL57 3NU, LL57 3PB, LL57 3PD, LL57 3PJ, LL57 3SG",249,45,204
W00000496,LL57,"LL57 3GA, LL57 3GB, LL57 3PF, LL57 3PG, LL57 3PH, LL57 3PP, LL57 3PR, LL57 3PW",343,45,298
W00000497,LL57,"LL57 3NY, LL57 3PA, LL57 3PE, LL57 3PL, LL57 3PN, LL57 3RW, LL57 3SW",329,51,278
W00000524,LL57,"LL57 2DN, LL57 2DW, LL57 2EJ, LL57 2EX, LL57 2HR, LL57 2JF, LL57 2JZ, LL57 2LP, LL57 2LR, LL57 2LW, LL57 2LY, LL57 2NA, LL57 2ND, LL57 2NE, LL57 2RQ",430,187,243
W00000523,LL57,"LL57 4UF, LL57 4UN, LL57 4UP, LL57 4UR, LL57 4UU, LL57 4UW, LL57 4ZE",256,101,155
W00000521,LL57,"LL57 4DP, LL57 4DR, LL57 4DS, LL57 4DT, LL57 4DU, LL57 4TX, LL57 4UB, LL57 4UD, LL57 4UE, LL57 4UG, LL57 4UH, LL57 4UL",245,107,138
W00000520,LL57,"LL57 2DL, LL57 2LS, LL57 2LT, LL57 2LU, LL57 2NF, LL57 2NJ, LL57 2NL, LL57 2NN, LL57 2NQ, LL57 2NZ, LL57 2PD, LL57 2RZ, LL57 2SJ",358,148,210
W00000519,LL57,"LL57 2BF, LL57 2DH, LL57 2DT, LL57 2DX, LL57 2DZ, LL57 2JE, LL57 2NB, LL57 2NG, LL57 2NH, LL57 2NR, LL57 2NY, LL57 2PF, LL57 2PG, LL57 2PH, LL57 2PL, LL57 2PN, LL57 2PS, LL57 2PW, LL57 2QL, LL57 2QN",532,228,304
W00000505,LL57,"LL57 4EL, LL57 4EP, LL57 4ER, LL57 4ES, LL57 4ET, LL57 4EU, LL57 4EY, LL57 4GA, LL57 4HA, LL57 4HD, LL57 4HG",297,110,187
W00000468,LL57,"LL57 2AB, LL57 2AD, LL57 2AE, LL57 2AF, LL57 2AG, LL57 2AH, LL57 2AL, LL57 2AN, LL57 2AP, LL57 2AR, LL57 2AS, LL57 2AT, LL57 2AU, LL57 2AY, LL57 2BA, LL57 2BB, LL57 2BD, LL57 2JJ, LL57 2JU, LL57 2PR, LL57 2PU",471,406,65
W00000467,LL57,"LL57 1LY, LL57 1NA, LL57 1NB, LL57 1ND, LL57 1NF",316,163,153
W00000466,LL57,"LL57 1LQ, LL57 1LT, LL57 1LU, LL57 1LW, LL57 1NE",326,167,159
W00000465,LL57,"LL57 1EG, LL57 1LR, LL57 1LS, LL57 1SS, LL57 1SY, LL57 1TA, LL57 1TG, LL57 1TH, LL57 1TL",293,130,163
W00000394,LL57,"LL57 1AJ, LL57 1AQ, LL57 1AX, LL57 1AZ, LL57 1BG, LL57 1BZ, LL57 1DB, LL57 1DJ, LL57 1DL, LL57 1EA, LL57 1PJ, LL57 1YQ, LL57 1YR, LL57 1YS, LL57 1YT, LL57 1YX, LL57 1YY, LL57 1ZE, LL57 1ZG, LL57 1ZN",336,225,111
W00000395,LL57,"LL57 1AL, LL57 1AN, LL57 1AP, LL57 1AR, LL57 1AW, LL57 1AY, LL57 1BA, LL57 1YJ, LL57 1YP, LL57 1YW",373,231,142
W00000396,LL57,"LL57 1AF, LL57 1AH, LL57 1BB, LL57 1BD, LL57 1BE, LL57 1BH, LL57 1BJ, LL57 1BN, LL57 1BX, LL57 1DP, LL57 1DU",340,224,116
W00000397,LL57,"LL57 1AB, LL57 1AS, LL57 1AT, LL57 1AU, LL57 1BT, LL57 1BU, LL57 1BW, LL57 2SD",266,184,82
W00000398,LL57,"LL57 1BL, LL57 1BP, LL57 1BS, LL57 1BY, LL57 1DA, LL57 1DD, LL57 1DE, LL57 1DF, LL57 1DG, LL57 1DH",204,110,94
W00010693,LL57,"LL57 1DZ, LL57 1EJ, LL57 1EQ, LL57 1HU, LL57 1NS, LL57 1PP, LL57 2BZ",739,657,82
W00010678,LL57,"LL57 2QA, LL57 2QB, LL57 2QE, LL57 2QF, LL57 2QJ",287,77,210
W00010675,LL57,"LL57 2NS, LL57 2NT, LL57 2NU, LL57 2PB, LL57 2SX, LL57 4DB, LL57 4DD",281,96,185
W00000391,LL57,"LL57 2QD, LL57 2QQ, LL57 2QW, LL57 2TN, LL57 2YD, LL57 4DH, LL57 4DL, LL57 4DN, LL57 4DW, LL57 4RU, LL57 4SB, LL57 4SD, LL57 4SE, LL57 4SF",208,124,84
W00010669,LL57,"LL57 2NW, LL57 2QG, LL57 2QH, LL57 2QP, LL57 2QR, LL57 4BY, LL57 4DA",302,102,200
W00000257,LL57,"LL57 3UY, LL57 3UZ, LL57 3WA, LL57 3WB, LL57 3YA, LL57 3YB, LL57 3YJ",168,52,116
W00000256,LL57,"LL57 3UR, LL57 3UT, LL57 3UU, LL57 3YS, LL57 3YT, LL57 3YU",246,96,150
W00000255,LL57,"LL57 4AA, LL57 4AB, LL57 4AD, LL57 4BG, LL57 4FL, LL57 4HN, LL57 4HP, LL57 4HR, LL57 4HS, LL57 4HT, LL57 4HU, LL57 4HW, LL57 4HY, LL57 4LA, LL57 4LB, LL57 4LD, LL57 4LE, LL57 4LF, LL57 4LG, LL57 4LH, LL57 4SS, LL57 4YH",315,167,148
W00000460,LL57,"LL57 1PH, LL57 1PX, LL57 1PZ, LL57 1SB, LL57 1SG, LL57 1SH, LL57 1SU",299,181,118
W00000461,LL57,"LL57 1SD, LL57 1SL, LL57 1SN, LL57 1SP, LL57 1SR, LL57 1SW, LL57 1TS, LL57 1TT",181,92,89
W00000462,LL57,"LL57 1EH, LL57 1ST, LL57 1TB, LL57 1TD, LL57 1TE, LL57 1TJ, LL57 1TN",342,144,198
W00000463,LL57,"LL57 1HQ, LL57 1SE, LL57 1SF, LL57 1SJ",277,139,138
W00000464,LL57,"LL57 1NG, LL57 1NH, LL57 1TF",331,164,167
W00010651,LL57,"LL57 1DQ, LL57 1LB, LL57 1LD, LL57 1LJ, LL57 1LX, LL57 1LZ, LL57 1NL, LL57 1NP, LL57 1NR, LL57 2UP, LL57 2UR",234,207,27
W00000368,LL57,"LL57 3RH, LL57 3RJ, LL57 3RL, LL57 3RN, LL57 3SP, LL57 3SR, LL57 3SS, LL57 3ST, LL57 3TH, LL57 3TL, LL57 3TN, LL57 3TP, LL57 3TR, LL57 3TS, LL57 3TT, LL57 3TU, LL57 3TW, LL57 3UA",313,90,223
W00000595,LL57,"LL57 4AL, LL57 4AN, LL57 4AT, LL57 4AU, LL57 4AY, LL57 4PR, LL57 4PY, LL57 4RA, LL57 4RB, LL57 4RE, LL57 4RF, LL57 4RH, LL57 4RP",339,113,226
W00000594,LL57,"LL57 4AE, LL57 4AF, LL57 4AG, LL57 4NA, LL57 4NB, LL57 4ND, LL57 4NE, LL57 4NF, LL57 4NG, LL57 4NL, LL57 4NW, LL57 4PB, LL57 4PD, LL57 4RR",278,71,207
W00010048,LL57,"LL57 2BT, LL57 2BY, LL57 2DB, LL57 2DD, LL57 2DE, LL57 2DF, LL57 2DG, LL57 2PP, LL57 2RL, LL57 2RP, LL57 2SB, LL57 2TF, LL57 2TH, LL57 2TL, LL57 2TQ",169,122,47
W00010046,LL57,"LL57 1AD, LL57 2RS, LL57 2RT, LL57 2RU, LL57 2RY, LL57 2SA, LL57 2SE, LL57 2SG, LL57 2SZ, LL57 2TA, LL57 2TD, LL57 2TE",372,287,85
W00010049,LL57,"LL57 2BE, LL57 2BG, LL57 2BH, LL57 2BL, LL57 2BN, LL57 2BP, LL57 2BW, LL57 2GB, LL57 2GE, LL57 2GF, LL57 2GL, LL57 2GP, LL57 2GS, LL57 2GT, LL57 2GU, LL57 2GW, LL57 2GX, LL57 2HG, LL57 2HJ, LL57 2HL, LL57 2HP, LL57 2HQ, LL57 2JA, LL57 2JD, LL57 2JN, LL57 2JP, LL57 2JR, LL57 2JS, LL57 2JT, LL57 2JX, LL57 2JY, LL57 2PE, LL57 2PJ, LL57 2PQ, LL57 2PX, LL57 2PZ",1472,1152,320
W00000593,LL57,"LL57 4AH, LL57 4AP, LL57 4AS, LL57 4AW, LL57 4YQ",275,76,199
W00010051,LL57,"LL57 2EN, LL57 2EP, LL57 2EQ, LL57 2ES, LL57 2EW, LL57 2HH, LL57 2JQ",120,75,45
W00000596,LL57,"LL57 4AR, LL57 4NH, LL57 4PE, LL57 4PF, LL57 4PG, LL57 4PH, LL57 4PL, LL57 4PN, LL57 4PP, LL57 4PS, LL57 4PT, LL57 4PU, LL57 4PW, LL57 4RD, LL57 4RG, LL57 4RJ, LL57 4RL",321,79,242
W00000597,LL57,"LL57 4AJ, LL57 4AX, LL57 4AZ, LL57 4BQ, LL57 4DQ, LL57 4NN, LL57 4NP, LL57 4NR, LL57 4NS, LL57 4NT, LL57 4YD, LL57 4YN, LL57 4YP, LL57 4YR, LL57 4YS, LL57 4YT, LL57 4YU, LL57 4YW, LL57 4YY",251,101,150
W00000599,LL57,"LL57 3BQ, LL57 3DQ, LL57 3LZ, LL57 4BJ, LL57 4BX, LL57 4BZ, LL57 4DJ, LL57 4DZ, LL57 4FF, LL57 4FJ, LL57 4LQ, LL57 4LZ, LL57 4NU, LL57 4NY, LL57 4PA, LL57 4RN, LL57 4YG, LL57 4YL",304,93,211
W00000598,LL57,"LL57 4BA, LL57 4BB, LL57 4BD, LL57 4BE, LL57 4DX, LL57 4EJ, LL57 4EQ, LL57 4LJ, LL57 4LX, LL57 4RW, LL57 4UT, LL57 4UX",297,133,164
W00000130,LL58,"LL58 8PA, LL58 8PB, LL58 8PD, LL58 8PE, LL58 8PF, LL58 8PG, LL58 8PH, LL58 8PN, LL58 8SA, LL58 8SE, LL58 8SY",166,104,62
W00000175,LL58,"LL58 8AQ, LL58 8LW, LL58 8PL, LL58 8PP, LL58 8PW, LL58 8TH, LL58 8TL, LL58 8TN, LL58 8TR, LL58 8TS, LL58 8UB, LL58 8UD, LL58 8UL, LL58 8UN, LL58 8UP, LL58 8UR, LL58 8UT, LL58 8UU, LL58 8UW, LL58 8UY, LL58 8WY, LL58 8XB, LL58 8YA, LL58 8YB, LL58 8YD, LL58 8YE, LL58 8YF, LL58 8YG",380,190,190
W00000174,LL58,"LL58 8TP, LL58 8TT, LL58 8TU, LL58 8TW, LL58 8TX, LL58 8TY, LL58 8UA, LL58 8UE, LL58 8UF, LL58 8UG, LL58 8UH",251,111,140
W00000014,LL58,"LL58 8HU, LL58 8HY, LL58 8LB, LL58 8LD, LL58 8LE, LL58 8LF, LL58 8LG, LL58 8LH, LL58 8LJ, LL58 8LL, LL58 8YP, LL58 8YS, LL58 8YT, LL58 8YU, LL58 8YY",251,152,99
W00000015,LL58,"LL58 8LN, LL58 8LP, LL58 8LQ, LL58 8LR, LL58 8PR, LL58 8PS, LL58 8PT, LL58 8RB, LL58 8RD, LL58 8RE, LL58 8RF, LL58 8RG, LL58 8RH, LL58 8RL, LL58 8ZF, LL58 8ZG, LL58 8ZH",227,166,61
W00000017,LL58,"LL58 8AB, LL58 8AD, LL58 8DN, LL58 8DP, LL58 8DR, LL58 8DU, LL58 8DW, LL58 8EB, LL58 8ED, LL58 8EE, LL58 8EG, LL58 8EJ, LL58 8EN, LL58 8ER, LL58 8EW",183,106,77
W00000129,LL58,"LL58 8AT, LL58 8NS, LL58 8NT, LL58 8NU, LL58 8RN, LL58 8RY, LL58 8SB, LL58 8YZ",301,184,117
W00000018,LL58,"LL58 8ES, LL58 8HD, LL58 8HE, LL58 8HF, LL58 8HP, LL58 8HW",211,128,83
W00000019,LL58,"LL58 8AA, LL58 8AF, LL58 8AG, LL58 8AL, LL58 8AN, LL58 8AP, LL58 8AS, LL58 8AU, LL58 8AW, LL58 8AY, LL58 8BP, LL58 8BQ, LL58 8BS, LL58 8BT, LL58 8BU, LL58 8BW, LL58 8BY, LL58 8DA, LL58 8DB, LL58 8DE, LL58 8DL, LL58 8RA",149,108,41
W00000021,LL58,"LL58 8AH, LL58 8AJ, LL58 8AR, LL58 8BA, LL58 8BB, LL58 8BD, LL58 8BE, LL58 8BG, LL58 8BH, LL58 8BL, LL58 8BN, LL58 8DD, LL58 8DS, LL58 8DT, LL58 8EF, LL58 8YH, LL58 8YL, LL58 8YN",170,104,66
W00000062,LL58,"LL58 8AZ, LL58 8YR, LL58 8YW, LL59 5PH, LL59 5RY, LL59 5SA, LL59 5SD, LL59 5SE, LL59 5SF, LL59 5SG, LL59 5SH, LL59 5SL, LL59 5SN, LL59 5SP, LL59 5SR, LL59 5ST, LL59 5SW, LL75 8YP",379,143,236
W00000131,LL58,"LL58 8RP, LL58 8RR, LL58 8RS, LL58 8RT, LL58 8RU, LL58 8RW, LL58 8SD, LL58 8SF, LL58 8SG, LL58 8SH, LL58 8SL, LL58 8SN, LL58 8SP, LL58 8SR, LL58 8SS, LL58 8ST, LL58 8SU, LL58 8SW, LL58 8TA, LL58 8TB",198,134,64
W00000127,LL58,"LL58 8LU, LL58 8NB, LL58 8ND, LL58 8NE, LL58 8NF, LL58 8NG, LL58 8NH, LL58 8NL, LL58 8NN, LL58 8NP, LL58 8NR, LL58 8NW, LL58 8NY",288,122,166
W00000020,LL58,"LL58 8AE, LL58 8AX, LL58 8DY, LL58 8EA, LL58 8EH, LL58 8EL, LL58 8EP, LL58 8ET, LL58 8EU, LL58 8EY, LL58 8HA, LL58 8HR, LL58 8LA",193,107,86
W00000016,LL58,"LL58 8HB, LL58 8HG, LL58 8HH, LL58 8HL, LL58 8HN, LL58 8YQ, LL58 8YX",200,130,70
W00000128,LL58,"LL58 8LS, LL58 8LT, LL58 8LX, LL58 8LY, LL58 8NA",274,117,157
W00000215,LL59,"LL59 5DA, LL59 5EJ, LL59 5QH, LL59 5QJ, LL59 5RP, LL59 5RS, LL59 5RW",250,105,145
W00000217,LL59,"LL59 5AF, LL59 5BB, LL59 5BF, LL59 5BG, LL59 5BL, LL59 5BP, LL59 5HY, LL59 5LB, LL59 5NF",292,129,163
W00000218,LL59,"LL59 5BH, LL59 5DS, LL59 5LD",245,101,144
W00000219,LL59,"LL59 5LE, LL59 5LF, LL59 5LH, LL59 5LL, LL59 5LN, LL59 5LP, LL59 5LS, LL59 5ND",264,92,172
W00000063,LL59,"LL59 5AQ, LL59 5PL, LL59 5PN, LL59 5PP, LL59 5PR, LL59 5PS, LL59 5PT, LL59 5PU, LL59 5PW, LL59 5PY, LL59 5RA, LL59 5RB, LL59 5RR, LL59 5RT, LL59 5SB, LL59 5UH",271,130,141
W00000061,LL59,"LL59 5NL, LL59 5NP, LL59 5QU, LL59 5TA, LL59 5TB, LL59 5TD, LL59 5TE, LL59 5TF, LL59 5TG, LL59 5TH, LL59 5TN, LL59 5TW, LL59 5UT, LL59 5YF, LL59 5ZQ",264,123,141
W00000214,LL59,"LL59 5HP, LL59 5NE, LL59 5QL, LL59 5QN, LL59 5QZ",340,138,202
W00000060,LL59,"LL59 5NN, LL59 5NR, LL59 5NS, LL59 5NT, LL59 5NY, LL59 5PA, LL59 5QP, LL59 5QX, LL59 5TL, LL59 5TP, LL59 5TR, LL59 5TS, LL59 5TT, LL59 5TU, LL59 5UA, LL59 5UG, LL59 5UL, LL59 5UN, LL59 5UU, LL59 5UY, LL59 5YG",247,125,122
W00000058,LL59,"LL59 5NU, LL59 5PB, LL59 5PD, LL59 5PE, LL59 5PF, LL59 5PG, LL59 5RL, LL59 5UB, LL59 5UD, LL59 5UE, LL59 5UF, LL59 5YA, LL59 5YD, LL59 5YE",261,144,117
W00000057,LL59,"LL59 5AZ, LL59 5RD, LL59 5UW, LL59 5YB, LL59 5YH",418,147,271
W00000051,LL59,"LL59 5AA, LL59 5AP, LL59 5DT, LL59 5DU, LL59 5EA, LL59 5HD, LL59 5HU, LL59 5LA, LL59 5LJ, LL59 5LY, LL59 5NA, LL59 5QY, LL59 5RE, LL59 5RG, LL59 5RH, LL59 5RN, LL59 5SS, LL59 5SU, LL59 5SY",317,147,170
W00000050,LL59,"LL59 5AG, LL59 5AH, LL59 5AL, LL59 5AN, LL59 5AR, LL59 5AT, LL59 5AW, LL59 5BA, LL59 5DD, LL59 5DF, LL59 5DL, LL59 5DN, LL59 5EB, LL59 5HS, LL59 5HT, LL59 5QW, LL59 5WQ, LL59 5WY",200,112,88
W00000049,LL59,"LL59 5AB, LL59 5AU, LL59 5AY, LL59 5BD, LL59 5BU, LL59 5DG, LL59 5DH, LL59 5DP, LL59 5ED, LL59 5EE, LL59 5EF, LL59 5EG, LL59 5EH, LL59 5EL, LL59 5EN, LL59 5EP, LL59 5ER, LL59 5ES, LL59 5EU, LL59 5EW, LL59 5NG, LL59 5NW",224,130,94
W00000048,LL59,"LL59 5AJ, LL59 5AS, LL59 5DB, LL59 5DE, LL59 5DR, LL59 5DW, LL59 5DY, LL59 5ET, LL59 5EY, LL59 5FZ, LL59 5HA, LL59 5HB, LL59 5HE, LL59 5HF, LL59 5HG, LL59 5HH, LL59 5HL, LL59 5HN, LL59 5HW",257,154,103
W00000059,LL59,"LL59 5TY, LL59 5UP, LL59 5UR, LL59 5WA",290,91,199
W00000213,LL59,"LL59 5AD, LL59 5AE, LL59 5AX, LL59 5BE, LL59 5BN, LL59 5BS, LL59 5BT, LL59 5BW, LL59 5BY, LL59 5DX, LL59 5NH, LL59 5ZR, LL59 5ZW",316,158,158
W00000216,LL59,"LL59 5LG, LL59 5LR, LL59 5LT, LL59 5LU, LL59 5LW, LL59 5NB",277,106,171
W00000126,LL59,"LL59 5RU, LL59 5RX, LL60 6AH, LL60 6AL, LL60 6AN, LL60 6AT, LL60 6AU, LL60 6AW, LL60 6AY, LL60 6BA, LL60 6BB, LL60 6HF, LL61 5AB, LL61 5AZ, LL61 5BJ, LL61 5BQ, LL61 5BX, LL61 5DJ, LL61 5DX, LL61 5DZ, LL61 6PG, LL61 6PH, LL61 6PL, LL61 6PN, LL75 8AB, LL75 8AQ, LL77 7SG, LL77 7SH",446,119,327
W00000132,LL60,"LL60 6EA, LL60 6ED, LL60 6EG, LL60 6ES, LL60 6EW, LL60 6HA, LL60 6HB, LL60 6HD, LL60 6HE, LL61 6DJ, LL61 6DQ, LL61 6DX, LL61 6DY, LL61 6DZ, LL61 6EJ, LL61 6EQ, LL61 6EX, LL61 6EZ, LL61 6PQ, LL61 6PT",305,143,162
W00000133,LL60,"LL60 6DS, LL60 6DT, LL60 6DU, LL60 6DY, LL60 6DZ, LL60 6EB, LL60 6EE, LL60 6EF, LL60 6EH, LL60 6EL, LL60 6EN, LL60 6EP, LL60 6EQ, LL60 6ER, LL60 6ET, LL60 6EU, LL60 6EY, LL60 6HW, LL60 6NL, LL60 6NN, LL60 6NQ",511,155,356
W00000125,LL60,"LL60 6BU, LL60 6BY, LL60 6DA, LL60 6DB, LL60 6DD, LL60 6DE, LL60 6DG, LL60 6DQ, LL60 6HH, LL60 6HP, LL60 6HS, LL60 6HT",293,65,228
W00000124,LL60,"LL60 6AE, LL60 6AJ, LL60 6AQ, LL60 6AX, LL60 6DP, LL60 6DR, LL60 6HU, LL60 6HY, LL60 6LA, LL60 6LB, LL60 6LD, LL60 6LE, LL60 6LF, LL60 6LG, LL60 6LH, LL60 6LL, LL60 6LN, LL60 6LW, LL60 6NW",429,129,300
W00000123,LL60,"LL60 6AA, LL60 6AD, LL60 6AF, LL60 6BN, LL60 6BS, LL60 6BT, LL60 6DH, LL60 6JW, LL60 6LS",342,67,275
W00000195,LL60,"LL60 6LP, LL60 6LR, LL60 6LT, LL60 6LU, LL60 6LY, LL60 6NA, LL60 6NB, LL60 6ND, LL60 6NE, LL60 6NF, LL60 6NH, LL60 6NJ, LL60 6NP, LL61 6NZ",340,114,226
W00000194,LL60,"LL60 6NG, LL61 6AX, LL61 6AZ, LL61 6BJ, LL61 6BQ, LL61 6BX, LL61 6BZ, LL61 6LQ, LL61 6PY, LL61 6RE, LL61 6RF, LL61 6RG, LL61 6RH, LL61 6RL, LL61 6RR, LL61 6RS, LL61 6SP, LL61 6SR, LL61 6SS, LL61 6TL, LL61 6TN, LL61 6TQ, LL61 6UU, LL61 6UY, LL61 6WF, LL61 6YA",337,167,170
W00000122,LL60,"LL60 6BH, LL60 6DF, LL60 6DJ, LL60 6DL, LL60 6DN, LL60 6HG, LL60 6HN, LL60 6HQ, LL60 6HR, LL60 6JN, LL60 6WB, LL60 6WD",316,70,246
W00000121,LL60,"LL60 6AB, LL60 6AG, LL60 6AP, LL60 6AR, LL60 6AS, LL60 6BE, LL60 6BL, LL60 6BP, LL60 6BW, LL60 6DW, LL60 6HL",276,71,205
W00000193,LL61,"LL61 6RT, LL61 6RU, LL61 6RY, LL61 6SA, LL61 6SB, LL61 6SD, LL61 6SE, LL61 6SH, LL61 6TG, LL61 6TS",245,81,164
W00000034,LL61,"LL61 5JA, LL61 5JB, LL61 5JD, LL61 5QB, LL61 5QD, LL61 5QH, LL61 5UJ, LL61 5UX, LL61 5UZ, LL61 5WA, LL61 5YQ",264,80,184
W00000070,LL61,"LL61 5HY, LL61 5JR, LL61 5NY, LL61 5NZ, LL61 5RA, LL61 5RZ",409,107,302
W00000135,LL61,"LL61 6LJ, LL61 6NJ, LL61 6NQ, LL61 6NX, LL61 6SQ, LL61 6TJ, LL61 6TX, LL61 6TZ, LL61 6UF, LL61 6UP, LL61 6UR, LL61 6UT, LL61 6UW, LL61 6WD",360,144,216
W00000136,LL61,"LL61 6RB, LL61 6RJ, LL61 6RQ, LL61 6TU, LL61 6TY, LL61 6UB, LL61 6UD, LL61 6UG, LL61 6UH, LL61 6UL, LL61 6UN",313,88,225
W00000192,LL61,"LL61 6AJ, LL61 6AQ, LL61 6AU, LL61 6BD, LL61 6JA, LL61 6QR, LL61 6RN, LL61 6RP, LL61 6RW, LL61 6YF, LL61 6YP, LL61 6YR, LL61 6YS, LL61 6YT, LL61 6YU, LL61 6YW, LL61 6YY",354,136,218
W00000071,LL61,"LL61 5BZ, LL61 5LQ, LL61 5YG, LL61 5YH, LL61 5YL, LL61 5YN, LL61 5YR, LL61 5YS, LL61 5YT, LL61 5YU, LL61 5YW, LL61 6AD",372,145,227
W00000072,LL61,"LL61 5AJ, LL61 5AQ, LL61 5JY, LL61 5PJ, LL61 5PQ, LL61 5YY",250,63,187
W00000073,LL61,"LL61 5HJ, LL61 5HQ, LL61 5HX, LL61 5HZ, LL61 5LA, LL61 5NJ, LL61 5NQ, LL61 5NX, LL61 5PX, LL61 5PZ, LL61 5RJ, LL61 5RQ, LL61 5RX, LL61 5SJ, LL61 5YP, LL61 6NT, LL61 6NY, LL61 6PD",209,80,129
W00000074,LL61,"LL61 5JF, LL61 5JG, LL61 5JQ, LL61 5SX, LL61 5TJ, LL61 5TQ, LL61 5TX, LL61 5TZ, LL61 5YZ",188,58,130
W00000033,LL61,"LL61 5AD, LL61 5DQ, LL61 5PG, LL61 5QA, LL61 5SZ, LL61 5UQ, LL61 5YA, LL61 5YJ, LL61 5YX, LL61 5ZF, LL61 6NU, LL61 6PA, LL61 6PB, LL61 6PE, LL61 6PF, LL61 6PS, LL61 6PU",258,77,181
W00000032,LL61,"LL61 5JE, LL61 5JH, LL61 5JJ, LL61 5JL, LL61 5JN, LL61 5JP, LL61 5JW, LL61 5QG, LL61 5ZA, LL61 5ZB, LL61 5ZD, LL61 5ZE, LL61 6UX",199,47,152
W00000196,LL61,"LL61 6SF, LL61 6SG, LL61 6ST, LL61 6SU, LL61 6SW, LL61 6TP, LL61 6TR, LL61 6US, LL61 6WA, LL61 6WG",307,140,167
W00000197,LL61,"LL61 6AB, LL61 6AE, LL61 6PZ, LL61 6RA, LL61 6SL, LL61 6SN, LL61 6SY, LL61 6TA, LL61 6TB, LL61 6TD, LL61 6TE, LL61 6TF, LL61 6TH, LL61 6TW, LL61 6UJ, LL61 6UZ",269,66,203
W00000198,LL61,"LL61 6LX, LL61 6LZ, LL61 6YB, LL61 6YD, LL61 6YE, LL61 6YG, LL61 6YH, LL61 6YJ, LL61 6YL, LL61 6YN, LL61 6YQ, LL61 6YZ",325,140,185
W00000035,LL61,"LL61 5AL, LL61 5AN, LL61 5AX, LL61 5BA, LL61 5EJ, LL61 5EQ, LL61 5EX, LL61 5EY, LL61 5EZ, LL61 5FA, LL61 5QE, LL61 5QF, LL61 5QQ",440,110,330
W00000134,LL61,"LL61 6HJ, LL61 6HQ, LL61 6HX, LL61 6HZ, LL61 6PJ, LL61 6PX, LL61 6RD, LL61 6RX, LL61 6RZ, LL61 6SJ, LL61 6SX, LL61 6SZ, LL61 6TT, LL61 6UA, LL61 6UE, LL61 6UQ",325,127,198
W00000036,LL61,"LL61 5JS, LL61 5JT, LL61 5JU, LL61 5JX, LL61 5JZ",256,71,185
W00000031,LL62,"LL62 5DN, LL62 5DP, LL62 5DQ, LL62 5DR, LL62 5DS, LL62 5DT, LL62 5DU, LL62 5DW, LL62 5DX, LL62 5DY, LL62 5EB, LL62 5PP, LL62 5PR, LL62 5PS, LL62 5PU, LL62 5PW, LL62 5PY, LL62 5RA, LL62 5RD, LL62 5RF, LL62 5RG, LL77 7YL",450,109,341
W00000026,LL62,"LL62 5DE, LL62 5ED, LL62 5EE, LL62 5EF, LL62 5EG, LL62 5EH, LL62 5NS, LL62 5PN, LL77 7EQ, LL77 7LY, LL77 7TY, LL77 7YT, LL77 7YU, LL77 7YY",275,75,200
W00000027,LL62,"LL62 5AE, LL62 5AF, LL62 5AG, LL62 5AH, LL62 5AL, LL62 5AR, LL62 5AS, LL62 5AU, LL62 5BB, LL62 5ER, LL62 5ES, LL62 5ET, LL62 5EU, LL62 5EY, LL62 5HA, LL62 5HB, LL62 5HE, LL62 5HF, LL62 5HG, LL62 5HH, LL62 5HL, LL62 5NG, LL62 5NP, LL62 5NW, LL62 5PH, LL62 5ZA, LL62 5ZB",350,162,188
W00000028,LL62,"LL62 5AA, LL62 5AB, LL62 5AP, LL62 5BL, LL62 5BN, LL62 5BP, LL62 5BS, LL62 5BW, LL62 5EP, LL62 5HP, LL62 5HR, LL62 5HS, LL62 5HT, LL62 5HU, LL62 5HY, LL62 5LA, LL62 5LB, LL62 5LD, LL62 5LE, LL62 5LF, LL62 5LL, LL62 5LN, LL62 5LP, LL62 5LR, LL62 5LS, LL62 5LT, LL62 5LU, LL62 5LW, LL62 5LY, LL62 5NE, LL62 5NF, LL62 5NH, LL62 5NL, LL62 5NN",288,138,150
W00000030,LL62,"LL62 5DF, LL62 5DG, LL62 5DH, LL62 5DL, LL62 5EA, LL62 5HD, LL62 5NR, LL62 5NT, LL62 5NU, LL62 5NY, LL62 5PA, LL62 5PB, LL62 5PD, LL62 5PE, LL62 5PF, LL62 5PG, LL62 5PT, LL62 5RB, LL62 5RE, LL77 7GE, LL77 7JR, LL77 7YA, LL77 7YB, LL77 7YD, LL77 7YE, LL77 7YF, LL77 7YG, LL77 7YH",378,105,273
W00000029,LL62,"LL62 5AD, LL62 5AN, LL62 5AT, LL62 5AW, LL62 5AY, LL62 5BA, LL62 5BD, LL62 5BG, LL62 5LG, LL62 5LH",274,110,164
W00000001,LL62,"LL62 5BE, LL62 5BT, LL62 5BU, LL62 5BY, LL62 5DA, LL62 5DB, LL62 5DD, LL63 5AD, LL63 5AJ, LL63 5AQ, LL63 5AX, LL63 5BX, LL63 5DJ, LL63 5DX, LL63 5EQ, LL63 5EX, LL63 5EY, LL63 5HJ, LL63 5HX, LL63 5HZ, LL63 5LX, LL63 5NJ, LL63 5NQ, LL63 5NX, LL63 5NZ, LL63 5PJ, LL63 5RJ, LL63 5RQ, LL63 5RX, LL63 5RZ, LL63 5SG, LL63 5SJ, LL63 5SQ, LL63 5SX, LL63 5SZ, LL63 5TE, LL63 5TF, LL63 5TG, LL63 5TQ, LL63 5UT, LL63 5UU, LL63 5UY, LL63 5YA, LL63 5YH, LL63 5YL, LL63 5YN, LL63 5YP, LL63 5YR, LL63 5YS, LL63 5YT, LL63 5YU, LL63 5YY",353,126,227
W00000056,LL62,"LL62 5WQ, LL63 5WZ, LL64 5YU, LL71 7ZB, LL71 8WT, LL71 8ZA, LL71 8ZD, LL72 8WW, LL72 8ZA, LL72 8ZB, LL72 8ZE, LL74 8XR, LL74 8ZA, LL74 8ZB, LL74 8ZE, LL74 8ZF, LL74 8ZG, LL75 8ZA, LL75 8ZB, LL75 8ZR, LL77 7AA, LL77 7AB, LL77 7AR, LL77 7AW, LL77 7EN, LL77 7EP, LL77 7ES, LL77 7ET, LL77 7EU, LL77 7EW, LL77 7EY, LL77 7FA, LL77 7FE, LL77 7HA, LL77 7HD, LL77 7HE, LL77 7HF, LL77 7JA, LL77 7JD, LL77 7JH, LL77 7LR, LL77 7LU, LL77 7NA, LL77 7RT, LL77 7TL, LL77 7TN, LL77 7TP, LL77 7TS, LL77 7TT, LL77 7TU, LL77 7TW, LL77 7TX, LL77 7TZ, LL77 7WY, LL77 7XR, LL77 7YJ, LL77 7YX, LL77 7YZ, LL77 7ZA, LL77 7ZB, LL77 7ZD, LL77 7ZE, LL77 7ZF, LL77 7ZH, LL77 7ZN, LL77 7ZP, LL77 7ZR, LL77 8LT, LL77 9AA, LL77 9AB, LL77 9AD, LL77 9AE, LL77 9AF, LL77 9AG, LL77 9AH, LL77 9AJ, LL77 9AL, LL77 9AN, LL77 9AP, LL77 9AQ, LL77 9AR, LL77 9AS, LL77 9AT, LL77 9AU, LL77 9AW, LL77 9AX, LL77 9AY, LL77 9AZ, LL77 9BA, LL77 9BB, LL77 9BD, LL77 9BE, LL77 9BF, LL77 9BG, LL77 9BH, LL77 9BJ, LL77 9BL, LL77 9BN, LL77 9BP, LL77 9BQ, LL77 9BR, LL77 9ZY, LL77 9ZZ",325,110,215
W00000037,LL63,"LL63 5UJ, LL63 5UL, LL63 5UN, LL63 5UP, LL63 5UR, LL63 5UW, LL65 3PN, LL65 3PR, LL65 3PS, LL65 3PT, LL65 3PU, LL65 3RE, LL65 3RG, LL65 3RL, LL65 3RN, LL65 3RP, LL65 3RR, LL65 3RS, LL65 3RT, LL65 3RW, LL65 3RY, LL65 3SA, LL65 3SB, LL65 3SD, LL65 3SE, LL65 3SF, LL65 3SG, LL65 3SH, LL65 3SL, LL65 3YN, LL65 3YW, LL65 4PN",444,129,315
W00000003,LL63,"LL63 5AA, LL63 5RN, LL63 5RP, LL63 5RR, LL63 5RS, LL63 5RT, LL63 5RU, LL63 5RW, LL63 5RY, LL63 5SB, LL63 5SD, LL63 5SE, LL63 5SF, LL63 5SH, LL63 5SL, LL63 5SN, LL63 5SP, LL63 5YB",357,145,212
W00000004,LL63,"LL63 5SA, LL63 5SR, LL63 5SS, LL63 5ST, LL63 5SU, LL63 5SW, LL63 5SY, LL63 5TA, LL63 5TB, LL63 5TH, LL63 5TL, LL63 5TN, LL63 5TP, LL63 5TR, LL63 5TS, LL63 5TT, LL63 5TU, LL63 5TW, LL63 5TY, LL63 5UA, LL63 5UB, LL63 5UD, LL63 5UE, LL63 5UF, LL63 5UG, LL63 5UH, LL63 5YD, LL65 3RU, LL65 3SN, LL65 3SW",336,179,157
W00000002,LL63,"LL63 5AZ, LL63 5BJ, LL63 5BQ, LL63 5BZ, LL63 5DQ, LL63 5DZ, LL63 5EJ, LL63 5EZ, LL63 5LJ, LL63 5LQ, LL63 5LZ, LL63 5PQ",236,80,156
W00000190,LL63,"LL63 5TD, LL64 5JA, LL64 5JB, LL64 5JD, LL64 5JE, LL64 5JF, LL64 5JG, LL64 5JH, LL64 5JJ, LL64 5JL, LL64 5JN, LL64 5JP, LL64 5JQ, LL64 5JR, LL64 5JS, LL64 5JT, LL64 5JU, LL64 5JW, LL64 5XB, LL64 5XG, LL64 5YJ, LL64 5YZ",186,119,67
W00000191,LL64,"LL64 5AF, LL64 5JX, LL64 5JY, LL64 5JZ, LL64 5QA, LL64 5QB, LL64 5QD, LL64 5QE, LL64 5UJ, LL64 5UQ, LL64 5UR, LL64 5UX, LL64 5UZ, LL64 5YQ, LL64 5YX, LL64 5ZA",158,120,38
W00000188,LL64,"LL64 5AD, LL64 5AE, LL64 5QF, LL64 5QG, LL64 5QH, LL64 5QJ, LL64 5QL, LL64 5QN, LL64 5QQ, LL64 5QU, LL64 5QW, LL64 5QY, LL64 5QZ, LL64 5RA, LL64 5RB, LL64 5XA",179,119,60
W00000189,LL64,"LL64 5AB, LL64 5QP, LL64 5QR, LL64 5QS, LL64 5QT, LL64 5QX",240,112,128
W00000038,LL65,"LL65 3AE, LL65 3FF, LL65 3GA, LL65 3PH, LL65 3PL, LL65 3PP, LL65 3PW, LL65 3PY, LL65 3RA, LL65 3RB, LL65 3RD",429,162,267
W00000113,LL65,"LL65 3SJ, LL65 3SY, LL65 3TB, LL65 3TD, LL65 3TN, LL65 3TP, LL65 3TR, LL65 3TW, LL65 3TX, LL65 3UR",351,74,277
W00000169,LL65,"LL65 2DP, LL65 2DR, LL65 2DT, LL65 2EA, LL65 2EB, LL65 2ED, LL65 2EE, LL65 2EF, LL65 2EP, LL65 2ES, LL65 2GA",360,221,139
W00000168,LL65,"LL65 2DE, LL65 2DG, LL65 2DH, LL65 2DL, LL65 2EG, LL65 2EL, LL65 2FF, LL65 2HN",263,169,94
W00000166,LL65,"LL65 2ER, LL65 2ET, LL65 2EU, LL65 2EW",246,152,94
W00000114,LL65,"LL65 3EZ, LL65 3PD, LL65 3PE, LL65 3PF, LL65 3PG, LL65 3RF, LL65 3ST, LL65 3TA, LL65 3TE, LL65 3TF, LL65 3TG, LL65 3TS, LL65 3TT, LL65 3TU, LL65 3TZ, LL65 3UB, LL65 3UE, LL65 3UF, LL65 3UG, LL65 3UH, LL65 3UL, LL65 4BY, LL65 4TB, LL65 4TE, LL65 4TP, LL65 4TR, LL65 4TS",360,118,242
W00000165,LL65,"LL65 1DJ, LL65 1DQ, LL65 2DA, LL65 2DF, LL65 2DN, LL65 2DS, LL65 2DU, LL65 2DW, LL65 2DY, LL65 2EY, LL65 2FA, LL65 2FG, LL65 2HE, LL65 2HH, LL65 2HL, LL65 2JF",376,232,144
W00000112,LL65,"LL65 4DY, LL65 4HH, LL65 4HW, LL65 4NL, LL65 4NN, LL65 4NP, LL65 4NS, LL65 4NU, LL65 4NW, LL65 4PD, LL65 4PG, LL65 4PQ, LL65 4YW",285,79,206
W00000158,LL65,"LL65 4BB, LL67 0DU, LL68 0RH, LL68 0SF, LL68 0SG, LL68 0SH, LL68 0SL, LL68 0SN, LL68 0TE, LL68 0TF, LL68 0TG, LL68 0TH, LL68 0TL, LL68 0TR, LL68 0TS, LL68 0TT, LL68 0TW, LL68 0UB, LL68 0UE, LL68 0UF, LL68 0UG",318,162,156
W00000167,LL65,"LL65 2EH, LL65 2EN, LL65 2PN, LL65 2PW, LL65 2QA, LL65 2RF",262,162,100
W00000115,LL65,"LL65 3FG, LL65 3PA, LL65 3PB, LL65 3SS, LL65 3SU, LL65 3SX, LL65 3SZ, LL65 3TH, LL65 3TL, LL65 3TY, LL65 3UA, LL65 3UD, LL65 3UJ, LL65 3UP, LL65 3YL, LL65 3ZA, LL65 3ZB, LL65 3ZE, LL65 3ZF, LL65 4BS, LL65 4BT, LL65 4BU, LL65 4DA",447,143,304
W00000120,LL65,"LL65 3FH, LL65 3HE, LL65 3HG, LL65 3HH, LL65 3HN, LL65 3HP, LL65 3HR, LL65 3HS, LL65 3HU, LL65 3HW, LL65 3NP, LL65 3PJ, LL65 3YA, LL65 3YB, LL65 3YD, LL65 3YE, LL65 3YF, LL65 3YG, LL65 3YH",367,193,174
W00000117,LL65,"LL65 3FE, LL65 3LG, LL65 3LH, LL65 3LL, LL65 3LN, LL65 3LT, LL65 3LW, LL65 3NR, LL65 3NS, LL65 3NT, LL65 3NU",339,249,90
W00000118,LL65,"LL65 3DX, LL65 3DZ, LL65 3EJ, LL65 3EQ, LL65 3EX, LL65 3LP, LL65 3LR, LL65 3LS, LL65 3NA, LL65 3ND, LL65 3SP",295,162,133
W00000119,LL65,"LL65 3HF, LL65 3HL, LL65 3HY, LL65 3LA, LL65 3LB, LL65 3LD, LL65 3LE, LL65 3LF, LL65 3NH, LL65 3NL, LL65 3NN, LL65 3NW, LL65 3NX, LL65 3NY, LL65 3PQ",267,191,76
W00000111,LL65,"LL65 4HB, LL65 4HD, LL65 4NR, LL65 4NT, LL65 4NY, LL65 4PA, LL65 4PB, LL65 4PE, LL65 4PF, LL65 4PH, LL65 4YE, LL65 4YF, LL65 4YG, LL65 4YH, LL65 4YL, LL65 4YN",252,115,137
W00000024,LL65,"LL65 3AJ, LL65 3AQ, LL65 3AX, LL65 3AZ, LL65 3BJ, LL65 3BX, LL65 3DJ, LL65 3DQ, LL65 3RH, LL65 3UN, LL65 3UW, LL65 3YP, LL65 3YR, LL65 3YS, LL65 3YT, LL65 3YU, LL65 3YY, LL65 4UA, LL71 7AH, LL71 7AN, LL71 7AP, LL71 7AS, LL71 7AW",371,116,255
W00000171,LL65,"LL65 1AQ, LL65 1BF, LL65 1DH, LL65 1LR, LL65 1LU, LL65 1LX, LL65 1LZ, LL65 1NF, LL65 1YG, LL65 1YN, LL65 1YP, LL65 1YR, LL65 1YU, LL65 1YW",380,204,176
W00000172,LL65,"LL65 1BQ, LL65 1BZ, LL65 1LD, LL65 1LE, LL65 1NA, LL65 1NP, LL65 1NQ, LL65 1NU, LL65 1NZ, LL65 1PA, LL65 1PF, LL65 1PG, LL65 1PH, LL65 1PJ, LL65 1PL, LL65 1RG, LL65 1ZB, LL65 1ZG, LL65 1ZH, LL65 1ZL",521,251,270
W00000023,LL65,"LL65 3BQ, LL65 3BZ, LL65 3LJ, LL65 3LQ, LL65 3LX, LL65 3LZ, LL65 4RJ, LL65 4RN, LL65 4RP, LL71 7AL, LL77 7DJ, LL77 7DZ, LL77 7EJ, LL77 7LJ, LL77 7LX, LL77 7LZ",286,72,214
W00000173,LL65,"LL65 1LH, LL65 1LP, LL65 1LS, LL65 1LT, LL65 1LY, LL65 1YE, LL65 1YF, LL65 1YS",263,149,114
W00000116,LL65,"LL65 3LU, LL65 3LY, LL65 3NB, LL65 3NE, LL65 3NF, LL65 3NG, LL65 3NJ",393,211,182
W00000156,LL65,"LL65 4EW, LL65 4LF, LL65 4LH, LL65 4LL, LL65 4LN, LL65 4LP, LL65 4LR, LL65 4LS, LL65 4LW, LL65 4LY, LL67 0DY, LL67 0EA, LL68 0SP, LL68 0SR, LL68 0SW, LL68 0UD",246,102,144
W00000110,LL65,"LL65 4DB, LL65 4DD, LL65 4DG, LL65 4DH, LL65 4DL, LL65 4DN, LL65 4DP, LL65 4DR, LL65 4DW, LL65 4NE, LL65 4NF, LL65 4NG, LL65 4NH, LL65 4UU, LL65 4UY, LL65 4UZ, LL65 4YA, LL65 4YB, LL65 4YD, LL65 4YR",320,128,192
W00000039,LL65,"LL65 4PJ, LL65 4PL, LL65 4PR, LL65 4PS, LL65 4PT, LL65 4PU, LL65 4RA, LL65 4RB, LL65 4RD, LL65 4RE, LL65 4RF, LL65 4RG, LL65 4RH, LL65 4RL, LL65 4RR, LL65 4RW, LL65 4SE, LL65 4SF, LL65 4SG, LL65 4SW",374,123,251
W00000040,LL65,"LL65 4PP, LL65 4PW, LL65 4PY, LL65 4RS, LL65 4SH, LL65 4SL, LL65 4SN, LL65 4SP, LL65 4SR, LL65 4SS, LL65 4ST",283,117,166
W00000041,LL65,"LL65 4RT, LL65 4RU, LL65 4RY, LL65 4SA, LL65 4SB, LL65 4SD, LL65 4SU, LL65 4SY",287,40,247
W00000142,LL65,"LL65 4AH, LL65 4AL, LL65 4AP, LL65 4AR, LL65 4AS, LL65 4AT, LL65 4BA, LL65 4DE, LL65 4TA, LL65 4TD, LL65 4TF, LL65 4TL, LL65 4TN, LL65 4TW, LL65 4TY, LL66 0BL, LL66 0BN, LL66 0BP, LL66 0BW, LL68 0PL, LL68 0TB, LL68 0TD, LL71 7AR, LL71 7DD, LL71 7DE",296,151,145
W00000143,LL65,"LL65 2FH, LL65 2GB, LL65 2JG, LL65 2PT, LL65 2PU, LL65 2PY, LL65 2RA, LL65 2RB, LL65 2RD, LL65 2RG, LL65 2SZ, LL65 2TJ, LL65 2UH",326,171,155
W00000144,LL65,"LL65 2PD, LL65 2PE, LL65 2PF, LL65 2PL, LL65 2PP, LL65 2PR, LL65 2PS",267,136,131
W00000145,LL65,"LL65 2BY, LL65 2HA, LL65 2HB, LL65 2HD, LL65 2NY, LL65 2PG, LL65 2PH, LL65 2RE",414,232,182
W00000146,LL65,"LL65 2NP, LL65 2NR, LL65 2NT, LL65 2NU, LL65 2PA",270,138,132
W00000147,LL65,"LL65 2BS, LL65 2BU, LL65 2DB, LL65 2HF, LL65 2HG, LL65 2NE, LL65 2NG, LL65 2NH, LL65 2NS, LL65 2NW, LL65 2PB",265,148,117
W00000075,LL65,"LL65 1BH, LL65 1ND, LL65 1NJ, LL65 1RA, LL65 1RS, LL65 1RT, LL65 1RU, LL65 1RZ, LL65 1SA, LL65 1SE, LL65 1SF, LL65 1SG, LL65 1SH, LL65 1SL",266,175,91
W00000076,LL65,"LL65 1BJ, LL65 1BP, LL65 1BS, LL65 1BT, LL65 1BU, LL65 1BW, LL65 1BY, LL65 1DD, LL65 1DF, LL65 1DS, LL65 1ED, LL65 1HG, LL65 1HH, LL65 1NB, LL65 1NE, LL65 1NH, LL65 1RH, LL65 1RL, LL65 1RN, LL65 1RP, LL65 1RW, LL65 1UB, LL65 1UE, LL65 1UU, LL65 1UY, LL65 1WY",252,166,86
W00000077,LL65,"LL65 1DN, LL65 1DX, LL65 1RR, LL65 1SN, LL65 1TR, LL65 1UD, LL65 1UF, LL65 1UG, LL65 1UH, LL65 1UL, LL65 1UN, LL65 1UP, LL65 1UR, LL65 1UT, LL65 1UW, LL65 2AE, LL65 2AF, LL65 2AU, LL65 2BB, LL65 2BT, LL65 2FE, LL65 2HU, LL65 2HW",369,223,146
W00000148,LL65,"LL65 1RE, LL65 1RF, LL65 1RJ, LL65 1TL, LL65 1TW",164,87,77
W00000155,LL65,"LL65 1NL, LL65 1NN, LL65 1NR, LL65 1NS, LL65 1NT, LL65 1NX, LL65 1NY, LL65 1TD, LL65 1TE, LL65 1TG, LL65 1TH, LL65 1TN",318,192,126
W00000149,LL65,"LL65 1NW, LL65 1PB, LL65 1PD, LL65 1PE, LL65 1PQ, LL65 1PX, LL65 1PZ, LL65 1QA, LL65 1QB",361,193,168
W00000151,LL65,"LL65 2AG, LL65 2AH, LL65 2AL, LL65 2AN, LL65 2AW, LL65 2AY, LL65 2BH",251,144,107
W00000078,LL65,"LL65 1SB, LL65 1SD, LL65 1SP, LL65 1SW, LL65 1TA, LL65 1TB, LL65 1TP, LL65 1TS, LL65 1TT, LL65 1TU, LL65 1TY, LL65 1TZ, LL65 2AT, LL65 2BF",272,160,112
W00000079,LL65,"LL65 2AP, LL65 2BN, LL65 2HT, LL65 2LB, LL65 2LE, LL65 2RH, LL65 2RL, LL65 2RN, LL65 2RP, LL65 2RR, LL65 2RS, LL65 2RU, LL65 2SG",285,149,136
W00000080,LL65,"LL65 2HY, LL65 2LA, LL65 2LD, LL65 2SD, LL65 2SE",356,211,145
W00000081,LL65,"LL65 2RT, LL65 2RW, LL65 2RY, LL65 2SA, LL65 2SB, LL65 2SF, LL65 2SN, LL65 2SP, LL65 2SR, LL65 2TL, LL65 2TQ",287,159,128
W00000082,LL65,"LL65 2SH, LL65 2SL, LL65 2SS, LL65 2ST, LL65 2SU, LL65 2SW, LL65 2SY, LL65 2TB, LL65 2TD, LL65 2TE, LL65 2TF, LL65 2TG, LL65 2TH, LL65 2TP, LL65 2WF, LL65 2WH, LL65 2YE, LL65 2YF, LL65 2YQ, LL65 2ZB, LL65 2ZG, LL65 2ZL",387,215,172
W00000083,LL65,"LL65 2LF, LL65 2LL, LL65 2LN, LL65 2QH, LL65 2TA, LL65 2TN, LL65 2YD",321,153,168
W00000108,LL65,"LL65 4AQ, LL65 4BE, LL65 4BG, LL65 4BH, LL65 4BL, LL65 4EA, LL65 4EB, LL65 4ED, LL65 4EE, LL65 4EF, LL65 4EG, LL65 4EH, LL65 4EJ, LL65 4EL, LL65 4EN, LL65 4EP, LL65 4EQ, LL65 4ER, LL65 4ES, LL65 4ET, LL65 4EU, LL65 4EY, LL65 4HA, LL65 4HL, LL65 4HN, LL65 4HP, LL65 4HR, LL65 4HS, LL65 4HT, LL65 4HU, LL65 4HY, LL65 4LA, LL65 4LB, LL65 4LD, LL65 4LE, LL65 4LG, LL65 4LT, LL65 4LU",475,223,252
W00000152,LL65,"LL65 2AS, LL65 2BA, LL65 2BD, LL65 2BE, LL65 2BG, LL65 2BL, LL65 2BW, LL65 2HP, LL65 2HR, LL65 2HS, LL65 2TZ",283,168,115
W00000153,LL65,"LL65 2AR, LL65 2LH, LL65 2ND, LL65 2QB, LL65 2YN",260,144,116
W00000154,LL65,"LL65 2DD, LL65 2LG, LL65 2NB, LL65 2NN",272,192,80
W00000109,LL65,"LL65 4UE, LL65 4UF, LL65 4UG, LL65 4UH, LL65 4UL, LL65 4UN, LL65 4UP, LL65 4UR, LL65 4UT, LL65 4UW, LL65 4YP, LL65 4YS",244,71,173
W00000150,LL65,"LL65 1SJ, LL65 1SR, LL65 1SS, LL65 1ST, LL65 1SU, LL65 1SY, LL65 1TF, LL65 2AA, LL65 2AB, LL65 2AD, LL65 2BP, LL65 2LY",329,201,128
W00000141,LL65,"LL65 4AA, LL65 4AB, LL65 4AD, LL65 4AE, LL65 4AF, LL65 4AG, LL65 4AJ, LL65 4AN, LL65 4AU, LL65 4AW, LL65 4AY, LL65 4BD, LL65 4DS, LL65 4DT, LL65 4DU, LL65 4TG, LL65 4TH",285,89,196
W00000170,LL65,"LL65 1AJ, LL65 1BX, LL65 1LF, LL65 1LG, LL65 1LJ, LL65 1LL, LL65 1LN, LL65 1LW",235,117,118
W00000204,LL65,"LL65 2QD, LL65 2QE, LL65 2QF, LL65 2QG, LL65 2TW, LL65 2UN, LL65 2UP, LL65 2UR, LL65 2UZ, LL65 2WD, LL65 2WG, LL65 2WJ, LL65 2WL, LL65 2WN, LL65 2WP, LL65 2WZ, LL65 2YL, LL65 2ZA",183,124,59
W00000186,LL65,"LL65 1DB, LL65 1DZ, LL65 1EY, LL65 1HA, LL65 1HD, LL65 1HE, LL65 1HL, LL65 1HP, LL65 1HR, LL65 1HS, LL65 1HT",261,163,98
W00000187,LL65,"LL65 1AX, LL65 1DA, LL65 1DU, LL65 1EB, LL65 1EG, LL65 1EH, LL65 1EJ, LL65 1EL, LL65 1EN, LL65 1EP, LL65 1EQ, LL65 1ER, LL65 1ES, LL65 1ET, LL65 1EU, LL65 1EW",295,195,100
W00000199,LL65,"LL65 2DX, LL65 2DZ, LL65 2EQ, LL65 2HZ, LL65 2NJ, LL65 2NQ, LL65 2NX, LL65 2NZ, LL65 2RJ, LL65 2RQ, LL65 2RX, LL65 2RZ, LL65 2SJ, LL65 2SQ",169,98,71
W00000226,LL65,"LL65 3AA, LL65 3AB, LL65 3AD, LL65 3AF, LL65 3AG, LL65 3AL, LL65 3AP, LL65 3AS, LL65 3BD, LL65 3EY",314,153,161
W00000200,LL65,"LL65 2EZ, LL65 2FB, LL65 2HJ, LL65 2HQ, LL65 2HX, LL65 2NF, LL65 2NL, LL65 2PJ, LL65 2PQ, LL65 2PX, LL65 2PZ, LL65 2SX, LL65 2TX",308,149,159
W00000201,LL65,"LL65 1YH, LL65 1YL, LL65 1YT, LL65 2LP, LL65 2LR, LL65 2LS, LL65 2LT, LL65 2LU, LL65 2LW, LL65 2NA, LL65 2UT, LL65 2UU",120,73,47
W00000202,LL65,"LL65 1AZ, LL65 1ZA, LL65 1ZE, LL65 1ZF, LL65 1ZJ, LL65 1ZN, LL65 1ZP, LL65 1ZQ, LL65 1ZR, LL65 2FD, LL65 2JA, LL65 2JB, LL65 2JD, LL65 2JE, LL65 2TR, LL65 2UG, LL65 2UJ, LL65 2UQ, LL65 2US, LL65 2UW, LL65 2UX, LL65 2UY, LL65 2WA, LL65 2WE, LL65 2WY, LL65 2YB, LL65 2YH, LL65 2YW, LL65 2YX, LL65 2ZD, LL65 2ZE, LL65 2ZF, LL65 2ZH, LL65 2ZJ, LL65 2ZZ, LL65 3YZ, LL65 3ZD, LL65 3ZG, LL65 3ZH, LL65 3ZJ, LL65 3ZL, LL65 3ZR, LL65 3ZU, LL65 4WZ, LL65 4ZA, LL65 4ZP, LL65 4ZT, LL65 4ZU, LL65 9AA, LL65 9AB, LL65 9AD, LL65 9AF, LL65 9AG, LL65 9AH, LL65 9AJ, LL65 9AL, LL65 9AN, LL65 9AQ, LL65 9AR, LL65 9AS, LL65 9AT, LL65 9AU, LL65 9AW, LL65 9AX, LL65 9AY, LL65 9AZ, LL65 9BA, LL65 9BD, LL65 9BE, LL65 9BF",306,197,109
W00000203,LL65,"LL65 2LX, LL65 2QS, LL65 2TS, LL65 2TT, LL65 2TU, LL65 2UE, LL65 2UF, LL65 2WB",295,193,102
W00000225,LL65,"LL65 3AN, LL65 3AY, LL65 3BA, LL65 3BE, LL65 3BF, LL65 3BG, LL65 3BH, LL65 3BU, LL65 3DS",284,159,125
W00000224,LL65,"LL65 3AR, LL65 3BS, LL65 3DN, LL65 3FJ",256,142,114
W00000223,LL65,"LL65 3AT, LL65 3AU, LL65 3AW, LL65 3BL, LL65 3BN, LL65 3BP, LL65 3BT, LL65 3BW, LL65 3DA, LL65 3DB, LL65 3DD, LL65 3DE, LL65 3DF, LL65 3DG, LL65 3DH, LL65 3DL, LL65 3HQ, LL65 3PZ",288,128,160
W00000222,LL65,"LL65 3AH, LL65 3DP, LL65 3DR, LL65 3EA, LL65 3EE, LL65 3EG, LL65 3FA, LL65 3FB, LL65 3FD, LL65 3SR",250,119,131
W00000221,LL65,"LL65 3DU, LL65 3EB, LL65 3ED, LL65 3EF, LL65 3EL, LL65 3EN, LL65 3EP, LL65 3EW, LL65 3HA, LL65 3HB, LL65 3HD, LL65 3HT",265,116,149
W00000220,LL65,"LL65 3DT, LL65 3EH, LL65 3ER, LL65 3ES, LL65 3ET, LL65 3EU",377,149,228
W00000205,LL65,"LL65 2LJ, LL65 2UA, LL65 2UB, LL65 2UD, LL65 2UL, LL65 2YP, LL65 2YR, LL65 2YU",137,90,47
W00000206,LL65,"LL65 2AJ, LL65 2AQ, LL65 2AX, LL65 2AZ, LL65 2BQ, LL65 2TY, LL65 2YG, LL65 2YJ, LL65 2YS, LL65 2YT, LL65 2YY, LL65 2YZ",255,168,87
W00000207,LL65,"LL65 2BJ, LL65 2BX, LL65 2BZ, LL65 2DJ, LL65 2DQ, LL65 2EJ, LL65 2EX, LL65 2LQ, LL65 2LZ",221,138,83
W00000184,LL65,"LL65 1AN, LL65 1AP, LL65 1AS, LL65 1AT, LL65 1AU, LL65 1AW, LL65 1AY, LL65 1BA, LL65 1BB, LL65 1BD, LL65 1BE, LL65 1YA, LL65 1YB, LL65 1YD",272,148,124
W00000227,LL65,"LL65 3BB, LL65 3BY, LL65 3DW, LL65 3DY",243,124,119
W00000185,LL65,"LL65 1AD, LL65 1AE, LL65 1AF, LL65 1AL, LL65 1AR, LL65 1BN, LL65 1HU, LL65 1LB",289,151,138
W00000180,LL65,"LL65 1HY, LL65 1LA, LL65 1PR, LL65 1PS, LL65 1RB",260,163,97
W00000183,LL65,"LL65 1AA, LL65 1AB, LL65 1AG, LL65 1AH, LL65 1BG, LL65 1BL, LL65 1PT, LL65 1PW, LL65 1RY",298,166,132
W00000182,LL65,"LL65 1DE, LL65 1DG, LL65 1DL, LL65 1DP, LL65 1DR, LL65 1DT, LL65 1DW, LL65 1DY, LL65 1EA, LL65 1EE, LL65 1EF, LL65 1FA, LL65 1HB, LL65 1HN, LL65 1HW",254,160,94
W00000181,LL65,"LL65 1NG, LL65 1PN, LL65 1PP, LL65 1PU, LL65 1PY, LL65 1RD",267,160,107
W00000105,LL66,"LL66 0AB, LL66 0AD, LL66 0BE, LL66 0BG, LL66 0BH, LL66 9AB, LL68 9PU, LL68 9PY, LL68 9RA, LL68 9RB, LL68 9RH, LL68 9RL, LL68 9TU, LL68 9TX, LL68 9TY, LL68 9UA, LL71 8AL, LL71 8AN, LL71 8AP, LL71 8AW",360,168,192
W00000106,LL66,"LL66 0AX, LL66 9AA, LL68 9AQ, LL68 9NR, LL68 9PJ, LL68 9PT, LL68 9TR, LL68 9TS, LL68 9TT, LL68 9UD, LL68 9UU, LL68 9UW, LL68 9WY",301,117,184
W00009981,LL66,"LL66 0AT, LL66 0AY, LL67 0AA, LL67 0HY, LL67 0LA, LL67 0LB, LL67 0LG, LL67 0LH, LL67 0LL, LL67 0LN, LL67 0LS, LL67 0LW, LL67 0NA, LL67 0NB, LL67 0NL, LL67 0NW, LL67 0ZA",222,126,96
W00000009,LL66,"LL66 0ZA, LL67 0ZD, LL68 8AA, LL68 8AB, LL68 8AD, LL68 8AE, LL68 8AF, LL68 9AT, LL68 9AU, LL68 9AY, LL68 9BA, LL68 9BD, LL68 9BH, LL68 9BJ, LL68 9BL, LL68 9BQ, LL68 9DA, LL68 9ZB, LL68 9ZD, LL68 9ZE, LL68 9ZF, LL68 9ZG, LL68 9ZZ",413,135,278
W00000157,LL66,"LL66 0AA, LL66 0AE, LL66 0AR, LL66 0AS, LL66 0AU, LL68 0NT, LL68 0NU, LL68 0NY, LL68 0PA, LL68 0PB, LL68 0PD, LL68 0PE, LL68 0PF, LL68 0PG, LL68 0PH, LL68 0PN, LL68 0PP, LL68 0PR, LL68 0PS, LL68 0PW, LL68 0RL, LL68 0RT, LL68 0RU, LL68 0SD, LL68 0TA, LL68 0TN, LL68 0TP, LL68 0ZA, LL68 0ZB, LL68 0ZD",356,182,174
W00000011,LL66,"LL66 0AN, LL66 0AP, LL66 0AW, LL68 0RR, LL68 0RS, LL68 9AA, LL68 9PA, LL68 9PB, LL68 9PF, LL68 9PG, LL68 9PH, LL68 9PL, LL68 9PN, LL68 9RP, LL68 9RR, LL68 9RS, LL68 9RW, LL68 9TA, LL68 9TB, LL68 9TF, LL68 9TL, LL68 9TN, LL68 9TP, LL68 9TW, LL69 9UT",255,124,131
W00000087,LL67,"LL67 0ER, LL67 0ET, LL67 0EU, LL67 0HA, LL67 0HB, LL67 0HD, LL67 0HE, LL67 0HF, LL67 0HG, LL67 0HJ, LL67 0HP, LL67 0ND, LL67 0NF, LL67 0NG, LL67 0NH, LL67 0NP",173,97,76
W00000088,LL67,"LL67 0DA, LL67 0DB, LL67 0DE, LL67 0DF, LL67 0DG, LL67 0DH, LL67 0DL, LL67 0DS, LL67 0DX, LL67 0HT, LL67 0LD, LL67 0LE, LL67 0LF, LL67 0LJ, LL67 0LP, LL67 0LT, LL67 0ZB",283,149,134
W00000084,LL67,"LL67 0EP, LL67 0ES, LL67 0EW, LL67 0HH, LL67 0HL, LL67 0HN, LL67 0HR, LL67 0HU, LL67 0NN",128,79,49
W00000086,LL67,"LL67 0EY, LL67 0HS, LL67 0HW",193,88,105
W00000090,LL67,"LL67 0DN, LL67 0DP, LL67 0DR, LL67 0DT, LL67 0DW, LL67 0ED",150,68,82
W00000160,LL68,"LL68 0PT, LL68 0PU, LL68 0PY, LL68 0RA, LL68 0RB, LL68 0RD, LL68 0RE, LL68 0RY, LL68 0SB",271,89,182
W00009980,LL68,"LL68 9AD, LL68 9AR, LL68 9AS, LL68 9AW, LL68 9AX, LL68 9BN, LL68 9BP, LL68 9BS, LL68 9BT, LL68 9BU, LL68 9BX, LL68 9NX, LL68 9RX, LL68 9TG",203,100,103
W00000005,LL68,"LL68 9AZ, LL68 9DB, LL68 9DP, LL68 9DW, LL68 9HE, LL68 9HG, LL68 9HN, LL68 9HP, LL68 9HU, LL68 9HW, LL68 9HY, LL68 9JA, LL68 9LA, LL68 9LH, LL68 9NS, LL71 8DG",460,180,280
W00000159,LL68,"LL68 0RF, LL68 0RG, LL68 0RJ, LL68 0SA, LL68 0SE, LL68 0SJ, LL68 0SQ, LL68 0SS",321,124,197
W00000006,LL68,"LL68 9DN, LL68 9HA, LL68 9HB, LL68 9HD, LL68 9HF, LL68 9HH, LL68 9HJ, LL68 9HL, LL68 9HR, LL68 9HT",302,118,184
W00000104,LL68,"LL68 9NE, LL69 9AJ, LL69 9AX, LL69 9AZ, LL69 9BJ, LL69 9BQ, LL69 9BX, LL69 9UN, LL69 9YB, LL69 9YF",278,117,161
W00009978,LL68,"LL68 9AN, LL68 9DY, LL68 9EA, LL68 9EH, LL68 9LB",254,117,137
W00000008,LL68,"LL68 9BY, LL68 9DH, LL68 9DL, LL68 9DS, LL68 9DT, LL68 9ER, LL68 9HS, LL68 9LL",245,113,132
W00000010,LL68,"LL68 9AJ, LL68 9SA, LL68 9SE, LL68 9SF, LL68 9SL, LL68 9SP, LL68 9SR, LL68 9SS, LL68 9ST, LL68 9SU, LL68 9SY, LL68 9TE",285,197,88
W00000012,LL68,"LL68 9AP, LL68 9DU, LL68 9EB, LL68 9ED, LL68 9EE, LL68 9EF, LL68 9EG, LL68 9EJ, LL68 9RT, LL68 9RU, LL68 9RY, LL68 9SB, LL68 9SD, LL68 9SG, LL68 9SH, LL68 9SN, LL68 9SQ, LL68 9SW",288,138,150
W00000013,LL68,"LL68 9BB, LL68 9BE, LL68 9BG, LL68 9LD, LL68 9NT, LL68 9NU, LL68 9NY, LL68 9PD, LL68 9PE, LL68 9RN, LL68 9TH, LL68 9ZA",400,149,251
W00009977,LL68,"LL68 9AB, LL68 9AE, LL68 9AF, LL68 9AG, LL68 9AH, LL68 9AL, LL68 9BW, LL68 9DR, LL68 9EL, LL68 9EN, LL68 9EP, LL68 9EQ, LL68 9ES, LL68 9ET, LL68 9EW, LL68 9EY, LL68 9YQ",246,113,133
W00000107,LL68,"LL68 9PP, LL68 9PR, LL68 9PS, LL68 9PW, LL68 9RD, LL68 9RE, LL68 9RF, LL68 9RG, LL68 9UB, LL69 9UE, LL69 9UF, LL69 9UG, LL69 9UH, LL70 9DX, LL71 8AD, LL71 8AG, LL71 8AH, LL71 8AR, LL71 8AS, LL71 8AT, LL71 8AU, LL71 8AY, LL71 8DH",369,170,199
W00000102,LL68,"LL68 9LE, LL68 9LN, LL68 9LP, LL68 9LS, LL68 9LT, LL68 9LU, LL68 9LW, LL68 9NB, LL68 9ND, LL68 9NN, LL69 9UP, LL69 9UR, LL69 9YA",297,183,114
W00000103,LL68,"LL68 9LF, LL68 9LR, LL68 9LY, LL68 9NA, LL68 9NF, LL68 9NG, LL68 9NH, LL68 9NJ, LL68 9NL, LL68 9NQ, LL69 9AQ, LL69 9UL, LL69 9YU, LL69 9YY, LL70 9DJ, LL70 9DQ, LL70 9LJ, LL70 9LQ, LL70 9LX, LL70 9LZ",355,200,155
W00009979,LL68,"LL68 9DD, LL68 9DE, LL68 9DF, LL68 9DG, LL68 9EU",247,83,164
W00000101,LL69,"LL69 9AB, LL69 9BZ, LL69 9YD, LL69 9YE, LL69 9YG, LL69 9YH, LL69 9YL, LL69 9YN, LL69 9YP, LL69 9YQ, LL69 9YR, LL69 9YS, LL69 9YT, LL69 9YW",304,119,185
W00000163,LL70,"LL70 9DZ, LL70 9EJ, LL70 9EQ, LL70 9EX, LL70 9EZ, LL70 9HJ, LL70 9HQ, LL70 9HX, LL70 9HZ, LL70 9PJ, LL70 9PQ, LL70 9PX, LL70 9PZ, LL71 8BH, LL71 8BL, LL71 8BN, LL71 8BW, LL72 8HA, LL72 8HB, LL72 8HF, LL72 8LY, LL72 8NE, LL72 8NF, LL72 8NG, LL72 8NH, LL72 8NL, LL72 8NN, LL73 8PH",305,172,133
W00000138,LL71,"LL71 7AB, LL71 7AE, LL71 7AT, LL71 7BB, LL71 7BD, LL71 7BE, LL71 8DB, LL71 8DD, LL71 8DE, LL71 8DP, LL71 8DU, LL71 8ES",303,88,215
W00000137,LL71,"LL71 7AG, LL71 7BG, LL71 7BH, LL71 7BL, LL71 7BN, LL71 7BP, LL71 7BS, LL71 7BT, LL71 7BU, LL71 7BW, LL71 7BY, LL71 7DA, LL71 7DB, LL71 7DF, LL71 7DG, LL71 7DH",225,105,120
W00000140,LL71,"LL71 7AA, LL71 7AD, LL71 7AF, LL71 7DL, LL71 7ZA, LL71 8AA, LL71 8AB, LL71 8AE, LL71 8DF, LL71 8ED, LL71 8EE, LL71 8EF, LL71 8EH, LL71 8EL, LL71 8EN, LL71 8EP, LL71 8ER, LL71 8EW",408,106,302
W00000098,LL71,"LL71 8AF, LL71 8BD, LL71 8BE, LL71 8BG, LL77 7HX, LL77 7UE, LL77 7UF, LL77 7UG, LL77 7UH, LL77 7UL, LL77 7UP, LL77 7UQ, LL77 7UR, LL77 7UT, LL77 7UW, LL77 8UX",314,86,228
W00000139,LL71,"LL71 8AJ, LL71 8BU, LL71 8BY, LL71 8DA, LL71 8DL, LL71 8DR, LL71 8DS, LL71 8DT, LL71 8DY, LL71 8EA, LL71 8EB, LL71 8EG, LL71 8EJ, LL71 8EQ, LL71 8EU",408,96,312
W00000100,LL71,"LL71 8BP, LL73 8NY, LL73 8PA, LL73 8PB, LL73 8PD, LL73 8PE, LL73 8PF, LL73 8PG, LL73 8PL, LL73 8PN, LL78 7JF",253,145,108
W00000161,LL72,"LL72 8HD, LL72 8HE, LL72 8HQ, LL72 8HR, LL72 8HS, LL72 8HT, LL72 8HW, LL72 8HY",155,91,64
W00000162,LL72,"LL72 8HG, LL72 8HH, LL72 8HJ, LL72 8HL, LL72 8LJ, LL72 8LS, LL72 8LT, LL72 8LU, LL72 8LZ",263,97,166
W00000164,LL72,"LL72 8HN, LL72 8HP, LL72 8HU, LL72 8LA, LL72 8LB, LL72 8LD, LL72 8LE, LL72 8LF, LL72 8LG, LL72 8LH, LL72 8LL, LL72 8LN, LL72 8LP, LL72 8LR, LL72 8LW, LL72 8NA, LL72 8NW",172,101,71
W00000044,LL73,"LL73 8PP, LL73 8PW, LL74 8NR, LL74 8NS, LL74 8NT, LL74 8SA, LL78 7JG, LL78 7JH, LL78 7JQ, LL78 8AD, LL78 8JF, LL78 8JG, LL78 8JH, LL78 8JJ, LL78 8JL, LL78 8JN, LL78 8JP, LL78 8JQ, LL78 8JR, LL78 8JS, LL78 8JT, LL78 8JW, LL78 8JY, LL78 8ZA",494,225,269
W00000042,LL74,"LL74 8PR, LL74 8RS, LL74 8SR, LL74 8SS, LL74 8TB, LL74 8TW",188,112,76
W00000043,LL74,"LL74 8RG, LL74 8RH, LL74 8TJ, LL74 8UA, LL74 8UB, LL74 8UD, LL74 8UE, LL74 8UH, LL74 8UL",256,150,106
W00000045,LL74,"LL74 8AB, LL74 8AD, LL74 8QF, LL74 8QG, LL74 8SB, LL74 8SD, LL74 8SJ, LL74 8UF, LL74 8ZD, LL74 8ZL",331,158,173
W00000047,LL74,"LL74 8PT, LL74 8PU, LL74 8RB, LL74 8RD, LL74 8RE, LL74 8XA",227,116,111
W00000092,LL74,"LL74 8QE, LL74 8SP, LL74 8TN, LL74 8TU, LL74 8TX, LL74 8TY",173,120,53
W00000096,LL74,"LL74 8AE, LL74 8QJ, LL74 8RU, LL74 8ST, LL74 8SU, LL74 8SW, LL74 8SX, LL74 8SY, LL74 8TF, LL74 8TG, LL74 8TH, LL74 8UG, LL74 8UJ, LL74 8UN, LL74 8WY",203,116,87
W00000095,LL74,"LL74 8PY, LL74 8QH, LL74 8RA, LL74 8RP, LL74 8RR, LL74 8TA",216,147,69
W00000093,LL74,"LL74 8RL, LL74 8RN, LL74 8RT, LL74 8RW, LL74 8SZ, LL74 8TR, LL74 8TS, LL74 8TT",173,121,52
W00000091,LL74,"LL74 8RF, LL74 8RY, LL75 8HX, LL76 8EG, LL76 8SQ, LL76 8SX, LL76 8SZ, LL76 8TJ, LL76 8TQ, LL76 8TX, LL76 8TZ, LL78 8JZ, LL78 8QA",294,127,167
W00000046,LL74,"LL74 8NU, LL74 8QP, LL74 8QQ, LL74 8SE, LL74 8SF, LL74 8SG, LL74 8SH, LL74 8SL, LL74 8SN, LL74 8SQ, LL74 8TD, LL74 8TE, LL74 8TL, LL74 8TP, LL74 8TQ, LL74 8TZ",280,148,132
W00000178,LL75,"LL75 7DR, LL75 8AX, LL75 8AZ, LL75 8UL, LL75 8UN, LL75 8YH, LL75 8YL, LL75 8YN, LL75 8YR, LL75 8YS, LL75 8YT, LL75 8YU, LL75 8YW, LL75 8YY",336,156,180
W00000094,LL75,"LL75 8DJ, LL75 8DQ, LL75 8DR, LL75 8DX, LL75 8DZ, LL75 8EJ, LL75 8EQ, LL75 8EX, LL75 8EZ, LL75 8HZ, LL75 8NQ, LL75 8RJ, LL75 8RQ, LL75 8RX, LL75 8RZ, LL76 8SJ",268,173,95
W00000177,LL75,"LL75 8UY, LL75 8YA, LL75 8YB",217,97,120
W00000176,LL75,"LL75 8AJ, LL75 8BJ, LL75 8BQ, LL75 8BX, LL75 8BZ, LL75 8DA, LL75 8LJ, LL75 8LQ, LL75 8UP, LL75 8UR, LL75 8UT, LL75 8UU, LL75 8UW, LL75 8YD, LL75 8YE, LL75 8YF",294,119,175
W00000179,LL75,"LL75 8HA, LL75 8HJ, LL75 8HQ, LL75 8LN, LL75 8LX, LL75 8LZ, LL75 8NJ, LL75 8PJ, LL75 8PQ, LL75 8PX, LL75 8PZ, LL75 8YG",264,121,143
W00000097,LL76,"LL76 8NX, LL77 7GL, LL77 7SF, LL77 7SL, LL77 7SN, LL77 7SP, LL77 7SW, LL77 7TB, LL77 7TD, LL77 7TE, LL77 7TF, LL77 7TG, LL77 7UA, LL77 7UD, LL77 8JB, LL77 8JD",400,141,259
W00000066,LL77,"LL77 7JE, LL77 7JU, LL77 7NP",283,65,218
W00000067,LL77,"LL77 7AE, LL77 7AF, LL77 7AG, LL77 7AH, LL77 7RP, LL77 7SA, LL77 7WA, LL77 7WB, LL77 7WD, LL77 8WA, LL77 8WB, LL77 8YQ, LL77 8YX",525,115,410
W00000068,LL77,"LL77 7EA, LL77 7EB, LL77 7ED, LL77 7EE, LL77 7EF, LL77 7EH, LL77 7EL, LL77 7JF, LL77 7ND, LL77 7NH, LL77 7NL, LL77 7NN, LL77 7PF, LL77 7QD, LL77 7QE, LL77 7TJ, LL77 7ZJ, LL77 7ZL, LL77 7ZQ",409,87,322
W00000069,LL77,"LL77 7JB, LL77 7JG, LL77 7NR, LL77 7NS, LL77 7NT, LL77 7NW, LL77 7UB, LL77 7YW",370,72,298
W00000052,LL77,"LL77 7AZ, LL77 7BJ, LL77 7EZ, LL77 7GB, LL77 7HB, LL77 7QA, LL77 7QG, LL77 7QH, LL77 7QQ, LL77 7YN, LL77 7YP",270,68,202
W00000053,LL77,"LL77 7EX, LL77 7GA, LL77 7GF, LL77 7GG, LL77 7NF, LL77 7NG, LL77 7PG, LL77 7QX, LL77 7QY, LL77 7QZ",448,88,360
W00000022,LL77,"LL77 7AD, LL77 7BZ, LL77 7DN, LL77 7DQ, LL77 7DX, LL77 7JS, LL77 7LQ, LL77 7PJ, LL77 7PQ",298,88,210
W00000099,LL77,"LL77 7HJ, LL77 7HQ, LL77 7HZ, LL77 7PX, LL77 7PZ, LL77 7RJ, LL77 7SR, LL77 7SS, LL77 7ST, LL77 7SU, LL77 7SY, LL77 7TA, LL77 7TH, LL77 7UN, LL77 7UU, LL77 8JA, LL77 8YJ, LL78 7JJ, LL78 7JL",327,89,238
W00000025,LL77,"LL77 7AJ, LL77 7AQ, LL77 7AU, LL77 7AX, LL77 7BX, LL77 7GD, LL77 7YR, LL77 7YS",264,66,198
W00000064,LL77,"LL77 7BQ, LL77 7NJ, LL77 7NQ, LL77 7NX, LL77 7NZ, LL77 7RQ, LL77 7RX, LL77 7RZ, LL77 7SJ, LL77 7SQ, LL77 7SX, LL77 7SZ, LL77 7TQ",237,32,205
W00000054,LL77,"LL77 7NE, LL77 7NU, LL77 7NY, LL77 7PA, LL77 7PB, LL77 7PD, LL77 7PE",262,68,194
W00000055,LL77,"LL77 7HG, LL77 7HH, LL77 7HL, LL77 7HN, LL77 7HP, LL77 7HR, LL77 7HS, LL77 7HW, LL77 7SE, LL77 7UX, LL77 7UZ, LL77 7XA, LL77 7XE, LL77 7YQ",351,120,231
W00000212,LL77,"LL77 7RF, LL77 7RG, LL77 7RH, LL77 7RL, LL77 7RN, LL77 7RR, LL77 7RW",252,58,194
W00000208,LL77,"LL77 7HT, LL77 7HU, LL77 7HY, LL77 7LA, LL77 7LF, LL77 7LH, LL77 7LP, LL77 7RS, LL77 7RY, LL77 7SB, LL77 7SD",409,107,302
W00000209,LL77,"LL77 7RD, LL77 7RE, LL77 7RU",241,59,182
W00000210,LL77,"LL77 7LB, LL77 7LD, LL77 7LE, LL77 7LG, LL77 7LL, LL77 7LN",513,129,384
W00000211,LL77,"LL77 7PP, LL77 7PR, LL77 7PS, LL77 7PU, LL77 7PW",114,32,82
W00000065,LL77,"LL77 7DU, LL77 7DW, LL77 7DY, LL77 7EG, LL77 7ER, LL77 7FD, LL77 7LS, LL77 7LT, LL77 7NB, LL77 7PH, LL77 7PL, LL77 7PN, LL77 7PT, LL77 7PY, LL77 7QF, LL77 7RA, LL77 7RB, LL77 7TR, LL77 7UJ, LL77 7ZG",303,84,219
W00007384,NP1,"NP1 6AT, NP1 6BJ, NP1 6BT, NP1 6LF, NP1 6QE, NP11 6AS, NP11 6AT, NP11 6BH, NP11 6BJ, NP11 6BN, NP11 6PU",266,250,16
W00007383,NP1,"NP1 6DQ, NP1 6GL, NP1 6GP, NP1 6GQ, NP1 6GR, NP1 6GS, NP1 6GT, NP1 6HE, NP1 6XA, NP1 6XB, NP1 6XE, NP1 6XF, NP1 6XG, NP11 6DJ, NP11 6DP, NP11 6DQ, NP11 6GL, NP11 6GN, NP11 6GP",254,239,15
W00006957,NP1,"NP1 7ES, NP1 7ET, NP1 7EW, NP1 7EX, NP1 7EY, NP11 7ES, NP11 7ET, NP11 7EU",319,289,30
W00007119,NP1,"NP1 4AZ, NP1 4EJ, NP1 4LG, NP1 4LJ, NP1 4LL, NP1 4LR, NP1 4XG, NP11 3AA, NP11 3AU, NP11 3AX, NP11 3AZ, NP11 3EF, NP11 3EJ, NP11 3EL, NP11 3EP, NP11 3GE, NP11 3XG, NP12 0FD, NP13 2DD, NP13 2DE, NP13 2DF, NP13 2DG, NP13 2DH, NP13 2DJ, NP13 2DL, NP13 2DN, NP13 2DP, NP13 2DQ, NP13 2DR, NP13 2DS, NP13 2DT, NP3 2DE, NP3 2DG, NP3 2DH, NP3 2DJ, NP3 2DL, NP3 2DP, NP3 2DR, NP3 2DS, NP3 2DT",170,157,13
W00006956,NP1,"NP1 4SA, NP1 4TE, NP1 4TF, NP1 4TG, NP1 4TH, NP1 5AQ, NP1 5GR, NP1 5GW, NP1 5GX, NP1 5JU, NP1 5LE, NP1 5RA, NP1 5RE, NP1 5RF, NP11 4SA, NP11 4SB, NP11 4SD, NP11 4SE, NP11 4SF, NP11 4TD, NP11 5AQ, NP11 5DT, NP11 5GJ, NP11 5GQ, NP11 5GR, NP11 5GT, NP11 5GW, NP11 5LB, NP11 5LD",237,223,14
W00006955,NP1,"NP1 5JF, NP1 5JG, NP1 5JJ, NP1 5JL, NP1 5JP, NP1 5JQ, NP1 5JR, NP1 5JS, NP1 5JT, NP11 5AP, NP11 5AS, NP11 5BS, NP11 5BT, NP11 5GG, NP11 5JB, NP11 5JF, NP11 5JG, NP11 5JJ, NP11 5JN, NP11 5JP, NP11 5JQ, NP11 5JR, NP11 5JS, NP11 5LJ",303,273,30
W00007385,NP1,"NP1 6AR, NP1 6AS, NP1 6AU, NP1 6AW, NP1 6AX, NP1 6AY, NP1 6BN, NP1 6BX, NP1 6PU, NP1 6PW, NP1 6PX, NP1 6YA, NP1 6YJ, NP1 6YL, NP11 6AP, NP11 6AU, NP11 6AW, NP11 6AY, NP11 6BU, NP11 6BW, NP11 6BX, NP11 6DS, NP11 6PW, NP11 6PX, NP11 6YA, NP11 6YE, NP11 6YH, NP11 6YJ, NP11 6YN, NP11 6ZQ, NP11 6ZY",271,250,21
W00007386,NP1,"NP1 6AZ, NP1 6BA, NP1 6BB, NP1 6BE, NP1 6BG, NP1 6BH, NP1 6BL, NP1 6BP, NP11 6AN, NP11 6AX, NP11 6AZ, NP11 6BA, NP11 6BB, NP11 6BG, NP11 6BL, NP11 6YL",224,208,16
W00006970,NP1,"NP1 4SH, NP1 4SL, NP1 4SQ, NP1 4SR, NP1 4SU, NP1 4SW, NP1 4SY, NP1 4TD, NP1 5GQ, NP11 4SG, NP11 4SH, NP11 4SN, NP11 4SU, NP11 4SW, NP11 4SX, NP11 4TE, NP11 4TF, NP11 4TG, NP11 4TP",441,398,43
W00006969,NP1,"NP1 4SE, NP1 4SF, NP1 4SG, NP1 4SN, NP1 4SP, NP1 4SS, NP1 4ST, NP1 4SX, NP1 4TB, NP11 3WS, NP11 3YE, NP11 3YH, NP11 3YN, NP11 3YS, NP11 4AA, NP11 4AP, NP11 4LT, NP11 4SL, NP11 4SP, NP11 4SQ, NP11 4SR, NP11 4SS, NP11 4ST, NP11 4TH, NP11 4WS, NP11 4WU, NP11 4WW, NP11 4WX, NP11 4WY, NP11 4WZ, NP11 4YB, NP11 4YS, NP11 4YW, NP11 5EY, NP11 5WY, NP11 5WZ, NP11 6WZ, NP11 6XF, NP11 6ZA, NP11 6ZE, NP11 6ZS, NP11 7WY, NP11 7WZ, NP11 7XZ, NP11 7YA, NP11 7YE, NP11 7YH, NP11 7YJ, NP11 7YU, NP11 7ZR, NP11 7ZT, NP11 7ZY, NP11 9AE, NP11 9AG, NP11 9AH, NP11 9AJ, NP11 9AL, NP11 9AN, NP11 9AP, NP11 9AQ, NP11 9AR, NP11 9AS, NP11 9AT, NP11 9AU, NP11 9AW, NP11 9AX, NP11 9AY, NP11 9BA, NP11 9BB",262,237,25
W00006964,NP1,"NP1 5AL, NP1 5AN, NP1 5AP, NP1 5AW, NP1 5GZ, NP1 7EQ, NP1 7ER, NP1 7EZ, NP1 7FA, NP1 7FB, NP11 5AL, NP11 7EN, NP11 7EQ, NP11 7ER, NP11 7EW, NP11 7EX, NP11 7EY, NP11 7EZ, NP11 7FA, NP11 7FB, NP11 7FE, NP11 7FF, NP11 7RS",268,242,26
W00006966,NP1,"NP1 5AB, NP1 5AD, NP1 5AE, NP1 5AF, NP11 5AA, NP11 5AB, NP11 5AD, NP11 5AE, NP11 5AF, NP11 5JA, NP11 5JH",282,249,33
W00006965,NP1,"NP1 7EE, NP1 7EH, NP1 7EJ, NP11 7EF, NP11 7EG, NP11 7EH, NP11 7EJ, NP11 7LX, NP11 7NT",254,235,19
W00006962,NP1,"NP1 4SB, NP1 5AH, NP1 5AJ, NP1 5AR, NP1 5GS, NP1 5GT, NP1 5HA, NP1 5RB, NP1 5RH, NP1 5RL, NP1 5RN, NP1 5YB, NP1 7NE, NP11 5AH, NP11 5AJ, NP11 5AR, NP11 5RL, NP11 5YS, NP11 7NE, NP11 7NG, NP11 7NS, NP11 7NX",249,227,22
W00006963,NP1,"NP1 7DZ, NP1 7EA, NP1 7EB, NP1 7ED, NP1 7EF, NP1 7EG, NP1 7GA, NP1 7LW, NP1 7LX, NP1 7LY, NP1 7LZ, NP1 7NA, NP1 7NB, NP1 7NF, NP1 7NG, NP1 7NH, NP1 7NJ, NP1 7NT, NP1 7ZD, NP1 7ZE, NP11 7BH, NP11 7DZ, NP11 7EA, NP11 7EB, NP11 7LU, NP11 7LW, NP11 7LY, NP11 7NB, NP11 7NH, NP11 7NJ, NP11 7NL, NP11 7ZB",286,256,30
W00006958,NP1,"NP1 7EN, NP1 7ND, NP1 7NS, NP11 7LZ, NP11 7NA, NP11 7ND, NP11 7NF",283,248,35
W00007387,NP1,"NP1 6EG, NP1 6LZ, NP11 6EF, NP11 6EG, NP11 6ET, NP11 6LX, NP11 6LY",311,285,26
W00006959,NP1,"NP1 7EL, NP1 7EP, NP1 7EU, NP11 7ED, NP11 7EE, NP11 7EL, NP11 7EP",304,279,25
W00006960,NP1,"NP1 5GU, NP1 5GY, NP1 5HB, NP1 5LA, NP1 5LB, NP1 5LD, NP1 5LF, NP11 5BW, NP11 5GN, NP11 5GS, NP11 5GU, NP11 5GX, NP11 5HA, NP11 5HB, NP11 5LE, NP11 5LF",300,260,40
W00006968,NP1,"NP1 5JW, NP1 5JX, NP1 5JY, NP1 5JZ, NP11 5JT, NP11 5JU, NP11 5JW, NP11 5JX, NP11 5JY, NP11 5JZ",329,282,47
W00007388,NP1,"NP1 6NE, NP1 6NG, NP11 6LZ, NP11 6NB, NP11 6ND",235,220,15
W00008680,NP1,"NP1 9GQ, NP10 9HJ, NP10 9HL, NP10 9HN, NP10 9HP, NP10 9HX",300,274,26
W00007390,NP1,"NP1 6JN, NP1 6JU, NP11 6NE, NP11 6NF, NP11 6NG, NP11 6NH",295,276,19
W00008671,NP1,"NP1 9BH, NP1 9BU, NP1 9BW, NP1 9DB, NP10 9BX, NP10 9BY, NP10 9DA, NP10 9DB",191,179,12
W00008672,NP1,"NP1 9BS, NP1 9BX, NP1 9BY, NP1 9DL, NP1 9DP, NP1 9DR, NP1 9GT, NP1 9GU, NP1 9GW, NP1 9HH, NP1 9HJ, NP1 9HL, NP1 9HN, NP1 9HP, NP1 9HQ, NP1 9HR, NP1 9HS, NP1 9HT, NP1 9HU, NP1 9HW, NP1 9HX, NP1 9HY, NP1 9HZ, NP10 9DL, NP10 9DP, NP10 9DR, NP10 9DZ, NP10 9HU",229,216,13
W00008673,NP1,"NP1 9DQ, NP1 9DU, NP1 9DW, NP1 9DX, NP1 9DY, NP1 9DZ, NP10 9DQ, NP10 9DW, NP10 9DX, NP10 9EA, NP10 9EB, NP10 9EF, NP10 9EG, NP10 9EH, NP10 9YA",321,294,27
W00008674,NP1,"NP1 9BT, NP1 9BZ, NP1 9DA, NP1 9DD, NP1 9DE, NP10 9BW, NP10 9BZ, NP10 9DD, NP10 9DE, NP10 9DH, NP10 9DJ, NP10 9DU",292,264,28
W00008675,NP1,"NP1 9DF, NP1 9DG, NP1 9DH, NP1 9DJ, NP1 9DT, NP10 9DG, NP10 9DS, NP10 9DT, NP10 9ED, NP10 9ES",195,183,12
W00008676,NP1,"NP1 9DN, NP10 9DF, NP10 9DN, NP20 3PA, NP20 3PB, NP20 3PD, NP20 3PE, NP20 3PF, NP20 3PG, NP20 3PH, NP20 3PJ, NP20 3PL, NP20 3PN, NP20 3PU, NP20 3PW, NP20 3QA, NP20 3QB, NP20 3QD, NP20 3QE, NP20 3QF, NP20 3RJ, NP9 3PU, NP9 3RJ, NPT 3PU, NPT 3RJ",440,411,29
W00008678,NP1,"NP1 0AF, NP1 0AJ, NP1 0AL, NP1 0BA, NP1 0BB, NP1 9FX, NP1 9GR, NP10 0AF, NP10 0BA, NP10 0BB, NP10 1AF, NP10 1AJ, NP10 1AL, NP10 1BA, NP10 1BB, NP10 1BD, NP10 9AT, NP10 9DY, NP10 9FX, NP10 9HG, NP10 9HY, NP10 9WS",508,471,37
W00008679,NP1,"NP1 6GH, NP1 9GJ, NP1 9GN, NP1 9GS, NP1 9HF, NP10 9FZ, NP10 9GH, NP10 9GJ, NP10 9GN, NP10 9GS, NP10 9HF, NP10 9TG, NP9 6SE, NP9 6SF, NP9 6SH, NP9 6SJ, NPT 6SE, NPT 6SF, NPT 6SH",365,335,30
W00007286,NP1,"NP1 4LS, NP12 0EN, NP12 0ES, NP12 0LF, NP12 0LJ, NP12 0LL, NP12 0LQ, NP12 0NJ, NP12 0NL, NP12 0NY, NP2 0EL, NP2 0EN, NP2 0LF, NP2 0LL, NP2 0LQ, NP2 0YH, NP2 0YZ",364,335,29
W00007389,NP1,"NP1 6EF, NP1 6LE, NP1 6LG, NP1 6LH, NP11 6BD, NP11 6BE, NP11 6BP, NP11 6EB, NP11 6ED",239,222,17
W00008681,NP1,"NP1 0AB, NP1 0AX, NP1 0AY, NP1 0AZ, NP1 0YA, NP1 0YB, NP1 0YD, NP1 0YE, NP10 0AB, NP10 0AJ, NP10 0AR, NP10 0AT, NP10 0AU, NP10 0AW, NP10 0AX, NP10 0AY, NP10 0AZ, NP10 1AB, NP10 1AX, NP10 1AY, NP10 1AZ",289,270,19
W00008750,NP1,"NP1 9TB, NP10 8TA, NP10 8TB, NP10 8TD, NP10 8TG, NP9 3AH, NP9 3AQ, NP9 3AS, NP9 3AU, NP9 3DJ, NP9 3YU, NPT 3AH, NPT 3AQ, NPT 3AS, NPT 3AU, NPT 3DJ",223,204,19
W00008751,NP1,"NP1 9TD, NP1 9TF, NP1 9TG, NP1 9TQ, NP1 9WG, NP1 9WJ, NP1 9WL, NP1 9WN, NP1 9WP, NP10 8WF, NP10 8WG, NP10 8WH, NP10 8WJ, NP10 8YJ, NP9 1YJ, NPT 1YJ",344,325,19
W00007382,NP1,"NP1 6BU, NP1 6BW, NP1 6BY, NP1 6BZ, NP1 6DA, NP1 6DB, NP1 6DD, NP1 6DE, NP1 6DF, NP1 6DG, NP1 6DJ, NP1 6DL, NP1 6DN, NP1 6DS, NP1 6ER, NP1 6YE, NP11 6BT, NP11 6BY, NP11 6BZ, NP11 6DA, NP11 6DB, NP11 6DD, NP11 6DH, NP11 6DL, NP11 6DN, NP11 6DT, NP11 6ER",306,282,24
W00008752,NP1,"NP1 9WH, NP1 9XD, NP10 8XB, NP10 8XD, NP10 8XE",138,137,1
W00008753,NP1,"NP1 9WQ, NP1 9WR, NP10 8WP, NP10 8WQ",358,332,26
W00008755,NP1,"NP1 9WA, NP1 9WB, NP1 9XE, NP1 9XF, NP10 8WA, NP10 8WZ, NP10 8XF",144,144,0
W00008757,NP1,"NP1 9TE, NP1 9WF, NP1 9WX, NP1 9WY, NP1 9WZ, NP10 8TH, NP10 8WX, NP10 8WY, NP10 8XH, NP10 8XL",332,302,30
W00007392,NP1,"NP1 6NH, NP1 6NJ, NP11 6AR, NP11 6LU, NP11 6NJ, NP11 6NL, NP11 6NN",279,262,17
W00007391,NP1,"NP1 6JP, NP1 6JQ, NP1 6JR, NP1 6JT, NP1 6LT, NP1 6NQ, NP11 6JP, NP11 6JQ, NP11 6JR, NP11 6LT, NP11 6NQ",285,257,28
W00008682,NP1,"NP1 9EA, NP1 9EB, NP1 9ED, NP1 9EE, NP1 9FR, NP1 9FS, NP1 9FT, NP1 9FU, NP1 9FY, NP1 9FZ, NP1 9GA, NP1 9GH, NP10 9EE, NP10 9FS, NP10 9FT, NP10 9FU, NP10 9FY",239,221,18
W00007381,NP1,"NP1 6FZ, NP11 6HH, NP11 6HX, NP11 6HY, NP11 6HZ",291,266,25
W00007117,NP1,"NP1 4DB, NP1 4DG, NP1 4DH, NP1 4DL, NP1 4DN, NP1 4ED, NP1 4RS, NP11 3DB, NP11 3DG, NP11 3DH, NP11 3DL, NP11 4AB, NP11 4RD, NP11 4RU",276,262,14
W00007379,NP1,"NP1 6JB, NP11 6JE, NP11 6JF, NP11 6RP, NP11 6RQ, NP11 6RR, NP11 6XE",304,274,30
W00007112,NP1,"NP1 4DP, NP1 4DQ, NP1 4DU, NP11 3DP, NP11 3DU, NP11 3DW, NP11 3DX",329,300,29
W00007111,NP1,"NP1 4AQ, NP1 4AR, NP1 4AS, NP1 4AT, NP1 4BN, NP1 4DT, NP11 3AQ, NP11 3AR, NP11 3AS, NP11 3BN, NP11 3DR, NP11 3DS, NP11 3DT",265,245,20
W00007347,NP1,"NP1 4HA, NP1 4HT, NP12 2AZ, NP12 2BB, NP12 2BG, NP12 2BL, NP12 2DP, NP12 2DR, NP12 2DT, NP12 2DU, NP12 2NB, NP12 2ND, NP12 2NE, NP12 2NF, NP12 2QT, NP2 2AX, NP2 2AY, NP2 2AZ, NP2 2BA, NP2 2BB, NP2 2BQ, NP2 2DT, NP2 2DU, NP2 2DX, NP2 2ND, NP2 2NF, NP2 2NG",412,377,35
W00007110,NP1,"NP1 4BA, NP1 4BF, NP1 4BY, NP1 4BZ, NP1 4DA, NP1 4DD, NP1 4DE, NP1 4DF, NP11 3BY, NP11 3BZ, NP11 3DA, NP11 3DD, NP11 3DE, NP11 3LR, NP11 3LS, NP11 3NJ, NP2 0LH",248,226,22
W00007109,NP1,"NP1 4BH, NP1 4BJ, NP1 4BX, NP1 4GP, NP1 4GQ, NP1 4GR, NP11 3AT, NP11 3BH, NP11 3BJ, NP11 3BL, NP11 3BQ, NP11 3DF, NP11 3GN, NP11 3GP, NP12 0LH",364,332,32
W00007108,NP1,"NP1 4PB, NP1 4PD, NP1 4PE, NP1 4PF, NP1 4PG, NP1 4PH, NP1 4PL, NP1 4QH, NP1 4XF, NP1 4XL, NP1 5EG, NP1 5EN, NP1 5EP, NP1 5EQ, NP1 5ER, NP1 5ES, NP1 5ET, NP1 5EU, NP1 5EW, NP11 3PB, NP11 3PE, NP11 3PF, NP11 3PG, NP11 3PH, NP11 3PJ, NP11 3PL, NP11 3QG, NP11 3QH, NP11 3XF, NP11 4PA, NP11 4PP, NP11 4PT, NP11 5EN, NP11 5EP, NP11 5EQ, NP11 5ER, NP11 5ES, NP11 5ET, NP11 5EU, NP11 5EW",197,184,13
W00010609,NP1,"NP1 9YA, NP10 9NL, NP10 9PA, NP10 9PN, NP10 9PS",307,290,17
W00007106,NP1,"NP1 5AX, NP1 5AZ, NP1 5BA, NP1 5BB, NP1 5BD, NP1 5BE, NP1 5BG, NP1 5BH, NP1 5BJ, NP1 5BL, NP1 5BS, NP11 5AX, NP11 5AZ, NP11 5BA, NP11 5BB, NP11 5BD, NP11 5BE, NP11 5BG, NP11 5BH, NP11 5BJ, NP11 5BL, NP11 5DS",276,252,24
W00007105,NP1,"NP1 4AG, NP1 4AW, NP1 4BL, NP1 4BP, NP1 4BQ, NP1 4BR, NP1 4BS, NP1 4BT, NP1 4GN, NP1 4HY, NP1 4LT, NP1 4RJ, NP11 3AF, NP11 3AG, NP11 3AH, NP11 3AW, NP11 3BA, NP11 3BP, NP11 3BT, NP11 3BX, NP11 4RP",265,251,14
W00007104,NP1,"NP1 4JP, NP1 4JR, NP1 4JU, NP1 4JW, NP11 3JR, NP11 3JS, NP11 3JW, NP11 3JX, NP3 2DN",290,263,27
W00007103,NP1,"NP1 7DD, NP1 7DU, NP1 7DW, NP1 7DX, NP1 7DY, NP1 7FS, NP1 7GG, NP11 7DU, NP11 7DW, NP11 7DX, NP11 7DY, NP11 7FS, NP11 7FU",188,170,18
W00007102,NP1,"NP1 7FT, NP1 7FU, NP1 7FW, NP1 7FX, NP1 7FY, NP1 7FZ, NP11 7FD, NP11 7FT, NP11 7FW, NP11 7FX, NP11 7FY, NP11 7FZ",312,289,23
W00007093,NP1,"NP1 7DA, NP1 7DB, NP1 7DE, NP1 7FR, NP1 7GE, NP1 7GF, NP1 7GH, NP11 7DA, NP11 7DB, NP11 7DD, NP11 7DE, NP11 7FQ, NP11 7FR, NP11 7GE, NP11 7GF, NP11 7GG, NP11 7GH",305,276,29
W00007094,NP1,"NP1 7DF, NP1 7FN, NP1 7FQ, NP11 7BW, NP11 7BX, NP11 7BY, NP11 7BZ, NP11 7DF, NP11 7DL, NP11 7FN, NP11 7FP",279,248,31
W00007095,NP1,"NP1 7BT, NP1 7BW, NP1 7BX, NP1 7DG, NP1 7DH, NP1 7FP, NP1 7ZA, NP1 7ZB, NP11 7BT, NP11 7BU, NP11 7DG, NP11 7PG, NP11 7PH, NP11 7ZA",317,298,19
W00007096,NP1,"NP1 6GZ, NP11 6GY, NP11 6GZ, NP11 7AG, NP11 7AQ, NP11 7DH, NP11 7DJ, NP11 7DN",258,245,13
W00007097,NP1,"NP1 7BR, NP1 7BS, NP1 7BU, NP1 7BY, NP1 7BZ, NP1 7PA, NP1 7PB, NP1 7PD, NP1 7PN, NP11 7AT, NP11 7BR, NP11 7BS, NP11 7PA, NP11 7PB",278,254,24
W00007098,NP1,"NP1 7PE, NP1 7PG, NP1 7PJ, NP1 7PL, NP1 7YL, NP1 7YN, NP1 7YR, NP11 7PD, NP11 7PE, NP11 7PF, NP11 7PJ, NP11 7PL, NP11 7PN, NP11 7QB",309,278,31
W00007099,NP1,"NP1 7AJ, NP1 7DJ, NP1 7NU, NP1 7NX, NP11 7AJ, NP11 7AL, NP11 7AN",133,132,1
W00007113,NP1,"NP1 4AY, NP1 4DR, NP1 4DS, NP1 4PJ, NP1 4PN, NP1 4PP, NP1 4PQ, NP1 4PT, NP1 4PU, NP1 4QA, NP1 4QB, NP1 4QD, NP1 4QF, NP1 4QG, NP11 3AP, NP11 3AY, NP11 3DQ, NP11 3PA, NP11 3PN, NP11 3PP, NP11 3QF, NP11 3YU, NP11 4PN, NP11 4QA, NP11 4QB, NP11 4QD, NP11 4QE",302,273,29
W00007114,NP1,"NP1 4DJ, NP1 4DW, NP1 4DZ, NP1 4EA, NP1 4EB, NP1 4EE, NP1 4XU, NP1 4XW, NP1 4YB, NP1 4YE, NP1 4YG, NP1 4YH, NP1 4YJ, NP1 4YN, NP1 4YP, NP1 4YR, NP1 4YW, NP11 3AL, NP11 3DJ, NP11 3DY, NP11 3DZ, NP11 3EA, NP11 3EB, NP11 3ED, NP11 3EE",317,298,19
W00007115,NP1,"NP1 4PA, NP1 4PR, NP1 4PS, NP1 4PW, NP1 4PX, NP1 4PY, NP1 4PZ, NP1 4QE, NP1 4XN, NP11 4AN, NP11 4AQ, NP11 4AR, NP11 4AS, NP11 4PQ, NP11 4PR, NP11 4PW, NP11 4PX, NP11 4PY",326,304,22
W00007116,NP1,"NP1 4AL, NP1 4AN, NP1 4QJ, NP1 4RT, NP11 3DN, NP11 4AF, NP11 4PS, NP11 4PU, NP11 4QJ, NP11 4RS, NP11 4RT",245,227,18
W00007118,NP1,"NP1 4BB, NP1 4BD, NP1 4JH, NP1 4JS, NP1 4JX, NP1 4JY, NP1 4LA, NP1 4LF, NP1 4LN, NP1 4LP, NP1 4LQ, NP11 3AE, NP11 3BB, NP11 3BD, NP11 3LF, NP11 3LG, NP11 3LH, NP11 3LJ, NP11 3LL, NP11 3LN, NP11 3LP, NP11 3LQ, NP13 2AL, NP13 2BP, NP13 2BS, NP13 2BT, NP13 2BU, NP13 2BX, NP13 2DA, NP13 2DB, NP13 2DU, NP13 2JR, NP13 2XA, NP3 2AL, NP3 2BG, NP3 2BQ, NP3 2BS, NP3 2BT, NP3 2BU, NP3 2BX, NP3 2DA, NP3 2DB, NP3 2DD, NP3 2DF, NP3 2DQ, NP3 2DU, NP3 2JR, NP3 2RW, NP3 2XA",292,264,28
W00007378,NP1,"NP1 6FY, NP1 6HU, NP1 6HX, NP1 6HY, NP11 6FY, NP11 6FZ, NP11 6GA, NP11 6GB, NP11 6HR, NP11 6HU, NP11 6JB",252,233,19
W00007377,NP1,"NP1 6AF, NP1 9YU, NP10 9GF, NP10 9QD, NP10 9YU, NP11 6JS, NP11 6JT, NP11 6JU",213,207,6
W00007376,NP1,"NP1 6JD, NP1 6JG, NP1 6JS, NP1 6QX, NP1 6QY, NP1 6YT, NP1 6YU, NP1 6YY, NP1 6ZY, NP1 9GE, NP1 9GF, NP1 9GG, NP1 9GL, NP10 9GE, NP10 9GG, NP10 9GL, NP10 9GR, NP11 6GH, NP11 6JD, NP11 6JG, NP11 6QX, NP11 6QY, NP11 6YY",244,229,15
W00007375,NP1,"NP1 6RB, NP1 6RD, NP1 6RE, NP11 6PD, NP11 6PE, NP11 6RD, NP11 6RJ",314,291,23
W00007374,NP1,"NP1 6JW, NP1 6JX, NP1 6JY, NP1 6JZ, NP1 6LA, NP1 6LD, NP1 6LJ, NP1 6QP, NP11 6JW, NP11 6JX, NP11 6LA, NP11 6LD, NP11 6LH, NP11 6LJ",229,219,10
W00007373,NP1,"NP1 6QT, NP1 6QU, NP1 6QZ, NP11 6QW, NP11 6QZ, NP11 6RA, NP11 6RB",243,231,12
W00007372,NP1,"NP1 6AB, NP1 6AD, NP1 6AG, NP1 6LB, NP11 6AF, NP11 6AG, NP11 6JY, NP11 6LB",290,271,19
W00007371,NP1,"NP1 6RP, NP1 6RQ, NP1 6RR, NP11 6PB, NP11 6PH, NP11 6PP",321,298,23
W00007380,NP1,"NP1 6HZ, NP1 6JF, NP11 6HN, NP11 6HP, NP11 6HW, NP11 6JA",268,253,15
W00007370,NP1,"NP1 6QH, NP1 6QL, NP1 6QN, NP1 6QQ, NP1 6QR, NP11 6AL, NP11 6LE, NP11 6LF, NP11 6LG, NP11 6LL, NP11 6QH, NP11 6QL, NP11 6QP, NP11 6QQ",435,409,26
W00007368,NP1,"NP1 6AA, NP1 6AH, NP1 6PD, NP1 6PG, NP1 6PH, NP1 6PJ, NP11 6AA, NP11 6AB, NP11 6JZ, NP11 6PJ",292,269,23
W00007367,NP1,"NP1 6PA, NP1 6PF, NP1 6PL, NP1 6PN, NP1 6XD, NP1 6YB, NP1 6YH, NP1 6YN, NP1 6YR, NP11 6DU, NP11 6PF, NP11 6PL, NP11 6PQ, NP11 6QN, NP11 6QR, NP11 6XG, NP11 6YB, NP11 6YQ",263,245,18
W00007366,NP1,"NP1 6JA, NP1 6PB, NP1 6PP, NP11 6PA, NP11 6PG, NP11 6PN",315,298,17
W00007365,NP1,"NP1 6HJ, NP1 6HL, NP1 6HW, NP1 6PQ, NP1 6PS, NP1 6QF, NP1 6QJ, NP11 6HJ, NP11 6HL, NP11 6PS, NP11 6QJ",280,248,32
W00007364,NP1,"NP1 6FJ, NP1 6GA, NP1 6GB, NP1 6GD, NP1 6GE, NP1 6HP, NP1 6HQ, NP1 6HR, NP1 6HS, NP1 6PR, NP1 6PY, NP1 6PZ, NP1 6QA, NP1 6QG, NP11 6HQ, NP11 6HS, NP11 6HT, NP11 6JH, NP11 6PR, NP11 6PY, NP11 6PZ, NP11 6QA, NP11 6RL",302,276,26
W00007363,NP1,"NP1 6HN, NP1 6HT, NP1 6QB, NP1 6QD, NP11 6BQ, NP11 6QB, NP11 6QD, NP11 6QE, NP11 6QF, NP11 6QG",276,252,24
W00007362,NP1,"NP1 6AE, NP1 6PE, NP1 6RA, NP1 6RJ, NP1 6YS, NP11 6AD, NP11 6AE, NP11 6AH",334,315,19
W00007361,NP1,"NP1 6QW, NP1 6RF, NP1 6RG, NP11 6RE, NP11 6RF, NP11 6RG",202,185,17
W00008670,NP1,"NP1 9BJ, NP1 9BL, NP1 9BP, NP1 9BR, NP10 9BH, NP10 9BS, NP10 9BT, NP10 9BU",326,296,30
W00007369,NP1,"NP1 6QS, NP1 6RH, NP11 6QS, NP11 6QT, NP11 6QU, NP11 6RH",273,251,22
W00008669,NP1,"NP1 9BN, NP1 9BQ, NP10 9BJ, NP10 9BL, NP10 9BN, NP10 9BP, NP10 9BR",314,295,19
W00007399,NP1,"NP1 6DH, NP1 6EZ, NP1 6FB, NP1 6FD, NP1 6FH, NP1 6GG, NP1 6GN, NP1 6HD, NP1 6YG, NP1 6YQ, NP11 6DE, NP11 6DF, NP11 6DG, NP11 6EZ, NP11 6FB, NP11 6GQ, NP11 6GR, NP11 6YG",298,280,18
W00008667,NP1,"NP1 9AD, NP10 9AD, NP10 9AE, NP10 9LX, NP10 9LY, NP10 9SG, NP10 9SH, NP10 9SJ, NPT 3SG",306,281,25
W00008497,NP1,"NP1 9JA, NP1 9JD, NP1 9JE, NP1 9JP, NP1 9JQ, NP1 9JS, NP1 9JT, NP1 9JX, NP1 9JY, NP1 9LH, NP1 9LJ, NP1 9LL, NP1 9LN, NP1 9LP, NP1 9LX, NP1 9LY, NP1 9LZ, NP1 9NW, NP1 9YD, NP10 8HZ, NP10 8JA, NP10 8JD, NP10 8LG, NP10 8LL, NP10 8LN, NP10 8LP, NP10 8LX, NP10 8SG",315,287,28
W00008499,NP1,"NP1 9QA, NP1 9QE, NP1 9RL, NP1 9RN, NP1 9RX, NP1 9RZ, NP10 8QA, NP10 8QT, NP10 8QU, NP10 8QZ, NP10 8RL, NP10 8RN, NP10 8RZ",307,279,28
W00007245,NP1,"NP1 4FP, NP1 4FQ, NP1 4FR, NP1 4FS, NP1 4FU, NP1 4FW, NP1 4FX, NP1 4FY, NP1 4FZ, NP1 4GA, NP1 4GB, NP1 4GS, NP1 4LZ, NP1 4RR, NP11 4FT, NP11 4FY, NP11 4FZ, NP11 4GA, NP11 4GB, NP11 4GH, NP11 4LY, NP11 4LZ, NP11 4NA",235,214,21
W00008501,NP1,"NP1 9NZ, NP1 9PA, NP1 9PB, NP1 9PU, NP10 8NY, NP10 8NZ, NP10 8PD, NP10 8PE, NP10 8PN, NP10 8PU, NP10 8PW",293,264,29
W00008503,NP1,"NP1 9LW, NP1 9PL, NP1 9PP, NP1 9PR, NP1 9PS, NP1 9PT, NP1 9PX, NP1 9PY, NP1 9PZ, NP1 9RA, NP1 9RB, NP1 9RG, NP10 8GS, NP10 8JU, NP10 8JW, NP10 8LW, NP10 8PP, NP10 8PR, NP10 8PZ, NP10 8RA, NP10 8RB, NP10 8RG, NP10 8XS",283,255,28
W00008504,NP1,"NP1 9NU, NP1 9NX, NP1 9NY, NP1 9PD, NP1 9PE, NP10 8LR, NP10 8NX, NP10 8PA, NP10 8PB, NP10 8PQ, NP10 8QB",242,227,15
W00008505,NP1,"NP1 9NN, NP1 9NS, NP1 9NT, NP1 9PF, NP1 9PH, NP10 8LH, NP10 8NT, NP10 8NU, NP10 8NW, NP10 8PF, NP10 8PH",339,303,36
W00008506,NP1,"NP1 9DS, NP1 9JZ, NP1 9LA, NP1 9XN, NP1 9XS, NP1 9XU, NP1 9XW, NP1 9XZ, NP1 9YG, NP1 9YH, NP1 9YN, NP1 9YP, NP1 9YR, NP1 9YT, NP10 8BP, NP10 8BQ, NP10 8BR, NP10 8BW, NP10 8JZ, NP10 8LA, NP10 8LB, NP10 8NA, NP10 8NE, NP10 8QY, NP10 8ZU, NP9 3PW, NP9 3PX, NPT 3PW, NPT 3PX",520,487,33
W00007244,NP1,"NP1 4AH, NP1 4LY, NP1 4ND, NP1 4NF, NP1 4NG, NP1 4NH, NP1 4NJ, NP1 4NL, NP1 4NN, NP1 4NP, NP1 4NQ, NP1 4NR, NP1 4NS, NP1 4NU, NP1 4NW, NP1 4NX, NP1 4XQ, NP11 3EG, NP11 3NP, NP11 3NQ, NP11 3NR, NP11 3NS, NP11 3NT, NP11 3RJ, NP11 4AL, NP11 4NF, NP11 4NH, NP11 4NJ, NP11 4NL, NP11 4NW, NP11 4NX, NP11 4RJ, NP11 4RW, NP11 4RX",348,317,31
W00008496,NP1,"NP1 9JB, NP1 9JF, NP1 9JR, NP10 8HY, NP10 8JE, NP10 8JN, NP10 8JS, NP10 8JT",255,239,16
W00008507,NP1,"NP1 9JG, NP1 9JH, NP1 9JJ, NP1 9JL, NP1 9LS, NP1 9LU, NP10 8JB, NP10 8JG, NP10 8JH, NP10 8JJ, NP10 8JL, NP10 8JP, NP10 8JQ, NP10 8JR",257,242,15
W00007242,NP1,"NP1 4EP, NP1 4ER, NP1 4ES, NP1 4EU, NP1 4EX, NP1 4LH, NP1 4NB, NP1 4QP, NP1 4QQ, NP1 4QS, NP1 4QT, NP1 4QU, NP1 4RF, NP1 4RG, NP1 4RL, NP1 4RN, NP1 4XJ, NP1 4YA, NP1 4YD, NP1 4YQ, NP1 4YS, NP1 4YU, NP11 4EP, NP11 4EQ, NP11 4ES, NP11 4ET, NP11 4EU, NP11 4EX, NP11 4EZ, NP11 4FH, NP11 4LS, NP11 4LU, NP11 4LW, NP11 4QH, NP11 4RL, NP11 4RN",339,306,33
W00008508,NP1,"NP1 8UU, NP1 8UW, NP1 8UX, NP1 8UY, NP1 8UZ, NP1 9LG, NP1 9RP, NP1 9RR, NP1 9RS, NP1 9RT, NP1 9RW, NP1 9YF, NP10 8GP, NP10 8GU, NP10 8GW, NP10 8GX, NP10 8GY, NP10 8GZ, NP10 8RP, NP10 8RQ, NP10 8RR, NP10 8RS, NP10 8RT, NP10 8RW, NP10 8YF",197,184,13
W00007241,NP1,"NP1 4EQ, NP1 4XD, NP1 5FA, NP1 5FB, NP1 5FD, NP1 5FE, NP1 5FF, NP1 5FG, NP1 5FH, NP1 5FJ, NP1 5FL, NP1 5FN, NP1 5FP, NP1 5FQ, NP1 5FS, NP1 5FT, NP1 5FU, NP1 5FX, NP1 5GA, NP11 4ER, NP11 4GN, NP11 4XD, NP11 5FA, NP11 5FB, NP11 5FD, NP11 5FE, NP11 5FF, NP11 5FG, NP11 5FH, NP11 5FJ, NP11 5FL, NP11 5FN, NP11 5FP, NP11 5FQ, NP11 5FR, NP11 5FS, NP11 5FT, NP11 5GA, NP11 5GH",294,260,34
W00009863,NP1,"NP1 9RD, NP1 9TJ, NP1 9TR, NP1 9TS, NP1 9TT, NP1 9TX, NP1 9TY, NP1 9UA, NP1 9UB, NP1 9UD, NP1 9US, NP1 9UT, NP1 9UU, NP1 9YE, NP10 8AR, NP10 8AT, NP10 8BA, NP10 8BB, NP10 8BD, NP10 8DE, NP10 8FE, NP10 8FQ, NP10 8FY, NP10 8FZ, NP10 8HH, NP10 8QQ, NP10 8QR, NP10 8SB, NP10 8TF, NP10 8TJ, NP10 8TL, NP10 8TP, NP10 8TQ, NP10 8TR, NP10 8TT, NP10 8TU, NP10 8TW, NP10 8TX, NP10 8TY, NP10 8UD, NP10 8UG, NP10 8UH, NP10 8XG, NP10 8XT, NP9 1TB, NP9 1XG, NPT 1TB, NPT 1XF, NPT 1XG",311,290,21
W00008509,NP1,"NP1 9LB, NP1 9LD, NP1 9LE, NP1 9LF, NP1 9NA, NP1 9NB, NP1 9ND, NP1 9NE, NP1 9NF, NP1 9NG, NP1 9NH, NP1 9NJ, NP1 9NL, NP1 9RE, NP1 9XQ, NP1 9ZA, NP1 9ZB, NP1 9ZE, NP1 9ZF, NP1 9ZG, NP1 9ZH, NP1 9ZL, NP10 8AQ, NP10 8BS, NP10 8BT, NP10 8BU, NP10 8FX, NP10 8LD, NP10 8LE, NP10 8LF, NP10 8LY, NP10 8LZ, NP10 8NB, NP10 8ND, NP10 8NF, NP10 8NG, NP10 8NH, NP10 8NJ, NP10 8RD, NP10 8RE",419,380,39
W00007240,NP1,"NP1 4AA, NP1 4AB, NP1 4QR, NP1 4QW, NP1 4QX, NP1 4QZ, NP1 4RA, NP1 4RB, NP1 4RD, NP1 4XA, NP1 4XY, NP1 4YL, NP1 4YT, NP11 3YF, NP11 4AH, NP11 4QP, NP11 4QQ, NP11 4QS, NP11 4QW, NP11 4QZ, NP11 4RA, NP11 4RB, NP11 4RE, NP11 4YE, NP11 4YF, NP11 4YJ, NP11 4YU, NP11 4ZB, NP11 4ZQ, NP11 4ZS, NP11 5YA, NP11 5YF, NP11 5YG, NP11 5YH, NP11 7YF, NP11 7YG, NP11 7YL",330,299,31
W00008606,NP1,"NP1 9SH, NP1 9SJ, NP1 9SL, NP1 9SQ, NP1 9ST, NP1 9SU, NP1 9SX, NP1 9SY, NP1 9SZ, NP1 9TA, NP10 8SF, NP10 8SH, NP10 8SL, NP10 8ST, NP10 8SU",339,324,15
W00009867,NP1,"NP1 9ET, NP1 9EU, NP10 9ET, NP10 9LG, NP10 9LJ, NP10 9LN, NP10 9LP, NP10 9LQ",457,408,49
W00007485,NP1,"NP1 7AR, NP1 7AW, NP1 7AX, NP1 7HX, NP11 7BJ, NP11 7HP, NP11 7HQ, NP11 7HR, NP11 7HS, NP11 7HT, NP11 7HU, NP11 7HW, NP11 7HX",265,236,29
W00007243,NP1,"NP1 4ET, NP1 4EW, NP1 4EY, NP1 4EZ, NP1 4FA, NP1 4FF, NP1 4FG, NP1 4FH, NP1 4FL, NP1 4GD, NP1 5RD, NP11 4FA, NP11 4FD, NP11 4FG, NP11 4FL, NP11 4FN, NP11 4GD, NP11 4XB",278,246,32
W00009869,NP1,"NP1 9TH, NP1 9TW, NP1 9XA, NP1 9XB, NP1 9YS, NP1 9YW, NP10 8AB, NP10 8AD, NP10 8AE, NP10 8AF, NP10 8AG, NP10 8AH, NP10 8AJ, NP10 8AL, NP10 8AN, NP10 8AP, NP10 8TE, NP10 8YS, NP10 8YW",333,287,46
W00008495,NP1,"NP1 9JN, NP1 9LQ, NP1 9LR, NP1 9LT, NP1 9PJ, NP1 9PN, NP1 9PQ, NP1 9PW, NP1 9QB, NP1 9QD, NP1 9QQ, NP10 8JF, NP10 8LJ, NP10 8LQ, NP10 8LS, NP10 8LT, NP10 8LU, NP10 8PJ",313,285,28
W00008493,NP1,"NP1 9QF, NP1 9QG, NP1 9QH, NP1 9QJ, NP1 9QL, NP1 9QN, NP1 9QP, NP1 9QR, NP1 9QS, NP1 9QT, NP1 9QU, NP1 9QW, NP1 9QY, NP1 9QZ, NP1 9RH, NP1 9RJ, NP1 9RQ, NP1 9RY, NP10 8QS, NP10 8QW, NP10 8RH, NP10 8RJ, NP10 8RX, NP10 8RY, NP10 8UA, NP10 8UN, NP10 8UY",372,331,41
W00010620,NP1,"NP1 2LT, NP18 2BL, NP18 2LT, NP18 2LU, NP18 2NL, NP18 2QJ",311,293,18
W00007336,NP1,"NP1 4HH, NP12 2AA, NP12 2AB, NP12 2AD, NP12 2AN, NP12 2AP, NP12 2AX, NP12 2BJ, NP12 2DG, NP12 2DH, NP12 2DN, NP12 2DS, NP12 2FQ, NP12 2FR, NP12 2FX, NP12 2GX, NP12 2LD, NP12 2LT, NP12 2LY, NP12 2XF, NP12 2YD, NP12 2YE, NP12 2YL, NP12 2YN, NP12 2YT, NP2 2AA, NP2 2AB, NP2 2AD, NP2 2AN, NP2 2AP, NP2 2AW, NP2 2BJ, NP2 2DH, NP2 2DN, NP2 2DR, NP2 2XF, NP2 2XN, NP2 2YB, NP2 2YD, NP2 2YE",501,457,44
W00010565,NP1,"NP1 9EH, NP1 9HG, NP1 9XJ, NP1 9XP, NP1 9XR, NP1 9XT, NP1 9XX, NP1 9XY, NP1 9YB, NP1 9YL, NP1 9YQ, NP1 9YZ, NP1 9ZJ, NP1 9ZN, NP1 9ZP, NP1 9ZQ, NP1 9ZR, NP1 9ZS, NP1 9ZT, NP1 9ZU, NP1 9ZW, NP1 9ZY, NP10 9EQ, NP10 9ER, NP10 9FQ, NP10 9NB, NP10 9QA, NP10 9XJ, NP10 9XP, NP10 9YB, NP10 9YJ, NP10 9YL, NP10 9YN, NP10 9ZJ",327,309,18
W00010557,NP1,"NP1 9WD, NP1 9WE, NP10 8WN",345,274,71
W00010555,NP1,"NP1 9NP, NP1 9NQ, NP1 9NR, NP1 9PG, NP10 8FL, NP10 8NL, NP10 8NN, NP10 8NQ, NP10 8NR, NP10 8NS, NP10 8PG",271,252,19
W00010544,NP1,"NP1 9EG, NP1 9EP, NP1 9EQ, NP1 9ER, NP10 9ND, NP10 9NG, NP10 9NH, NP10 9NJ, NP10 9NS",336,302,34
W00007248,NP1,"NP1 4HG, NP1 4HJ, NP1 4HN, NP1 4HQ, NP1 4HS, NP1 4HW, NP11 4AJ, NP11 4GJ, NP11 4HG, NP11 4HH, NP11 4HN, NP11 4HR, NP11 4HS, NP11 4HX, NP11 4HY, NP12 2AY",306,283,23
W00010527,NP1,"NP1 9BA, NP1 9BB, NP1 9BD, NP1 9BE, NP1 9BF, NP1 9GX, NP1 9GY, NP1 9GZ, NP1 9HA, NP1 9HB, NP1 9HD, NP1 9HE, NP1 9YX, NP10 9BE, NP10 9BF, NP10 9EJ, NP10 9GT, NP10 9GU, NP10 9GW, NP10 9GX, NP10 9GY, NP10 9GZ, NP10 9HA, NP10 9HB, NP10 9HD, NP10 9HE, NP10 9HQ, NP10 9HR, NP10 9HS, NP10 9HT, NP10 9PZ, NP10 9YX, NP10 9YY, NP10 9ZA",259,243,16
W00010512,NP1,"NP1 9XL, NP10 8AZ, NP10 8BG, NP10 8BH, NP10 8BJ, NP10 8BL, NP10 8BN, NP10 8UX, NP10 8YE",298,271,27
W00008494,NP1,"NP1 9JU, NP1 9JW, NP1 9RF, NP10 8JX, NP10 8JY, NP10 8RF",158,148,10
W00010511,NP1,"NP1 9EJ, NP1 9EL, NP1 9EN, NP1 9YJ, NP10 9EL, NP10 9LR, NP10 9NF, NP10 9NP, NP10 9NZ, NP10 9PE, NP10 9PR, NP10 9YD",308,275,33
W00007247,NP1,"NP1 4EL, NP1 4EN, NP1 4HP, NP1 4HR, NP1 4HU, NP1 4HX, NP11 4EN, NP11 4HP, NP11 4HQ, NP11 4HT, NP11 4HU, NP12 2AW",332,310,22
W00007655,NP1,"NP1 5EA, NP1 5EB, NP1 5ED, NP1 5EF, NP1 5HR, NP11 5EB, NP11 5ED, NP11 5EE, NP11 5EF, NP11 5EG",287,271,16
W00007654,NP1,"NP1 5EE, NP1 5EX, NP1 5HJ, NP1 5HL, NP1 5HQ, NP1 5HT, NP1 5HU, NP1 5HW, NP11 5EJ, NP11 5EL, NP11 5EX, NP11 5EZ, NP11 5HT, NP11 5HU",300,289,11
W00007653,NP1,"NP1 5DU, NP1 5DW, NP1 5DX, NP1 5DY, NP1 5DZ, NP1 5HX, NP1 5HY, NP11 5DU, NP11 5DW, NP11 5DX, NP11 5DY, NP11 5DZ, NP11 5EA, NP11 5HS, NP11 5HX, NP11 5HY, NP13 2JL, NP3 2JT",331,306,25
W00007652,NP1,"NP1 5EH, NP1 5EJ, NP1 5EL, NP11 5EH, NP11 5HJ, NP11 5HP, NP11 5HW",250,239,11
W00007651,NP1,"NP1 5HN, NP1 5HP, NP1 5HS, NP11 5HL, NP11 5HN, NP11 5HQ, NP11 5HR",229,207,22
W00007487,NP1,"NP1 7HY, NP1 7HZ, NP11 7HA, NP11 7HB, NP11 7HH, NP11 7HY",301,274,27
W00007486,NP1,"NP1 7AP, NP1 7GT, NP1 7GU, NP1 7GW, NP1 7HF, NP1 7HG, NP1 7HN, NP11 7AW, NP11 7AX, NP11 7GN, NP11 7GT, NP11 7GU, NP11 7GW, NP11 7GX, NP11 7GZ, NP11 7HF, NP11 7HG, NP11 7HN",306,287,19
W00007246,NP1,"NP1 4FB, NP1 4FD, NP1 4FE, NP1 4GE, NP1 4GG, NP11 4AG, NP11 4EW, NP11 4EY, NP11 4FB, NP11 4FE, NP11 4FF, NP11 4GE, NP11 4GF, NP11 4GG, NP11 4XA",249,231,18
W00008039,NP1,"NP1 5BN, NP1 5BP, NP1 5BQ, NP1 5BR, NP11 5BN, NP11 5BP, NP11 5BQ, NP11 5BR, NP4 6ER, NP4 6TY, NP4 6UA, NP4 6UD, NP4 6UE, NP4 6UH, NP4 6UJ",161,149,12
W00008668,NP1,"NP1 9AA, NP1 9AB, NP1 9AE, NP1 9BG, NP10 9AA, NP10 9AB, NP10 9BG, NP10 9BQ, NP9 3SG, NP9 3SH, NP9 3SJ, NPT 3SH, NPT 3SJ",278,266,12
W00007239,NP1,"NP1 5DA, NP1 5DD, NP1 5DE, NP1 5DQ, NP1 5GE, NP11 5BX, NP11 5BY, NP11 5BZ, NP11 5DA, NP11 5DQ, NP11 5FW, NP11 5FZ",252,222,30
W00007484,NP1,"NP1 7JA, NP1 7JB, NP1 7JF, NP1 7JG, NP1 7JH, NP1 7JU, NP1 7JW, NP1 7JY, NP1 7JZ, NP1 7LL, NP11 7JE, NP11 7JF, NP11 7JG, NP11 7JH, NP11 7JX, NP11 7JY, NP11 7LJ, NP11 7LL",275,254,21
W00010309,NP1,"NP1 4DX, NP1 4DY, NP1 4XH, NP1 4XP, NP11 3AJ, NP11 3BR, NP11 3BS, NP11 3LA",119,100,19
W00007121,NP1,"NP1 4HZ, NP1 4JA, NP1 4JB, NP1 4JD, NP1 4JE, NP1 4JF, NP1 4JG, NP11 3HZ, NP11 3JA, NP11 3JB, NP11 3JD, NP11 3JF, NP11 3JG",239,221,18
W00007100,NP1,"NP1 7AL, NP1 7AN, NP1 7PF, NP1 7PH, NP1 7PP, NP1 7PQ, NP1 7PR, NP1 7PS, NP1 7PY, NP1 7PZ, NP1 7QA, NP1 7QB, NP11 7PP, NP11 7PQ, NP11 7PR, NP11 7PS, NP11 7PW, NP11 7PY, NP11 7PZ, NP11 7QA, NP11 7RD, NP2 6YE",329,300,29
W00007398,NP1,"NP1 6FR, NP1 6FT, NP1 6FU, NP11 6FE, NP11 6FF, NP11 6FH, NP11 6FJ, NP11 6FR, NP11 6FS, NP11 6FT, NP11 6FU, NP11 6HD",258,223,35
W00007397,NP1,"NP1 6FA, NP1 6FE, NP1 6FF, NP1 6FG, NP1 6FL, NP1 6FN, NP1 6HB, NP11 6FA, NP11 6FD, NP11 6FG, NP11 6GD, NP11 6GE, NP11 6GF, NP11 6HB, NP11 6HE",173,166,7
W00007396,NP1,"NP1 6GU, NP1 6GX, NP1 6YF, NP11 6GG, NP11 6GJ, NP11 6GX, NP11 6HF, NP11 6YF, NP11 6YS, NP11 6ZR, NP11 7AB, NP11 7AD, NP11 7AS",282,261,21
W00007395,NP1,"NP1 6DP, NP1 6DR, NP1 6GJ, NP1 6HA, NP1 7AA, NP1 7AB, NP1 7AD, NP1 7AE, NP1 7AF, NP1 7AG, NP1 7AH, NP1 7NW, NP11 6DR, NP11 6HA, NP11 7AA, NP11 7AE, NP11 7AF, NP11 7AH, NP11 7AP, NP11 7AR, NP11 7NU, NP11 7NW",320,289,31
W00007394,NP1,"NP1 6FP, NP1 6FQ, NP1 6FS, NP1 6FW, NP1 6FX, NP1 6GW, NP1 6GY, NP11 6AJ, NP11 6FL, NP11 6FN, NP11 6FP, NP11 6FQ, NP11 6FW, NP11 6FX, NP11 6GS, NP11 6GT, NP11 6GU, NP11 6GW, NP11 6HG",281,268,13
W00007393,NP1,"NP1 6BD, NP1 6EA, NP1 6EB, NP1 6ED, NP1 6EE, NP1 6EH, NP1 6EJ, NP1 6EL, NP1 6EN, NP1 6EP, NP1 6EQ, NP1 6ES, NP1 6LU, NP1 6LW, NP1 6LX, NP1 6LY, NP1 6NB, NP1 6ND, NP1 6NF, NP1 6NL, NP1 6NN, NP1 6NP, NP1 6NR, NP1 6YD, NP1 6YP, NP11 6EA, NP11 6EE, NP11 6EH, NP11 6EJ, NP11 6EL, NP11 6EN, NP11 6EP, NP11 6EQ, NP11 6ES, NP11 6EU, NP11 6EW, NP11 6EX, NP11 6EY, NP11 6LW, NP11 6NP, NP11 6NR, NP11 6YD",360,330,30
W00010290,NP1,"NP1 4AP, NP1 4AU, NP1 4AX, NP1 4BE, NP1 4BG, NP1 4BU, NP1 4BW, NP1 4EF, NP1 4EG, NP1 4EH, NP1 4XT, NP1 4XX, NP1 4YF, NP11 3AN, NP11 3BE, NP11 3BG, NP11 3BU, NP11 3BW, NP11 3EH, NP11 3EN, NP11 3GJ, NP11 3GQ, NP11 3GR, NP11 3HY, NP11 3XT, NP11 3XX, NP11 4EA, NP11 4EG",491,447,44
W00008654,NP1,"NP1 0AD, NP1 0AP, NP1 0AT, NP1 0AU, NP1 0BE, NP1 0BH, NP1 0BN, NP10 0AA, NP10 0AL, NP10 0AP, NP10 0AS, NP10 0ED, NP10 1AD, NP10 1AP, NP10 1AT, NP10 1AU, NP10 1BE, NP10 1BH",279,261,18
W00008657,NP1,"NP1 9AS, NP1 9AT, NP1 9AU, NP1 9AX, NP1 9AY, NP1 9AZ, NP1 9FD, NP1 9FE, NP1 9FF, NP10 9FE, NP10 9FF, NP10 9FW, NP10 9SX, NP10 9SY, NP10 9XS, NP10 9XU, NP10 9XX",312,294,18
W00007120,NP1,"NP1 4JJ, NP1 4JL, NP11 3JE, NP11 3JH, NP11 3JJ, NP11 3JN",316,284,32
W00008659,NP1,"NP1 0AE, NP1 0AG, NP1 0AH, NP1 0AN, NP1 0AQ, NP1 0AR, NP1 0AS, NP1 0XA, NP1 0XE, NP1 9AR, NP10 0AE, NP10 0AG, NP10 0AH, NP10 0AN, NP10 0AQ, NP10 1AE, NP10 1AG, NP10 1AH, NP10 1AN, NP10 1AQ, NP10 1AR, NP10 1AS, NP10 9AQ, NP10 9AR, NP10 9AS, NP10 9HH",256,237,19
W00008660,NP1,"NP1 9EW, NP1 9EX, NP1 9FJ, NP10 9EX, NP10 9EY, NP10 9EZ, NP10 9FH, NP10 9FR",273,246,27
W00008661,NP1,"NP1 9EF, NP1 9ES, NP1 9FH, NP10 9EU, NP10 9EW, NP10 9FJ, NP10 9FN, NP10 9FP",216,199,17
W00008662,NP1,"NP1 0DN, NP1 9AF, NP1 9AG, NP1 9AH, NP1 9AJ, NP1 9AL, NP1 9AN, NP1 9AP, NP1 9AQ, NP1 9AW, NP10 1DN, NP10 9AF, NP10 9AH, NP10 9AJ, NP10 9AL, NP10 9AN, NP10 9AP, NP10 9LW",358,331,27
W00008663,NP1,"NP1 0AW, NP1 0BJ, NP1 0BY, NP1 0DB, NP1 0DD, NP1 0DE, NP1 0DF, NP1 0DL, NP10 0BJ, NP10 0BQ, NP10 0BW, NP10 0BX, NP10 0BY, NP10 0DE, NP10 1AW, NP10 1BJ, NP10 1BY, NP10 1DB, NP10 1DD, NP10 1DE, NP10 1DF, NP10 1DL",203,193,10
W00008665,NP1,"NP1 0AA, NP1 0BP, NP1 0BS, NP1 0BT, NP1 0BU, NP1 0BX, NP1 0DW, NP1 0XB, NP1 0XD, NP1 0XF, NP1 0XG, NP1 0YF, NP10 0BP, NP10 0BS, NP10 0BT, NP10 0BU, NP10 0DN, NP10 0YF, NP10 1AA, NP10 1BP, NP10 1BS, NP10 1BT, NP10 1BU, NP10 1BX, NP10 1DW, NP10 1ED, NP10 1YD, NP10 1YF",286,264,22
W00008666,NP1,"NP1 9EY, NP1 9EZ, NP1 9FA, NP1 9FB, NP1 9FG, NP1 9FL, NP1 9FN, NP1 9FP, NP1 9FQ, NP1 9FW, NP10 9FA, NP10 9FB, NP10 9FD, NP10 9FG, NP10 9FL",309,288,21
W00008656,NP1,"NP1 0BG, NP1 0BL, NP1 0BQ, NP1 0BW, NP1 9GP, NP10 0AD, NP10 0BD, NP10 0BE, NP10 0BG, NP10 0BH, NP10 0BL, NP10 1BG, NP10 1BL, NP10 1BQ, NP10 1BW, NP10 9GP, NP10 9GQ, NP10 9HW, NP10 9LH, NP10 9US",347,324,23
W00007238,NP1,"NP1 4GL, NP1 4RE, NP1 4RH, NP1 4RQ, NP11 3RH, NP11 4NB, NP11 4ND, NP11 4NE, NP11 4NN, NP11 4NU, NP11 4RF, NP11 4RG, NP11 4RH, NP11 4RQ, NP11 4RR",280,269,11
W00007477,NP1,"NP1 7JJ, NP1 7JL, NP1 7JN, NP1 7JP, NP1 7JQ, NP1 7JS, NP1 7JT, NP1 7YF, NP11 7JA, NP11 7JJ, NP11 7JL, NP11 7JN, NP11 7JP, NP11 7JS, NP11 7JT, NP11 7JU, NP11 7JW",279,259,20
W00007478,NP1,"NP1 7GX, NP1 7GY, NP1 7GZ, NP1 7HA, NP1 7HB, NP1 7HD, NP1 7HE, NP1 7HH, NP1 7HJ, NP1 7HL, NP1 7HP, NP1 7HQ, NP1 7HR, NP1 7HS, NP1 7HT, NP1 7HU, NP1 7HW, NP1 7JX, NP1 7YG, NP11 7BN, NP11 7GY, NP11 7HD, NP11 7HE, NP11 7HJ, NP11 7HL, NP11 7JD, NP11 7NR",437,399,38
W00007483,NP1,"NP1 7JR, NP1 7LA, NP1 7LB, NP1 7LE, NP1 7LF, NP1 7LG, NP1 7LH, NP1 7LJ, NP1 7LN, NP11 7JQ, NP11 7JR, NP11 7JZ, NP11 7LA, NP11 7LB, NP11 7LE, NP11 7LF, NP11 7LG, NP11 7LH, NP11 7LN",391,361,30
W00009875,NP1,"NP1 9WT, NP10 8BX, NP10 8DB, NP10 8DD, NP10 8DZ, NP10 8EX, NP10 8EY, NP10 8EZ, NP10 8YD",294,265,29
W00009877,NP1,"NP1 9WU, NP1 9WW, NP10 8WU, NP10 8WW",266,247,19
W00007482,NP1,"NP1 7AY, NP1 7AZ, NP1 7BA, NP1 7BB, NP1 7BE, NP1 7BG, NP1 7LD, NP11 7AU, NP11 7AY, NP11 7BA, NP11 7BB, NP11 7BE, NP11 7BG, NP11 7LD, NP12 2BQ, NP12 2HL, NP12 2HU, NP12 2HW, NP12 2JB, NP2 2BG, NP2 2BL, NP2 2JA, NP2 2JB",245,224,21
W00007481,NP1,"NP1 7PT, NP1 7PU, NP1 7QQ, NP1 7QR, NP1 7QU, NP1 7QW, NP1 7QX, NP1 7QY, NP1 7QZ, NP1 7RA, NP1 7YB, NP1 7YD, NP1 7YJ, NP1 7YQ, NP11 7HZ, NP11 7JB, NP11 7NY, NP11 7PT, NP11 7PU, NP11 7QS, NP11 7QT, NP11 7QU, NP11 7QW, NP11 7QX, NP11 7QY, NP11 7QZ, NP11 7RA, NP11 7RE, NP11 7YB, NP11 7YD",434,388,46
W00009880,NP1,"NP1 9GB, NP1 9GD, NP10 9GB, NP10 9GD, NP10 9JN, NP10 9JR, NP10 9JZ",364,326,38
W00007237,NP1,"NP1 5DB, NP1 5DF, NP1 5DG, NP1 5DH, NP1 5DJ, NP11 5DB, NP11 5DD, NP11 5DE, NP11 5DF, NP11 5DG, NP11 5DH, NP11 5DR",308,285,23
W00009882,NP1,"NP1 9WS, NP10 8WR, NP10 8WS, NP10 8WT",356,319,37
W00009883,NP1,"NP1 9TL, NP1 9TN, NP1 9TP, NP1 9TU, NP10 8AS, NP10 8BE, NP10 8FS, NP10 8HT, NP10 8HU, NP10 8HX, NP10 8TN, NP10 8TS, NP10 8UJ, NP10 8UL, NP10 8UW, NP10 8ZW, NP10 8ZY",309,277,32
W00007122,NP1,"NP1 4JN, NP1 4JQ, NP1 4JT, NP1 4JZ, NP11 3JL, NP11 3JP, NP11 3JQ, NP11 3JT, NP11 3JU, NP11 3JY, NP11 3JZ",305,289,16
W00007236,NP1,"NP1 4AD, NP1 4AE, NP1 4AF, NP1 4QY, NP11 4AD, NP11 4AE, NP11 4QR, NP11 4QT, NP11 4QU, NP11 4QX, NP11 4QY, NP11 4YD",281,251,30
W00007480,NP1,"NP1 7BD, NP1 7PW, NP1 7PX, NP1 7QD, NP1 7QE, NP1 7QF, NP1 7QG, NP1 7QH, NP1 7QN, NP1 7RB, NP1 7YA, NP1 7YE, NP1 7YH, NP11 7BD, NP11 7BP, NP11 7PX, NP11 7QD, NP11 7QE, NP11 7QF, NP11 7QG, NP11 7QH, NP11 7QN, NP11 7RF",254,234,20
W00007234,NP1,"NP1 5DN, NP1 5LR, NP1 5LS, NP1 5LT, NP1 5LU, NP1 5LZ, NP11 5DN, NP11 5DP, NP11 5LR, NP11 5LS, NP11 5LT, NP11 5LZ, NP2 1PQ",274,249,25
W00007233,NP1,"NP1 5LP, NP1 5LW, NP1 5LY, NP1 5YJ, NP11 5LP, NP11 5LU, NP11 5LW, NP11 5LX, NP11 5LY",297,283,14
W00007479,NP1,"NP1 7QJ, NP1 7QL, NP1 7QP, NP1 7QS, NP1 7QT, NP11 7NZ, NP11 7QJ, NP11 7QL, NP11 7QP, NP11 7QQ, NP11 7QR, NP11 7RB",365,334,31
W00007232,NP1,"NP1 4GT, NP1 4HB, NP1 4HD, NP1 4HE, NP1 4HF, NP1 4NE, NP11 4EL, NP11 4HE, NP11 4HF, NP11 4HW, NP11 4HZ",302,279,23
W00007231,NP1,"NP1 4FT, NP1 4GF, NP1 4GH, NP1 4GJ, NP1 4GU, NP1 4GW, NP1 4GX, NP1 4GY, NP1 4GZ, NP1 4HL, NP1 4NT, NP1 4XB, NP1 4XE, NP1 5YA, NP1 5YD, NP1 5YG, NP11 3GY, NP11 4GL, NP11 4GT, NP11 4GU, NP11 4GW, NP11 4GX, NP11 4GY, NP11 4GZ, NP11 4HA, NP11 4HB, NP11 4HD, NP11 4HJ, NP11 4HL, NP11 4NG, NP11 4NP, NP11 4NQ, NP11 5GP, NP12 2BA, NP12 2BD",561,511,50
W00007230,NP1,"NP1 4FJ, NP1 4FN, NP1 4LU, NP1 4LW, NP1 4LX, NP1 4NA, NP11 4FJ, NP11 4FP, NP11 4FQ, NP11 4FR, NP11 4FS, NP11 4FU, NP11 4FW, NP11 4FX, NP11 4GS, NP11 4LX, NP11 4YA, NP11 4YG, NP11 4YQ",261,244,17
W00007229,NP1,"NP1 5BY, NP1 5BZ, NP1 5FW, NP1 5FY, NP1 5FZ, NP1 5GB, NP1 5GD, NP11 5AN, NP11 5AW, NP11 5FU, NP11 5FX, NP11 5FY, NP11 5GB, NP11 5GD",254,227,27
W00009922,NP1,"NP1 5AA, NP1 5JH, NP1 5JN, NP1 5LH, NP11 5AT, NP11 5GL, NP11 5JL, NP11 5LH",247,211,36
W00009924,NP1,"NP1 4SZ, NP1 4TA, NP1 5AG, NP1 7NL, NP1 7NN, NP1 7NP, NP1 7NQ, NP1 7NR, NP11 4SY, NP11 4SZ, NP11 4TA, NP11 4TB, NP11 5AG, NP11 7BQ, NP11 7NN, NP11 7NP, NP11 7NQ, NP12 2BE, NP12 2BF, NP2 2BD, NP2 2BE, NP2 2BF",271,227,44
W00007235,NP1,"NP1 5AY, NP1 5DL, NP1 5DP, NP1 5GF, NP1 5GG, NP1 5LX, NP1 5YE, NP1 5YF, NP1 5YH, NP11 5AY, NP11 5BU, NP11 5DJ, NP11 5DL, NP11 5GE, NP11 5GF, NP11 5YB, NP11 5YE",299,285,14
W00007101,NP1,"NP1 7DL, NP1 7GB, NP1 7GD, NP1 7GJ, NP1 7GL, NP11 7BL, NP11 7GA, NP11 7GB, NP11 7GD, NP11 7GJ, NP11 7GL",419,375,44
W00010619,NP10,"NP10 8AU, NP10 8AW, NP10 8AX, NP10 8AY",284,258,26
W00010606,NP10,"NP10 8FN, NP10 8FP, NP10 8FR, NP10 8FT, NP10 8GN, NP10 8NP",271,247,24
W00010621,NP10,"NP10 9PB, NP10 9PD, NP10 9PF, NP10 9PG, NP10 9PH, NP10 9PJ, NP10 9PL",299,264,35
W00009888,NP10,"NP10 9BB, NP10 9JB, NP10 9JE, NP10 9JL, NP10 9JT",320,295,25
W00009887,NP10,"NP10 8EA, NP10 8EB, NP10 8ED, NP10 8EE, NP10 8EF, NP10 8EL",192,174,18
W00009885,NP10,"NP10 8HG, NP10 8HJ, NP10 8HL, NP10 8HN, NP10 8HP, NP10 8HQ",305,285,20
W00009884,NP10,"NP10 8GQ, NP10 8GT, NP10 8HD, NP10 8HE, NP10 8HF, NP10 8SX",224,199,25
W00009881,NP10,"NP10 9LA, NP10 9LB, NP10 9LD, NP10 9LE, NP10 9LF, NP10 9LL, NP10 9LU",382,329,53
W00009872,NP10,"NP10 8DA, NP10 8ER, NP10 8ES, NP10 8EU, NP10 8EW",301,268,33
W00008510,NP10,"NP10 9AY, NP10 9AZ, NP10 9BA, NP10 9BD, NP10 9SD",319,295,24
W00009861,NP10,"NP10 8EP, NP10 8EQ, NP10 8ET, NP10 8WD",324,280,44
W00009890,NP10,"NP10 8EG, NP10 8EH, NP10 8EJ, NP10 8EN, NP10 8HR, NP10 8HS",261,235,26
W00009859,NP10,"NP10 9GA, NP10 9JP, NP10 9JQ, NP10 9JS, NP10 9LS, NP10 9LT, NP10 9LZ",368,319,49
W00009856,NP10,"NP10 8HA, NP10 8HB, NP10 8SZ, NP10 8UB",228,211,17
W00008500,NP10,"NP10 8PL, NP10 8PS, NP10 8PT, NP10 8PX, NP10 8PY",298,270,28
W00008486,NP10,"NP10 8YH, NP20 3FS, NP20 3FU, NP20 3FW, NP20 3HL, NP9 3FS, NP9 3FT, NP9 3FU, NPT 3FS, NPT 3FT, NPT 3FU",231,222,9
W00008345,NP10,"NP10 0WF, NP10 0YB, NP10 0YD, NP10 8FD, NP10 8FU, NP10 8FW, NP10 8QD, NP10 8QX, NP10 8SW, NP10 8UT, NP10 8UU, NP10 8UZ, NP10 8WB, NP10 8XA, NP10 8XJ, NP10 8XN, NP10 8XP, NP10 8XQ, NP10 8XR, NP10 8XU, NP10 8XW, NP10 8XX, NP10 8XY, NP10 8XZ, NP10 8YA, NP10 8YB, NP10 8YG, NP10 8YL, NP10 8YN, NP10 8YP, NP10 8YQ, NP10 8YR, NP10 8YT, NP10 8YU, NP10 8YX, NP10 8YY, NP10 8YZ, NP10 8ZA, NP10 8ZB, NP10 8ZD, NP10 8ZE, NP10 8ZF, NP10 8ZG, NP10 8ZH, NP10 8ZJ, NP10 8ZL, NP10 8ZN, NP10 8ZP, NP10 8ZQ, NP10 8ZR, NP10 8ZS, NP10 8ZT, NP10 8ZX, NP10 9WQ, NP10 9WU, NP10 9WW, NP10 9WX, NP10 9WY, NP10 9WZ, NP10 9XL, NP10 9XQ, NP10 9XZ, NP10 9YE, NP10 9YF, NP10 9YG, NP10 9YH, NP10 9YP, NP10 9YQ, NP10 9YR, NP10 9YS, NP10 9YT, NP10 9YW, NP10 9ZD, NP10 9ZP, NP10 9ZQ, NP10 9ZR, NP10 9ZU, NP20 1AR, NP20 1US, NP20 1WE, NP20 1WH, NP20 1WQ, NP20 1WS, NP20 1WY, NP20 1WZ, NP20 1XN, NP20 1YB, NP20 1YE, NP20 1YF, NP20 1YG, NP20 1YP, NP20 1ZB, NP20 1ZR, NP20 2WX, NP20 2WY, NP20 2YA, NP20 2YB, NP20 2YF, NP20 2YH, NP20 2YJ, NP20 2YL, NP20 2YQ, NP20 2YR, NP20 2YS, NP20 2YU, NP20 2YX, NP20 2YZ, NP20 2ZU, NP20 2ZW, NP20 3WZ, NP20 3XQ, NP20 3XR, NP20 3YB, NP20 3YD, NP20 3YE, NP20 3YG, NP20 3YH, NP20 3YL, NP20 3YN, NP20 3YP, NP20 3YQ, NP20 3YR, NP20 3YT, NP20 3YU, NP20 3YY, NP20 3YZ, NP20 3ZX, NP20 4WJ, NP20 4WX, NP20 4WY, NP20 4WZ, NP20 4XN, NP20 4XP, NP20 4XQ, NP20 4XR, NP20 4XU, NP20 4XW, NP20 4XX, NP20 4XY, NP20 4XZ, NP20 4YA, NP20 4YB, NP20 4YD, NP20 4YF, NP20 4YG, NP20 4YH, NP20 4YJ, NP20 4YN, NP20 4YQ, NP20 4YR, NP20 4YT, NP20 4YU, NP20 4YW, NP20 4YY, NP20 4YZ, NP20 4ZA, NP20 4ZD, NP20 4ZE, NP20 4ZS, NP20 4ZU, NP20 4ZX, NP20 5FA, NP20 5FB, NP20 5FD, NP20 5FE, NP20 5HA, NP20 5HJ, NP20 5HL, NP20 5WB, NP20 5WU, NP20 5WW, NP20 5WY, NP20 5XN, NP20 5XP, NP20 5XR, NP20 5XU, NP20 5XX, NP20 5XY, NP20 5XZ, NP20 5YD, NP20 5YE, NP20 5YG, NP20 5YJ, NP20 5YP, NP20 5YQ, NP20 5YS, NP20 5YT, NP20 5YU, NP20 5YW, NP20 5ZA, NP20 5ZN, NP20 5ZP, NP20 5ZW, NP20 5ZX, NP20 6XU, NP20 6YA, NP20 6YF, NP20 6YH, NP20 6YJ, NP20 6YL, NP20 6YX, NP20 7WY, NP20 7WZ, NP20 7YD, NP20 7YE, NP20 7YF, NP20 7YU, NP20 7ZB, NP20 7ZR, NP20 7ZX, NP20 9AA, NP20 9AB, NP20 9AD, NP20 9AE, NP20 9AF, NP20 9AG, NP20 9AH, NP20 9AJ, NP20 9AL, NP20 9AN, NP20 9AP, NP20 9AQ, NP20 9AR, NP20 9AS, NP20 9AT, NP20 9AU, NP20 9AW, NP20 9AX, NP20 9AY, NP20 9AZ, NP20 9BA, NP20 9BB, NP20 9EW, NP20 9FB, NP20 9FD, NP20 9FE, NP20 9FF, NP20 9FG, NP20 9FH, NP20 9FJ, NP20 9FL, NP20 9FN, NP20 9FP, NP20 9FQ, NP20 9FR, NP20 9FS, NP20 9FT, NP20 9FU, NP20 9FW, NP20 9FX, NP20 9FY, NP20 9FZ, NP20 9GA, NP20 9GB, NP20 9GD, NP20 9GE, NP20 9GF, NP20 9GG, NP20 9GH, NP20 9GJ, NP20 9GL, NP20 9GP, NP20 9GQ, NP20 9GR, NP20 9GS, NP20 9GT, NP20 9GU, NP20 9GW, NP20 9GX, NP20 9GY, NP20 9GZ, NP20 9HA, NP20 9HB, NP20 9HD, NP20 9HE, NP20 9HF, NP20 9HG, NP20 9HH, NP20 9HJ, NP20 9HL, NP20 9HN, NP20 9HP, NP20 9HQ, NP20 9HR, NP20 9HS, NP20 9HT, NP20 9HU, NP20 9HW, NP20 9HX, NP20 9HY, NP20 9HZ, NP20 9JA, NP20 9JB, NP20 9JD, NP20 9JE, NP20 9JF, NP20 9JG, NP20 9JH, NP20 9JJ, NP20 9JL, NP20 9JN, NP20 9JP, NP20 9JQ, NP20 9JR, NP20 9JS, NP20 9JT, NP20 9JU, NP20 9JW, NP20 9JX, NP20 9JY, NP20 9JZ, NP20 9LA, NP20 9LB, NP20 9LD, NP20 9LE, NP20 9LF, NP20 9LG, NP20 9LH, NP20 9LJ, NP20 9LL, NP20 9LN, NP20 9LP, NP20 9LQ, NP20 9LR, NP20 9LS, NP20 9LT, NP20 9LU, NP20 9LW, NP20 9LX, NP20 9LY, NP20 9LZ, NP20 9NA, NP20 9NB, NP20 9ND, NP20 9NE, NP20 9NF, NP20 9NG, NP20 9NH, NP20 9NJ, NP20 9NL, NP20 9NN, NP20 9NP, NP20 9NQ, NP20 9NR, NP20 9NS, NP20 9NT, NP20 9NU, NP20 9NW, NP20 9NX, NP20 9NY, NP20 9NZ, NP20 9PA, NP20 9PB, NP20 9PD, NP20 9PE, NP20 9PF, NP20 9PG, NP20 9PH, NP20 9PJ, NP20 9PL, NP20 9PN, NP20 9PP, NP20 9PQ, NP20 9PR, NP20 9PS, NP20 9PT, NP20 9PU, NP20 9PW, NP20 9PX, NP20 9PY, NP20 9QA, NP20 9QB, NP20 9QD, NP20 9QE, NP20 9QF, NP20 9QG, NP20 9QH, NP20 9QJ, NP20 9QL, NP20 9QN, NP20 9QP, NP20 9QQ, NP20 9QS, NP20 9QT, NP20 9QU, NP20 9QW, NP20 9QX, NP20 9QY, NP20 9QZ, NP20 9RA, NP20 9RB, NP20 9RD, NP20 9RE, NP20 9RF, NP20 9RG, NP20 9RH, NP20 9RJ, NP20 9RL, NP20 9RN, NP20 9RP, NP20 9RQ, NP20 9RR, NP20 9RS, NP20 9RT, NP20 9RU, NP20 9RW, NP20 9RX, NP20 9RY, NP20 9RZ, NP20 9SD, NP20 9SE, NP20 9WZ, NP9 5FA, NP9 5FB, NP9 5FE, NP9 5HF, NP9 5HH, NP9 5HJ, NP9 5JE, NP9 5JF, NP9 5YL, NP9 5YW, NPT 1XD, NPT 5FA, NPT 5FB, NPT 5FE, NPT 5HH, NPT 5HJ, NPT 5JE, NPT 5JF, NPT 5XF, NPT 5XR, NPT 5YJ, NPT 5YL",291,269,22
W00010532,NP10,"NP10 9EN, NP10 9EP, NP10 9NE, NP10 9NN, NP10 9NQ, NP10 9NR, NP10 9NU, NP10 9NY",317,288,29
W00010566,NP10,"NP10 9NT, NP10 9NW, NP10 9NX, NP10 9PP, NP10 9PQ",366,318,48
W00010599,NP10,"NP10 9NA, NP10 9PT, NP10 9PU, NP10 9PW, NP10 9PX, NP10 9PY, NP10 9QB",271,254,17
W00010605,NP10,"NP10 8QE, NP10 8QF, NP10 8QH, NP10 8QJ, NP10 8QL, NP10 8QN, NP10 8QP",237,219,18
W00009858,NP10,"NP10 8GR, NP10 8HW, NP10 8SY, NP10 8UP, NP10 8UQ",267,242,25
W00009891,NP10,"NP10 9HZ, NP10 9JA, NP10 9JD, NP10 9JJ, NP10 9JW, NP10 9JX, NP10 9SA",325,284,41
W00009870,NP10,"NP10 8QG, NP10 8SA, NP10 8SD",272,248,24
W00009892,NP10,"NP10 9JF, NP10 9JG, NP10 9JH, NP10 9JU, NP10 9JY",340,301,39
W00008658,NP10,"NP10 0DB, NP10 0DD, NP10 0DF, NP10 0DL, NP10 0DW, NP10 9AG, NP10 9AU, NP10 9AW, NP10 9AX, NP10 9SW",303,276,27
W00010611,NP10,"NP10 8WE, NP10 8WL",358,288,70
W00009919,NP11,"NP11 3AD, NP12 0BL, NP12 0EP, NP12 0ER, NP12 0LG, NP12 4AA, NP2 0EP",350,302,48
W00009929,NP11,"NP11 4TL, NP11 5AU",325,278,47
W00006961,NP11,"NP11 5GY, NP11 5GZ, NP11 5LA",313,268,45
W00007333,NP12,"NP12 2EE, NP12 2PN, NP12 2PP, NP12 2PR, NP12 2PS, NP12 2PU, NP12 2PW, NP12 2PX, NP12 2RA, NP2 2PN, NP2 2PP, NP2 2PR, NP2 2PT, NP2 2PU, NP2 2PW, NP2 2PX, NP2 2YG, NP2 2YH",245,231,14
W00007332,NP12,"NP12 2FT, NP12 2FU, NP12 2GD, NP12 2HD, NP2 2FT, NP2 2FU, NP2 2FY, NP2 2FZ, NP2 2GA, NP2 2GB, NP2 2GD, NP2 2HA, NP2 2HB, NP2 2HD, NP2 2PG",273,249,24
W00007331,NP12,"NP12 2EZ, NP12 2GU, NP12 2HA, NP12 2HE, NP12 2HF, NP12 2HX, NP12 2HZ, NP12 2PH, NP12 2PJ, NP12 2PL, NP12 2QR, NP2 2EZ, NP2 2HE, NP2 2HF, NP2 2PH, NP2 2PJ, NP2 2PL, NP2 2QR",270,245,25
W00007330,NP12,"NP12 2EB, NP12 2ED, NP12 2EY, NP12 2PT, NP12 2PY, NP12 2RL, NP2 2EB, NP2 2ED, NP2 2EE, NP2 2EX, NP2 2NP, NP2 2NW, NP2 2PY, NP2 2PZ",298,274,24
W00007329,NP12,"NP12 2BR, NP12 2BY, NP12 2DB, NP2 2BX, NP2 2BY, NP2 2BZ",306,284,22
W00007328,NP12,"NP12 2ER, NP12 2ES, NP12 2ET, NP12 2FA, NP12 2FE, NP12 2FG, NP12 2FH, NP2 1EG, NP2 1EQ, NP2 1WR, NP2 1WU, NP2 1WX, NP2 1WY, NP2 2ER, NP2 2ES, NP2 2ET, NP2 2FA, NP2 2FB, NP2 2FD, NP2 2FE, NP2 2FF, NP2 2FG, NP2 2XS",329,293,36
W00007290,NP12,"NP12 0DH, NP12 0DJ, NP12 0DL, NP12 0DP, NP12 0DR, NP12 0DT, NP12 0DW, NP12 0EG, NP12 0NE, NP12 0NF, NP12 0NP, NP12 0NQ, NP12 0NS, NP12 0NZ, NP12 0PA, NP12 0US, NP12 2AS, NP12 2AU, NP12 2GS, NP2 0DL, NP2 0DP, NP2 0DR, NP2 0DT, NP2 0DU, NP2 0DW, NP2 0EF, NP2 0EH, NP2 0NE, NP2 0NF, NP2 0NG, NP2 0NN, NP2 0YA, NP2 0YF, NP2 2AS, NP2 2AU",596,539,57
W00007334,NP12,"NP12 2FJ, NP12 2GP, NP12 2GY, NP12 2GZ, NP12 2HG, NP12 2HR, NP12 2HS, NP12 2HT, NP12 2JA, NP12 2PZ, NP2 2EY, NP2 2GZ, NP2 2HG, NP2 2HQ, NP2 2HR, NP2 2HS, NP2 2HT, NP2 2HU, NP2 2HX, NP2 2PS",295,249,46
W00007289,NP12,"NP12 0DN, NP12 0DQ, NP12 0DS, NP12 0DU, NP12 0DX, NP12 0EA, NP12 0EB, NP12 0ED, NP12 0EE, NP12 0EF, NP12 0EH, NP12 0ET, NP12 0NN, NP2 0DN, NP2 0DS, NP2 0DX, NP2 0EA, NP2 0EB, NP2 0ED, NP2 0EE, NP2 0EQ, NP2 0GX, NP2 0GY, NP2 0GZ",304,283,21
W00007288,NP12,"NP12 0FA, NP12 0FB, NP12 0LW, NP12 0LX, NP12 0ND, NP12 0NH, NP2 0LJ, NP2 0LN, NP2 0LP, NP2 0LR, NP2 0LT, NP2 0LU, NP2 0LW, NP2 0LY, NP2 0NB, NP2 0ND, NP2 0NH",369,340,29
W00007287,NP12,"NP12 0DY, NP12 0EY, NP12 0HN, NP12 0JP, NP12 0JS, NP12 0JT, NP12 0JU, NP12 0JX, NP12 0LN, NP12 0LP, NP12 0LR, NP12 0LT, NP12 0LU, NP12 0NR, NP2 0DY, NP2 0DZ, NP2 0JG, NP2 0JQ, NP2 0JS, NP2 0JT, NP2 0JU, NP2 0JX, NP2 0LS, NP2 0LX, NP2 0YJ",283,269,14
W00007342,NP12,"NP12 2DD, NP12 2DF, NP12 2EH, NP12 2EJ, NP12 2EQ, NP12 2EW, NP2 2DD, NP2 2DE, NP2 2EH, NP2 2EL, NP2 2XE",343,309,34
W00007341,NP12,"NP12 2AE, NP12 2AQ, NP12 2LB, NP12 2LE, NP2 2AE, NP2 2LD",255,240,15
W00007291,NP12,"NP12 0BR, NP12 0BS, NP12 0BT, NP12 0BU, NP12 0BW, NP12 0DE, NP12 0DF, NP12 0EU, NP12 0FE, NP12 0NG, NP12 0PF, NP12 0PG, NP12 2AR, NP12 2RJ, NP2 0BU, NP2 0BW, NP2 0DF, NP2 0DG, NP2 0NQ, NP2 0UW, NP2 2AR, NP2 2AT",379,350,29
W00007335,NP12,"NP12 2FD, NP12 2FN, NP12 2FP, NP12 2NU, NP12 2NY, NP12 2QJ, NP2 2NU, NP2 2NY, NP2 2QJ",424,381,43
W00007338,NP12,"NP12 2AT, NP12 2BP, NP12 2BW, NP12 2BZ, NP12 2DA, NP12 2DE, NP12 2FB, NP12 2FF, NP12 2PD, NP12 2XA, NP12 2XB, NP12 2YB, NP12 2YH, NP12 2YJ, NP2 2BP, NP2 2BW, NP2 2DA, NP2 2DB, NP2 2DG, NP2 2XA, NP2 2XB",302,273,29
W00007337,NP12,"NP12 2EL, NP12 2NX, NP12 2NZ, NP12 2PA, NP12 2PB, NP2 2NZ, NP2 2PA",322,294,28
W00007339,NP12,"NP12 2NT, NP12 2PE, NP12 2PF, NP12 2QP, NP2 2NT, NP2 2NX, NP2 2PB, NP2 2PF",257,239,18
W00007344,NP12,"NP12 2AG, NP12 2AH, NP12 2AJ, NP12 2AL, NP12 2NG, NP2 2AH, NP2 2AJ, NP2 2AQ, NP2 2DP, NP2 2XG",316,292,24
W00007345,NP12,"NP12 2EN, NP12 2EP, NP12 2NR, NP12 2NS, NP12 2RN, NP2 2EJ, NP2 2EN, NP2 2EP, NP2 2EW, NP2 2NS, NP2 2YJ",271,258,13
W00007346,NP12,"NP12 2EF, NP12 2EG, NP12 2FY, NP12 2FZ, NP12 2PG, NP12 2PQ, NP2 2EF, NP2 2EG, NP2 2NL, NP2 2NR, NP2 2PQ",272,251,21
W00007348,NP12,"NP12 2BH, NP12 2BS, NP12 2BT, NP12 2BU, NP12 2JH, NP12 2JL, NP12 2JU, NP12 2JX, NP12 2JY, NP12 2LA, NP12 2LN, NP12 2QH, NP2 2BT, NP2 2BU, NP2 2JH, NP2 2JL, NP2 2JN, NP2 2JU, NP2 2JX, NP2 2JY, NP2 2LL, NP2 2LN, NP2 2LR, NP2 2XL, NP2 2YN, NP2 2YQ, NP2 2YW",302,274,28
W00007349,NP12,"NP12 2FW, NP12 2GA, NP12 2GB, NP2 2FH, NP2 2FW, NP2 2QN",261,232,29
W00007350,NP12,"NP12 2GF, NP12 2GW, NP12 2LL, NP12 2LP, NP12 2LR, NP12 2LS, NP12 2LW, NP12 2NA, NP12 2NQ, NP2 2AL, NP2 2GF, NP2 2LH, NP2 2LJ, NP2 2LQ, NP2 2LS, NP2 2LU, NP2 2NB, NP2 2NE",249,233,16
W00007351,NP12,"NP12 2BX, NP12 2EA, NP12 2EX, NP12 2NN, NP12 2NP, NP12 2NW, NP2 2BR, NP2 2BS, NP2 2DF, NP2 2EA, NP2 2EQ, NP2 2NN",336,302,34
W00007352,NP12,"NP12 2HY, NP12 2JD, NP12 2JN, NP12 2JP, NP12 2JR, NP12 2JS, NP12 2JW, NP12 2LX, NP12 2XH, NP12 2XN, NP12 2XP, NP2 2GJ, NP2 2HY, NP2 2HZ, NP2 2JD, NP2 2JE, NP2 2JP, NP2 2JR, NP2 2JS, NP2 2JW, NP2 2LP, NP2 2LT, NP2 2LW, NP2 2LX, NP2 2NQ, NP2 2XH",283,262,21
W00007353,NP12,"NP12 2JE, NP12 2JQ, NP12 2JT, NP12 2LF, NP2 2JT",178,168,10
W00007340,NP12,"NP12 2AF, NP12 2DL, NP12 2DQ, NP12 2DW, NP12 2DX, NP12 2DY, NP12 2DZ, NP12 2JF, NP12 2JG, NP12 2JJ, NP12 2JZ, NP12 2LG, NP12 2LH, NP12 2LJ, NP12 2LQ, NP12 2LZ, NP12 2QG, NP12 2XZ, NP12 2YA, NP12 2YP, NP12 2YU, NP12 2YW, NP2 2AF, NP2 2AG, NP2 2DL, NP2 2DQ, NP2 2DS, NP2 2DW, NP2 2DZ, NP2 2JF, NP2 2JG, NP2 2JJ, NP2 2JQ, NP2 2JZ, NP2 2LA, NP2 2LB, NP2 2LE, NP2 2LF, NP2 2LG, NP2 2XD, NP2 2XR, NP2 2YA, NP2 2YF, NP2 2YL, NP2 2YP, NP2 2YR, NP2 2YS, NP2 2YT, NP2 2YU",304,269,35
W00007354,NP12,"NP12 2GE, NP12 2GG, NP12 2GH, NP12 2GJ, NP12 2GL, NP12 2GN, NP12 2LU, NP2 2GE, NP2 2GG, NP2 2GH, NP2 2GL, NP2 2GN, NP2 2GW, NP2 2LY, NP2 2NA",270,259,11
W00007476,NP12,"NP12 2HB, NP12 2HH, NP12 2HJ, NP12 2HN, NP12 2HP, NP12 2HQ, NP12 2NH, NP12 2YG, NP2 2HH, NP2 2HJ, NP2 2HL, NP2 2HN, NP2 2HP, NP2 2HW, NP2 2NH",290,256,34
W00007343,NP12,"NP12 2NJ, NP12 2NL, NP12 2QL, NP12 2QN, NP12 2QQ, NP2 2NJ, NP2 2PE, NP2 2QP, NP2 2QQ",274,252,22
W00007285,NP12,"NP12 0DG, NP12 0EQ, NP12 0UQ, NP12 0UT, NP12 0UW, NP12 0UX, NP12 0UY, NP2 0DH, NP2 0DJ, NP2 0DQ, NP2 0EJ, NP2 0UQ, NP2 0UR, NP2 0US, NP2 0UT, NP2 0UU, NP2 0UX, NP2 0UY",270,256,14
W00007083,NP12,"NP12 3HB, NP12 3LH, NP12 3LQ, NP2 1EZ, NP2 1HA, NP2 1LH",343,318,25
W00007282,NP12,"NP12 0DZ, NP12 0EW, NP12 0JB, NP12 0JG, NP12 0JH, NP12 0JN, NP12 0JQ, NP12 0JR, NP12 0JW, NP2 0JB, NP2 0JH, NP2 0JL, NP2 0JN, NP2 0JP, NP2 0JR, NP2 0JW",315,277,38
W00007074,NP12,"NP12 1DB, NP12 1DP, NP12 1EN, NP12 1EZ, NP12 3HA, NP2 1DB, NP2 1DE, NP2 1DF, NP2 1DP, NP2 1EN, NP2 1EY",243,224,19
W00007073,NP12,"NP12 0AG, NP12 0AH, NP12 0AQ, NP12 0BE, NP12 0BH, NP12 0BQ, NP12 0EJ, NP12 1BD, NP12 1BF, NP12 1BG, NP12 1BH, NP12 1BJ, NP12 1BP, NP12 1BQ, NP12 1BS, NP12 1BT, NP12 1BU, NP12 1BX, NP12 1BY, NP12 1BZ, NP12 1DA, NP12 1DQ, NP12 1EL, NP12 1GG, NP12 1GS, NP12 1YR, NP2 0AG, NP2 0AH, NP2 0AQ, NP2 0BE, NP2 0BJ, NP2 0BQ, NP2 1BF, NP2 1BG, NP2 1BH, NP2 1BJ, NP2 1BQ, NP2 1BT, NP2 1BU, NP2 1BX, NP2 1BY, NP2 1BZ, NP2 1DA, NP2 1DD",321,294,27
W00007072,NP12,"NP12 1EW, NP12 1EX, NP12 1EY, NP12 1HH, NP12 1HJ, NP12 1HY, NP2 1HH, NP2 1HJ, NP2 1JL",239,229,10
W00007071,NP12,"NP12 1GA, NP12 1GB, NP12 1GH, NP12 1GN, NP12 1GP, NP12 1GQ, NP12 1GR, NP12 3GZ, NP2 1GB, NP2 1GJ, NP2 1GP, NP2 1GR, NP2 1GS, NP2 1GY, NP2 1GZ",217,202,15
W00007070,NP12,"NP12 1BE, NP12 1BL, NP12 1BN, NP12 1BR, NP12 1BW, NP12 1GD, NP12 1GE, NP12 1HF, NP12 1HL, NP12 1HR, NP12 1HS, NP12 1HT, NP12 1HU, NP12 1HX, NP2 0BH, NP2 1BE, NP2 1BL, NP2 1BN, NP2 1BP, NP2 1BR, NP2 1BW, NP2 1EL, NP2 1GD, NP2 1GE, NP2 1HL, NP2 1HS, NP2 1HU, NP2 1HX, NP2 1YP, NP2 1YR",287,266,21
W00007069,NP12,"NP12 1AQ, NP12 1EE, NP12 1FE, NP12 1WR, NP12 1WT, NP12 1WU, NP12 1WW, NP12 1WX, NP12 1WY, NP2 1DT, NP2 1ED, NP2 1EE, NP2 1EJ, NP2 1WT",285,261,24
W00007068,NP12,"NP12 1FD, NP12 1RE, NP12 1SN, NP2 1DS, NP2 1DU",307,276,31
W00007067,NP12,"NP12 1GT, NP12 1GU, NP12 1GW, NP12 1HA, NP12 1HB, NP12 1SG, NP12 1SJ, NP12 1SL, NP12 1SP, NP2 1WA, NP2 1WZ",483,409,74
W00007066,NP12,"NP12 1AN, NP12 1AR, NP12 1AW, NP12 1DJ, NP12 1DL, NP12 1EF, NP12 1EG, NP12 1EH, NP12 1EQ, NP12 1FN, NP12 1YT, NP12 2BN, NP12 2FS, NP2 1AN, NP2 1AR, NP2 1AS, NP2 1AT, NP2 1AW, NP2 1DG, NP2 1DH, NP2 1DJ, NP2 1DL, NP2 1EF, NP2 1EH, NP2 2BN",297,265,32
W00007065,NP12,"NP12 1AJ, NP12 1DG, NP12 1DH, NP12 1DR, NP12 1DW, NP12 1EJ, NP12 1FB, NP12 1FJ, NP12 1FU, NP2 1AJ, NP2 1AL, NP2 1DN, NP2 1DR, NP2 1DW",240,229,11
W00007064,NP12,"NP12 1DN, NP12 1DT, NP12 1DX, NP12 1DY, NP12 1ED, NP2 1AG, NP2 1DX, NP2 1DY, NP2 1EB, NP2 1QW, NP2 1ZE",309,271,38
W00007063,NP12,"NP12 1DZ, NP12 1EA, NP12 1EB, NP12 1QF, NP12 1QH, NP12 1QN, NP2 1EA, NP2 1QF, NP2 1QG, NP2 1QH, NP2 1QJ, NP2 1QL, NP2 1QN, NP2 1YG",297,269,28
W00007062,NP12,"NP12 1FF, NP12 1FQ, NP12 1FT, NP12 1GL, NP2 1DZ, NP2 1QE",303,272,31
W00007061,NP12,"NP12 1AL, NP12 1AP, NP12 1AS, NP12 1AT, NP12 1AX, NP12 1NX, NP12 1NZ, NP12 1PA, NP12 1PE, NP2 0NX, NP2 0NZ, NP2 0PA, NP2 0UP, NP2 1AP, NP2 1AU",249,230,19
W00007075,NP12,"NP12 1ER, NP12 1FH, NP12 1LX, NP12 1LY, NP12 1QP, NP12 1WN, NP2 1ER, NP2 1LY, NP2 1WL, NP2 1WN, NP2 1WW, NP2 1YQ",310,290,20
W00007060,NP12,"NP12 1GX, NP12 1HD, NP12 1WB, NP12 1WP, NP12 1WQ, NP12 1WS, NP12 3LX, NP12 3LY, NP12 3ZS, NP2 1WB, NP2 1WP, NP2 1WQ",479,443,36
W00007058,NP12,"NP12 0NT, NP12 0WY, NP12 0WZ, NP12 0YA, NP12 0YB, NP12 0YE, NP12 0YG, NP12 0YH, NP12 0YJ, NP12 0YT, NP12 0ZR, NP12 0ZW, NP12 1AA, NP12 1AB, NP12 1AD, NP12 1AE, NP12 1AF, NP12 1AG, NP12 1AH, NP12 1AU, NP12 1AY, NP12 1AZ, NP12 1BA, NP12 1FA, NP12 1FG, NP12 1GY, NP12 1GZ, NP12 1LF, NP12 1NR, NP12 1NS, NP12 1NT, NP12 1NU, NP12 1NW, NP12 1NY, NP12 1PN, NP12 1PP, NP12 1PS, NP12 1PT, NP12 1QJ, NP12 1QL, NP12 1UZ, NP12 1WZ, NP12 1XA, NP12 1XB, NP12 1XD, NP12 1XJ, NP12 1XX, NP12 1XY, NP12 1XZ, NP12 1YA, NP12 1YB, NP12 1YD, NP12 1YE, NP12 1YG, NP12 1YH, NP12 1YJ, NP12 1YL, NP12 1YN, NP12 1YP, NP12 1YQ, NP12 1YS, NP12 1YU, NP12 1YW, NP12 1YX, NP12 1YY, NP12 1YZ, NP12 1ZA, NP12 1ZD, NP12 1ZE, NP12 1ZF, NP12 1ZH, NP12 1ZL, NP12 1ZN, NP12 1ZP, NP12 2GT, NP12 2WT, NP12 2WU, NP12 2WW, NP12 2WX, NP12 2WY, NP12 2WZ, NP12 2YF, NP12 2YQ, NP12 2YR, NP12 2YS, NP12 2YX, NP12 2ZA, NP12 3WU, NP12 3WW, NP12 3WX, NP12 3WY, NP12 3YA, NP12 3YB, NP12 3YE, NP12 3YF, NP12 3YG, NP12 3YH, NP12 3YJ, NP12 3YL, NP12 3YN, NP12 3YP, NP12 3YQ, NP12 3ZG, NP12 3ZQ, NP12 3ZR, NP12 9AH, NP12 9AN, NP12 9AP, NP12 9AQ, NP12 9AR, NP12 9AS, NP12 9AT, NP12 9AU, NP12 9AW, NP12 9AX, NP12 9AY, NP12 9AZ, NP12 9BA, NP12 9BB, NP12 9BD, NP12 9BE, NP12 9BF, NP12 9BG, NP2 0NP, NP2 0NR, NP2 0NS, NP2 0NT, NP2 0NU, NP2 0NW, NP2 0NY, NP2 0PH, NP2 0PQ, NP2 1AA, NP2 1AB, NP2 1AD, NP2 1AE, NP2 1AF, NP2 1AH, NP2 1AX, NP2 1BD, NP2 1HP, NP2 1PP, NP2 1PR, NP2 1PS, NP2 1PT, NP2 1PU, NP2 1PW, NP2 1PZ, NP2 1XA, NP2 1XZ, NP2 1YB, NP2 1YJ, NP2 1YL, NP2 1YN, NP2 1YW, NP2 1YY, NP2 1YZ, NP2 1ZA, NP2 1ZB, NP2 1ZD, NP2 1ZF, NP2 1ZG, NP2 2XJ, NP2 2XP",287,273,14
W00007057,NP12,"NP12 1DS, NP12 1DU, NP12 1EP, NP12 1FP, NP12 1FR, NP12 1FS, NP2 1AQ, NP2 1EP",304,265,39
W00007056,NP12,"NP12 1QE, NP12 1WA, NP12 1WD, NP12 1WE, NP2 1WD, NP2 1WE, NP2 1WF, NP2 1WG",324,304,20
W00007055,NP12,"NP12 1DE, NP12 1DF, NP12 1GF, NP12 1GJ, NP12 1JH, NP12 1JL, NP2 1DQ, NP2 1GA, NP2 1GF, NP2 1GG, NP2 1GH, NP2 1GL, NP2 1GN, NP2 1GQ, NP2 1JH, NP2 1JJ",355,331,24
W00006999,NP12,"NP12 0QD, NP12 0QF, NP12 0QL, NP12 0QN, NP12 0QP, NP12 0QS, NP12 0RX, NP2 0QD, NP2 0QF, NP2 0QG, NP2 0QH, NP2 0QN, NP2 0QP, NP2 0QR, NP2 0QS",292,271,21
W00006997,NP12,"NP12 0QA, NP12 0QB, NP12 0QU, NP12 0QW, NP12 0SU, NP2 0PT, NP2 0PY, NP2 0PZ, NP2 0QA, NP2 0QB, NP2 0QU, NP2 0QW, NP2 0QX",318,276,42
W00006996,NP12,"NP12 0PS, NP12 0PT, NP12 0PY, NP12 0RB, NP12 0RE, NP2 0PS, NP2 0RB, NP2 0RE",236,216,20
W00006995,NP12,"NP12 0BN, NP12 0GA, NP12 0GD, NP12 0RF, NP12 0RH, NP12 0RJ, NP12 0RL, NP12 0RN, NP12 0RP, NP12 0RQ, NP12 0RW, NP12 0RZ, NP12 0SA, NP12 0SB, NP12 0SD, NP12 0SE, NP12 0SF, NP12 0SG, NP12 0SH, NP12 0SJ, NP12 0SL, NP12 0SN, NP12 0SP, NP12 0SQ, NP12 0SR, NP12 0SS, NP12 0ST, NP12 0SW, NP2 0RD, NP2 0RF, NP2 0RH, NP2 0RJ, NP2 0RL, NP2 0RN, NP2 0RP, NP2 0RQ, NP2 0RW, NP2 0RZ, NP2 0SA, NP2 0SB, NP2 0SD, NP2 0SE, NP2 0SF, NP2 0SG, NP2 0SH, NP2 0SJ, NP2 0SL, NP2 0SN, NP2 0SP, NP2 0SQ, NP2 0SR, NP2 0SS, NP2 0ST, NP2 0SW",392,353,39
W00006994,NP12,"NP12 0AA, NP12 0AB, NP12 0AD, NP12 0AE, NP12 0AL, NP12 0AP, NP12 0HA, NP12 0HB, NP12 0HD, NP12 0HE, NP12 0HF, NP12 0HG, NP12 0HH, NP12 0HJ, NP12 0HL, NP12 0HP, NP12 0HQ, NP12 0HR, NP12 0HS, NP12 0HT, NP12 0HW, NP12 1DD, NP2 0AA, NP2 0AB, NP2 0AD, NP2 0AE, NP2 0AL, NP2 0HA, NP2 0HB, NP2 0HD, NP2 0HE, NP2 0HF, NP2 0HJ, NP2 0HL, NP2 0HP, NP2 0HR, NP2 0HT, NP2 0HW, NP2 0YB, NP2 0YD, NP2 0YE, NP2 0YG",380,331,49
W00006993,NP12,"NP12 0AJ, NP12 0AN, NP12 0AR, NP12 0AS, NP12 0AT, NP12 0AU, NP12 0AW, NP12 0AX, NP12 0AY, NP12 0AZ, NP12 0BA, NP12 0BJ, NP12 0HU, NP12 0HY, NP12 0HZ, NP12 0JA, NP12 0JD, NP2 0AJ, NP2 0AN, NP2 0AP, NP2 0AR, NP2 0AS, NP2 0AT, NP2 0AU, NP2 0AW, NP2 0AX, NP2 0AY, NP2 0AZ, NP2 0BA, NP2 0HG, NP2 0HH, NP2 0HQ, NP2 0HY, NP2 0HZ, NP2 0JA, NP2 0JD, NP2 0PG, NP2 0UZ",464,399,65
W00006992,NP12,"NP12 0PR, NP12 0PU, NP12 0PX, NP12 0PZ, NP12 0QJ, NP12 0QQ, NP12 0RA, NP2 0PR, NP2 0PU, NP2 0PW, NP2 0QJ, NP2 0QL, NP2 0QQ, NP2 0RA",293,280,13
W00007284,NP12,"NP12 0JL, NP12 0JY, NP12 0JZ, NP12 0LB, NP12 0LS, NP12 0LZ, NP2 0JY, NP2 0JZ, NP2 0LA, NP2 0LB, NP2 0LE, NP2 0NA",314,282,32
W00009933,NP12,"NP12 0PP, NP12 0RY, NP2 0PP, NP2 0RY, NP2 6EA, NP2 6EB, NP2 6EQ, NP2 6EU, NP2 6EX, NP2 6HB, NP2 6HX, NP2 6HY, NP2 6JE, NP2 6JF, NP2 6JG, NP2 6JH, NP2 6JP, NP2 6JQ, NP2 6JR, NP2 6JS, NP2 6JT, NP2 6JU, NP2 6JX, NP2 6JY, NP2 6JZ, NP2 6LL, NP2 6LP, NP2 6LR, NP2 6LS, NP2 6LT, NP2 6LU, NP2 6LW, NP2 6LX, NP2 6LY, NP2 6LZ, NP2 6PH, NP2 6XT, NP2 6XX, NP2 6XY, NP24 6EA, NP24 6EB, NP24 6ED, NP24 6JF, NP24 6JJ, NP24 6JN, NP24 6JP, NP24 6JQ, NP24 6JR, NP24 6JS, NP24 6JT, NP24 6JU, NP24 6JX, NP24 6JY, NP24 6JZ, NP24 6LL, NP24 6LR, NP24 6LW, NP24 6LY, NP24 6XX, NP24 6XY",418,384,34
W00009928,NP12,"NP12 0BG, NP12 0BP, NP12 0EL, NP12 0EX, NP12 0LD, NP12 0LE, NP2 0LG",450,391,59
W00007059,NP12,"NP12 1WF, NP12 1WG, NP12 1WH, NP12 1WJ, NP12 1WL, NP2 1LX, NP2 1QD, NP2 1QQ, NP2 1WH, NP2 1WJ, NP2 1ZT",267,253,14
W00007076,NP12,"NP12 1ES, NP12 1ET, NP12 1EU, NP12 1HQ, NP12 3HD, NP12 3HG, NP2 1ES, NP2 1EU, NP2 1EW, NP2 1EX, NP2 1ZP, NP2 1ZR",295,264,31
W00006998,NP12,"NP12 0PW, NP12 0QE, NP12 0QG, NP12 0QH, NP12 0QR, NP12 0QT, NP12 0QX, NP2 0PX, NP2 0QE, NP2 0QT",255,241,14
W00007078,NP12,"NP12 1HW, NP12 1HZ, NP12 1JD, NP12 1JF, NP12 1JG, NP2 1HT, NP2 1JD, NP2 1JE, NP2 1JF",264,245,19
W00007280,NP12,"NP12 0EZ, NP12 0GX, NP12 0GY, NP12 0GZ, NP12 0HX, NP12 0JJ, NP12 0LA, NP12 0NU, NP12 4AB, NP12 4AD, NP12 4AE, NP2 0HX, NP2 0JJ",437,402,35
W00007077,NP12,"NP12 1FL, NP12 1JA, NP12 1JB, NP12 1JE, NP12 1JQ, NP12 1ZR, NP2 1HW, NP2 1HY, NP2 1HZ, NP2 1JA, NP2 1JG, NP2 1JQ",257,233,24
W00007279,NP12,"NP12 0BX, NP12 0BY, NP12 0BZ, NP12 0DA, NP12 0DB, NP12 0UP, NP12 2DJ, NP12 2GQ, NP12 2GR, NP2 0BS, NP2 0BX, NP2 0BY, NP2 0BZ, NP2 0DA, NP2 0DB, NP2 0DD, NP2 0PD, NP2 0PE, NP2 0PF, NP2 0PL, NP2 2DJ",370,334,36
W00007278,NP12,"NP12 0DD, NP12 0PB, NP12 0PD, NP12 0PE, NP12 0PH, NP12 0PJ, NP12 0PL, NP12 0PN, NP12 0PQ, NP2 0BR, NP2 0BT, NP2 0DE, NP2 0PB, NP2 0PJ",275,255,20
W00007277,NP12,"NP12 1RR, NP12 3QW, NP12 3QX, NP12 3QY, NP12 3QZ, NP12 3RA, NP12 3RB, NP12 3RD, NP12 3RE, NP12 3RG, NP12 3RL, NP12 3RN, NP12 3RW, NP12 3SL, NP12 3SN, NP2 1NZ, NP2 1QX, NP2 1QY, NP2 1QZ, NP2 1RA, NP2 1RL, NP2 1RN",437,385,52
W00007276,NP12,"NP12 3NS, NP12 3NT, NP12 3NU, NP12 3NX, NP12 3NZ, NP12 3PL, NP2 1NS, NP2 1NT, NP2 1NU, NP2 1NX, NP2 1NY",274,251,23
W00007275,NP12,"NP12 3SJ, NP12 3SS, NP12 3ST, NP12 3SU, NP12 3SW, NP12 3SX, NP12 3SY, NP12 3SZ, NP12 3TB, NP12 3TP, NP12 3TU, NP12 3TX, NP12 3TY, NP12 3UZ, NP12 3XA, NP12 3XB, NP12 3XY, NP2 1SN, NP2 1SP, NP2 1SR, NP2 1SS, NP2 1ST, NP2 1SU, NP2 1SW, NP2 1SX, NP2 1TA, NP2 1TB, NP2 1TP, NP2 1TU, NP2 1UZ, NP2 1XB, NP2 1XY",341,292,49
W00007281,NP12,"NP12 0JE, NP12 0JF, NP12 0LY, NP12 0NA, NP12 0NB, NP12 0NW, NP12 0NX, NP2 0JE, NP2 0JF, NP2 0LD, NP2 0LZ, NP2 0NJ, NP2 0NL",450,403,47
W00007273,NP12,"NP12 3AA, NP12 3SP, NP12 3TD, NP12 3TE, NP12 3TJ, NP12 3TQ, NP2 1LF, NP2 1TD, NP2 1TE",282,246,36
W00007272,NP12,"NP12 3TR, NP12 3TT, NP12 3UH, NP12 3UQ, NP12 3UR, NP12 3US, NP12 3UT, NP12 3UU, NP12 3UW, NP2 1TR, NP2 1TS, NP2 1UH, NP2 1UP, NP2 1UQ, NP2 1UR, NP2 1US, NP2 1UT, NP2 1UU, NP2 1UW, NP2 1UX",369,314,55
W00007271,NP12,"NP12 1PD, NP12 2FL, NP12 2QB, NP12 2QD, NP12 2QE, NP12 2QF, NP12 2RH, NP12 3JQ, NP12 3RS, NP12 3SG, NP12 3SH, NP12 3SQ, NP12 3TS, NP12 3UP, NP12 3UX, NP2 1PD, NP2 1RR, NP2 1RS, NP2 1RX, NP2 1SG, NP2 1SQ, NP2 2EU, NP2 2QB, NP2 2QE, NP2 2XT",310,271,39
W00007270,NP12,"NP12 1PB, NP12 3FT, NP12 3FU, NP12 3FW, NP12 3FX, NP12 3FY, NP12 3FZ, NP2 1FL, NP2 1FN, NP2 1FP, NP2 1FR, NP2 1FS, NP2 1FT, NP2 1FU, NP2 1FW, NP2 1FX, NP2 1FY, NP2 1FZ, NP2 1PB, NP2 1QR, NP2 1QS, NP2 1QT, NP2 1QU",400,352,48
W00007269,NP12,"NP12 3PY, NP12 3RH, NP12 3RJ, NP12 3RP, NP12 3RQ, NP12 3RT, NP12 3RU, NP12 3RX, NP12 3RY, NP12 3RZ, NP12 3SB, NP12 3SE, NP2 1RH, NP2 1RJ, NP2 1RP, NP2 1RT, NP2 1RU, NP2 1RW",345,301,44
W00007268,NP12,"NP12 3NR, NP12 3NY, NP12 3PA, NP12 3PB, NP12 3PN, NP12 3TA, NP2 1LB, NP2 1NG, NP2 1NH, NP2 1NQ, NP2 1NR, NP2 1PA, NP2 1PL",319,282,37
W00007267,NP12,"NP12 3AB, NP12 3PZ, NP12 3RF, NP12 3TZ, NP12 3UA, NP12 3UB, NP12 3UD, NP12 3UE, NP12 3UF, NP2 1RB, NP2 1RD, NP2 1RE, NP2 1RF, NP2 1RG, NP2 1RQ, NP2 1TX, NP2 1TY, NP2 1TZ, NP2 1UA, NP2 1UF",253,224,29
W00007274,NP12,"NP12 3TF, NP12 3TG, NP12 3TH, NP12 3TL, NP12 3TN, NP12 3TW, NP2 1TF, NP2 1TG, NP2 1TH, NP2 1TJ, NP2 1TL, NP2 1TN, NP2 1TQ, NP2 1TW",288,258,30
W00007249,NP12,"NP12 0QY, NP2 6JJ, NP2 6JL, NP2 6NE, NP2 6NH, NP2 6NJ, NP2 6NL, NP2 6PJ, NP2 6PL, NP24 6DB, NP24 6FL, NP24 6NE, NP24 6NH, NP24 6NJ, NP24 6NP, NP24 6NQ, NP24 6NR, NP24 6NS, NP24 6NT, NP24 6NW, NP24 6NY, NP24 6NZ, NP24 6PJ, NP24 6PL",324,300,24
W00007081,NP12,"NP12 3PE, NP12 3PG, NP12 3PH, NP12 3PJ, NP2 1LS, NP2 1PE, NP2 1PJ",243,225,18
W00007080,NP12,"NP12 1PX, NP12 1QD, NP12 1QG, NP12 1QQ, NP12 1QR, NP12 1YF, NP12 1ZJ, NP12 1ZX, NP2 1PX",318,294,24
W00007266,NP12,"NP12 3RR, NP12 3SA, NP12 3SD, NP12 3SF, NP12 3UG, NP12 3UJ, NP12 3UL, NP12 3UN, NP12 3UY, NP12 3WA, NP12 3WS, NP12 3XS, NP12 3XT, NP12 3XU, NP2 1RY, NP2 1RZ, NP2 1SA, NP2 1SB, NP2 1SD, NP2 1SE, NP2 1SF, NP2 1SH, NP2 1SJ, NP2 1SL, NP2 1SY, NP2 1SZ, NP2 1TT, NP2 1UB, NP2 1UD, NP2 1UE, NP2 1UJ, NP2 1UL, NP2 1UN, NP2 1UY, NP2 1WS, NP2 1XS, NP2 1XT, NP2 1XU",358,320,38
W00007079,NP12,"NP12 1BB, NP12 1FW, NP12 1HN, NP12 1HP, NP12 1PQ, NP12 1PR, NP12 1PU, NP12 1PY, NP12 1PZ, NP12 1QA, NP12 1QB, NP2 1AY, NP2 1AZ, NP2 1BA, NP2 1BB, NP2 1BS, NP2 1HN, NP2 1HR, NP2 1JB, NP2 1PN, NP2 1PY, NP2 1QA, NP2 1QB, NP2 1QP, NP2 1YD, NP2 1YT, NP2 1YU, NP2 1YX",349,324,25
W00007082,NP12,"NP12 3PF, NP12 3QR, NP12 3QS, NP12 3QT",266,246,20
W00007085,NP12,"NP12 3HE, NP12 3HF, NP12 3JS, NP12 3JT, NP2 1ET, NP2 1HE, NP2 1JT",253,237,16
W00007084,NP12,"NP12 3LE, NP12 3LF, NP12 3LG, NP12 3LN, NP12 3LP, NP2 1LG, NP2 1LN, NP2 1LP, NP2 1LQ",251,234,17
W00007087,NP12,"NP12 3JJ, NP12 3JN, NP12 3JR, NP12 3JW, NP12 3LZ, NP12 3NA, NP12 3NB, NP12 3NE, NP2 1HD, NP2 1HF, NP2 1HG, NP2 1HQ, NP2 1JN, NP2 1JP, NP2 1JW, NP2 1NA, NP2 1NB, NP2 1ND, NP2 1NE, NP2 1YA, NP2 1YE, NP2 1YF, NP2 1YH, NP2 1YS, NP2 1ZL, NP2 1ZU",247,234,13
W00007088,NP12,"NP12 3AE, NP12 3LB, NP12 3LD, NP12 3NJ, NP12 3NQ, NP2 1LA, NP2 1LD, NP2 1LE, NP2 1LW, NP2 1NJ",321,300,21
W00007089,NP12,"NP12 3LA, NP12 3LW, NP12 3ND, NP12 3NN, NP2 1JR, NP2 1JS, NP2 1JZ",294,277,17
W00007090,NP12,"NP12 3BA, NP12 3FE, NP12 3NF, NP12 3NG, NP12 3NH, NP12 3NL, NP12 3NW, NP12 3WZ, NP12 3XZ, NP12 3YD, NP12 3ZB, NP2 1NF, NP2 1NN, NP2 1NP",280,261,19
W00007091,NP12,"NP12 3LT, NP12 3LU, NP12 3NP, NP2 1LT, NP2 1LU, NP2 1LZ, NP2 1ZS, NP2 1ZX",279,267,12
W00007092,NP12,"NP12 3FG, NP12 3FH, NP12 3FJ, NP12 3FL, NP12 3FN, NP12 3LR, NP12 3LS, NP12 3QU, NP2 1FA, NP2 1FD, NP2 1FE, NP2 1FF, NP2 1FG, NP2 1FH, NP2 1FJ, NP2 1FQ, NP2 1LR, NP2 1NL, NP2 1NW, NP2 1PF, NP2 1PG, NP2 1PH",176,168,8
W00007086,NP12,"NP12 3JU, NP12 3JX, NP12 3JY, NP12 3JZ, NP12 3LJ, NP12 3LL, NP2 1HB, NP2 1JU, NP2 1JX, NP2 1JY, NP2 1LJ, NP2 1LL",235,225,10
W00007650,NP13,"NP13 2JA, NP13 2JB, NP13 2JD, NP13 2JH, NP13 2RG, NP3 2HT, NP3 2JA, NP3 2JD, NP3 2RG, NP3 2RH, NP3 2RQ, NP3 2RY",226,212,14
W00007658,NP13,"NP13 2AR, NP13 2AX, NP13 2AY, NP13 2AZ, NP13 2BA, NP13 2HU, NP13 2HW, NP13 2JS, NP13 2RL, NP13 2RU, NP13 2RZ, NP13 2SE, NP13 2WA, NP13 2WN, NP13 2YA, NP13 2YD, NP13 2ZR, NP3 1XD, NP3 2AY, NP3 2BA, NP3 2BB, NP3 2HH, NP3 2HU, NP3 2HW, NP3 2HY, NP3 2RL, NP3 2YA",283,269,14
W00007657,NP13,"NP13 2AA, NP13 2AB, NP13 2AD, NP13 2AE, NP13 2AF, NP13 2AG, NP13 2AJ, NP13 2AN, NP13 2AP, NP13 2AQ, NP13 2AS, NP13 2AW, NP13 2HS, NP13 2LN, NP13 2XE, NP3 2AB, NP3 2AD, NP3 2AE, NP3 2AF, NP3 2AG, NP3 2AH, NP3 2AJ, NP3 2AN, NP3 2AP, NP3 2AQ, NP3 2AR, NP3 2AS, NP3 2AT, NP3 2AU, NP3 2AW, NP3 2AX, NP3 2BH, NP3 2BP, NP3 2EL, NP3 2HE, NP3 2HG, NP3 2HQ, NP3 2HS, NP3 2JW, NP3 2LN, NP3 2LP, NP3 2LW, NP3 2XE, NP3 2XF, NP3 2XJ, NP3 2XR",235,214,21
W00007656,NP13,"NP13 2AH, NP13 2BG, NP13 2EJ, NP13 2EL, NP13 2EN, NP13 2ES, NP13 2ET, NP13 2EW, NP3 2EN, NP3 2EP, NP3 2ES, NP3 2ET, NP3 2EU, NP3 2EW",244,235,9
W00007649,NP13,"NP13 2RA, NP13 2RD, NP13 2RE, NP13 2RF, NP13 2RH, NP13 2RN, NP13 2RQ, NP13 2RY, NP3 2RJ, NP3 2RZ",257,253,4
W00007601,NP13,"NP13 1SH, NP13 1SL, NP13 1SN, NP13 1SW, NP3 1SW",274,257,17
W00007605,NP13,"NP13 1SD, NP13 1SE, NP13 1SF, NP13 1SJ, NP13 1SQ, NP3 1SF, NP3 1SL",246,235,11
W00007604,NP13,"NP13 1HR, NP13 1HZ, NP13 1LT, NP13 1LX, NP13 1LY, NP3 1HG, NP3 1JG, NP3 1JH, NP3 1LP, NP3 1LT",242,231,11
W00007603,NP13,"NP13 1PE, NP13 1PF, NP13 1PH, NP13 1RP, NP13 1SA, NP13 1SG, NP3 1PB, NP3 1PE, NP3 1PF, NP3 1PH, NP3 1RP, NP3 1RT, NP3 1SE, NP3 1SJ, NP3 1SN, NP3 1SQ",251,235,16
W00007602,NP13,"NP13 1HS, NP13 1JD, NP13 1JF, NP13 1JG, NP13 1JH, NP13 1JQ, NP13 1JT, NP13 1JU, NP13 1LP, NP13 1LZ, NP13 1WY, NP13 1WZ, NP13 1XB, NP13 1XE, NP13 1YD, NP13 1YJ, NP13 1YQ, NP13 2WQ, NP13 2WZ, NP13 2YB, NP13 2YE, NP13 2YF, NP13 2YG, NP13 2YH, NP13 2YJ, NP13 2YL, NP13 2YN, NP13 2YP, NP13 2ZQ, NP13 3WY, NP13 3WZ, NP13 3XA, NP13 3YA, NP13 3YB, NP13 9AB, NP13 9AE, NP13 9AJ, NP13 9AL, NP13 9AN, NP13 9AP, NP13 9AQ, NP13 9AR, NP13 9AS, NP13 9AT, NP13 9AU, NP13 9AW, NP3 1HR, NP3 1HS, NP3 1HZ, NP3 1JB, NP3 1JD, NP3 1LY",218,207,11
W00007600,NP13,"NP13 1JJ, NP13 1JL, NP13 1JN, NP13 1JP, NP13 1JR, NP13 1JS, NP13 1JW, NP13 1JY, NP13 1JZ, NP13 1LA, NP13 1LB, NP13 1LD, NP13 1LF, NP13 1LG, NP13 1LN, NP13 1LS, NP13 1NS, NP3 1JJ, NP3 1JL, NP3 1JN, NP3 1JP, NP3 1JQ, NP3 1JR, NP3 1JS, NP3 1JU, NP3 1JW, NP3 1JY, NP3 1JZ, NP3 1LA, NP3 1LB, NP3 1LR, NP3 1LS, NP3 1LZ",274,256,18
W00007599,NP13,"NP13 1LE, NP13 1LH, NP13 1LJ, NP13 1LL, NP13 1LQ, NP13 1LU, NP13 1LW, NP13 1RF, NP3 1LD, NP3 1LE, NP3 1LF, NP3 1LG, NP3 1LH, NP3 1LJ, NP3 1LL, NP3 1LN, NP3 1LQ, NP3 1LU, NP3 1LW",218,212,6
W00007598,NP13,"NP13 1SP, NP13 1SR, NP13 1SS, NP13 1ST, NP13 1SU, NP13 1SX, NP13 2EH, NP13 3EL, NP13 3EN, NP13 3ER, NP13 3ES, NP3 1SP, NP3 1SR, NP3 3EN, NP3 3ER, NP3 3ES, NP3 3EU",365,331,34
W00007648,NP13,"NP13 2JJ, NP13 2JT, NP13 2RB, NP13 2RP, NP13 2RR, NP13 2RS, NP13 2RX, NP3 2JB, NP3 2JH, NP3 2RA, NP3 2RD, NP3 2RE, NP3 2RF, NP3 2RN, NP3 2RP, NP3 2RR, NP3 2RS, NP3 2RX, NP3 2SA",208,196,12
W00007659,NP13,"NP13 2AU, NP13 2GY, NP13 2GZ, NP13 2HF, NP3 2GY, NP3 2GZ",214,196,18
W00007714,NP13,"NP13 1AT, NP13 1BA, NP13 2NZ, NP13 2PA, NP13 2PL, NP13 2PQ, NP13 2PR, NP13 2PS, NP13 2PW, NP13 2PX, NP3 1BA, NP3 2AZ, NP3 2LS, NP3 2PA, NP3 2PN",239,229,10
W00007661,NP13,"NP13 2JP, NP13 2RT, NP13 2RW, NP13 2SA, NP13 2SB, NP13 2SD, NP3 2JP, NP3 2JS, NP3 2RT, NP3 2RU, NP3 2SB, NP3 2SD, NP3 2SE",264,253,11
W00007718,NP13,"NP13 2LG, NP13 2LQ, NP13 2NA, NP13 2NB, NP13 2NE, NP13 2PE, NP3 2LG, NP3 2LH, NP3 2LL, NP3 2PF, NP3 2PG",257,244,13
W00007717,NP13,"NP13 2PH, NP13 2PJ, NP13 2PT, NP13 2PU, NP13 2QA, NP3 2PH, NP3 2PJ, NP3 2PL, NP3 2PS, NP3 2PT, NP3 2PU, NP3 2QA",268,247,21
W00007716,NP13,"NP13 2PB, NP13 2PD, NP13 2PF, NP2 2QD, NP3 2PD, NP3 2PR",278,262,16
W00007715,NP13,"NP13 2LH, NP13 2LW, NP13 2NF, NP13 2NG, NP13 2PG, NP13 2PP, NP3 2LQ, NP3 2NA, NP3 2PQ, NP3 2XD",241,221,20
W00007597,NP13,"NP13 1BQ, NP13 1EZ, NP13 1HL, NP13 1HU, NP13 1JA, NP13 1JB, NP13 1QL, NP13 1QQ, NP13 1YH, NP13 1YL, NP13 1YN, NP13 1YP, NP3 1EH, NP3 1EZ, NP3 1HB, NP3 1HN, NP3 1HU, NP3 1HW, NP3 1HX, NP3 1HY, NP3 1JA, NP3 1YJ, NP3 1YL, NP3 1YP, NP3 1ZY",214,209,5
W00007713,NP13,"NP13 2LR, NP13 2LS, NP13 2LT, NP13 2LU, NP13 2LX, NP13 2QB, NP13 2QE, NP13 2QF, NP13 2QG, NP13 2QQ, NP3 2LR, NP3 2LU, NP3 2LX, NP3 2LY, NP3 2QF, NP3 2QG",266,240,26
W00007660,NP13,"NP13 2AT, NP13 2HB, NP13 2HE, NP13 2HP, NP13 2HQ, NP13 2HR, NP13 2HT, NP13 2JW, NP3 2HA, NP3 2HB, NP3 2HD, NP3 2HF, NP3 2HJ, NP3 2HP, NP3 2HR",237,228,9
W00007712,NP13,"NP13 2ND, NP13 2NH, NP13 2NN, NP13 2NQ, NP13 2NS, NP23 6AN, NP3 1XB, NP3 2ND, NP3 2NE, NP3 2NF, NP3 2NG, NP3 2NH",193,176,17
W00007710,NP13,"NP13 2EG, NP13 2EQ, NP13 2ER, NP13 2NJ, NP13 2NL, NP13 2NP, NP13 2NR, NP13 2NW, NP3 1UP, NP3 1YA, NP3 1YD, NP3 1YN, NP3 2BR, NP3 2EF, NP3 2EG, NP3 2EJ, NP3 2EQ, NP3 2JU, NP3 2LJ, NP3 2LT, NP3 2NB, NP3 2NJ, NP3 2NL, NP3 2NN, NP3 2NP, NP3 2NR, NP3 2NS, NP3 2NT, NP3 2NW, NP3 2NZ, NP3 2QB, NP3 2QD, NP3 2XG, NP3 2XL, NP3 2XS, NP3 2XT, NP3 2YB, NP3 2YD",245,234,11
W00007669,NP13,"NP13 3AH, NP13 3AL, NP13 3AP, NP13 3AR, NP13 3AS, NP23 4UE, NP23 4UF, NP23 4UH, NP23 4UN, NP23 4UW, NP3 3AR, NP3 4UH, NP3 4UJ, NP3 4UW, NP3 4UY, NP3 4WB, NP3 4WE",258,239,19
W00007668,NP13,"NP13 3AD, NP13 3DG, NP13 3DJ, NP13 3DQ, NP23 4LQ, NP23 4LR, NP23 4LS, NP23 4LT, NP23 4LX, NP23 4LY, NP23 4LZ, NP23 4NQ, NP23 4NW, NP23 4QG, NP23 4QH, NP23 4QQ, NP23 4UA, NP23 4UB, NP23 4UD, NP3 3AD, NP3 3AH, NP3 3AW, NP3 3BS, NP3 3DG, NP3 3DJ, NP3 4LR, NP3 4LS, NP3 4LT, NP3 4QH, NP3 4QQ, NP3 4QZ, NP3 4UD, NP3 4UF, NP3 4UL, NP3 4UN, NP3 4UR",393,362,31
W00007664,NP13,"NP13 2JE, NP13 2JF, NP13 2JG, NP13 2JQ, NP3 2JE, NP3 2JF, NP3 2JG, NP3 2JJ, NP3 2JL, NP3 2JQ",215,208,7
W00007663,NP13,"NP13 2HA, NP13 2HJ, NP13 2HL, NP13 2HY, NP13 2HZ, NP13 2RJ, NP3 2HL, NP3 2HN, NP3 2HX, NP3 2HZ",257,235,22
W00007662,NP13,"NP13 2HD, NP13 2HG, NP13 2HH, NP13 2HN, NP13 2HX, NP13 2JN",252,246,6
W00007711,NP13,"NP13 2LJ, NP13 2LL, NP13 2LP, NP13 2LY, NP13 2QD, NP13 2QH, NP13 2QJ, NP13 2QL, NP13 2QP, NP3 2PB, NP3 2PE, NP3 2QE, NP3 2QH, NP3 2QJ, NP3 2QL, NP3 2QP, NP3 2QQ, NP3 2RB",205,189,16
W00007596,NP13,"NP13 1NE, NP13 1NP, NP13 1NR, NP3 1PG",316,290,26
W00007553,NP13,"NP13 3DU, NP13 3DW, NP13 3DY, NP13 3EQ, NP3 3DN, NP3 3DT, NP3 3DU, NP3 3DW, NP3 3EE, NP3 3EG, NP3 3EQ",253,237,16
W00007594,NP13,"NP13 1NF, NP13 1NH, NP13 1NJ, NP13 1NL, NP13 1PA, NP13 1PB, NP13 1PG, NP3 1NH, NP3 1NJ, NP3 1NL, NP3 1NW, NP3 1PA, NP3 1PD, NP3 1PJ, NP3 1PL, NP3 1PN, NP3 1PP, NP3 1PQ, NP3 1PR, NP3 1PW, NP3 1QQ",301,282,19
W00007547,NP13,"NP13 3AJ, NP13 3AX, NP13 3AY, NP13 3AZ, NP13 3BA, NP13 3BD, NP13 3EH, NP13 3JA, NP13 3JB, NP13 3JL, NP13 3JS, NP13 3JT, NP13 3JX, NP13 3LF, NP13 3LN, NP13 3LQ, NP13 3NA, NP13 3XG, NP3 3AJ, NP3 3AP, NP3 3AS, NP3 3AT, NP3 3AU, NP3 3AX, NP3 3AY, NP3 3AZ, NP3 3BA, NP3 3BB, NP3 3JA, NP3 3JB, NP3 3LF, NP3 3LW, NP3 3LZ, NP3 3NA, NP3 3XF, NP3 3XG, NP3 4HP",577,529,48
W00007546,NP13,"NP13 3BG, NP13 3BP, NP13 3BT, NP13 3BU, NP13 3BW, NP13 3BX, NP13 3DD, NP13 3DE, NP13 3DF, NP13 3DH, NP13 3DL, NP3 3AE, NP3 3BP, NP3 3BU, NP3 3BW, NP3 3DA, NP3 3DB, NP3 3DD, NP3 3DF, NP3 3DL",221,216,5
W00007545,NP13,"NP13 3AE, NP13 3AF, NP13 3AT, NP13 3BL, NP13 3BN, NP13 3HA, NP13 3LR, NP3 3AF, NP3 3AG, NP3 3HA, NP3 3HB, NP3 3LB, NP3 3LD, NP3 3XA, NP3 3XB",137,134,3
W00007544,NP13,"NP13 3JG, NP13 3JJ, NP13 3JN, NP13 3JP, NP13 3JR, NP3 3JJ",220,208,12
W00007542,NP13,"NP13 3AU, NP13 3BH, NP13 3DB, NP13 3NG, NP13 3NH, NP13 3NJ, NP13 3NL, NP13 3WT, NP3 3AQ, NP3 3DH, NP3 3XD",245,229,16
W00007541,NP13,"NP13 3BB, NP13 3BE, NP13 3LT, NP13 3LU, NP13 3NB, NP13 3NE, NP13 3NF, NP3 3BN, NP3 3JY, NP3 3LE, NP3 3LG, NP3 3LJ, NP3 3LQ, NP3 3LS, NP3 3LU, NP3 3LY, NP3 3NE",275,252,23
W00007548,NP13,"NP13 3HD, NP13 3HG, NP13 3HH, NP13 3HJ, NP13 3HR, NP13 3HY, NP3 3HD, NP3 3HG, NP3 3HH, NP3 3HJ, NP3 3HL, NP3 3HR, NP3 3HY, NP3 3JR, NP3 3JS, NP3 3YA",252,241,11
W00007540,NP13,"NP13 3LE, NP13 3LG, NP13 3LS, NP13 3LX, NP13 3LY, NP13 3LZ, NP3 3LA, NP3 3LN, NP3 3LX, NP3 3XJ, NP3 4WJ",246,235,11
W00007515,NP13,"NP13 1BX, NP13 1DA, NP13 1DB, NP13 1EA, NP13 1EB, NP13 1ED, NP13 1EF, NP13 1HT, NP13 1NA, NP13 1QA, NP13 1TA, NP13 1UJ, NP13 1XA, NP13 1YE, NP3 1DA, NP3 1DB, NP3 1DD, NP3 1EA, NP3 1EB, NP3 1ED, NP3 1EE, NP3 1EF, NP3 1EG, NP3 1EP, NP3 1HT, NP3 1NA, NP3 1QA, NP3 1RN, NP3 1UJ, NP3 1XA, NP3 1XH, NP3 1YE",204,196,8
W00007513,NP13,"NP13 1EE, NP13 1EG, NP13 1EN, NP13 1EP, NP3 1EJ, NP3 1EN",258,246,12
W00007512,NP13,"NP13 1NB, NP13 1ND, NP13 1NN, NP13 1NQ, NP13 1NY, NP13 1NZ, NP13 1QG, NP13 1QH, NP3 1NN, NP3 1NR, NP3 1QF, NP3 1QG, NP3 1QH, NP3 1YF, NP3 1YG, NP3 1YH, NP3 1YQ",292,276,16
W00007511,NP13,"NP13 1NW, NP13 1QB, NP13 1QE, NP13 1QF, NP13 1QJ, NP13 1YF, NP13 1YG, NP3 1QB, NP3 1QJ",245,234,11
W00007510,NP13,"NP13 1EH, NP13 1EJ, NP13 1EX, NP13 1HB, NP3 1HD, NP3 1HE, NP3 1HF, NP3 1HP",310,295,15
W00007509,NP13,"NP13 1TS, NP13 1TY, NP13 1TZ, NP13 1UA, NP13 2EA, NP13 2EB, NP13 2ED, NP13 3HW, NP3 1ER, NP3 1NP, NP3 1TG, NP3 1TL, NP3 1TN, NP3 1TS, NP3 1TY, NP3 1TZ, NP3 2EA, NP3 2EB, NP3 2ED, NP3 2EH",297,268,29
W00007516,NP13,"NP13 1NG, NP13 1TF, NP13 1TH, NP13 1TJ, NP13 1UB, NP13 1UE, NP13 1UF, NP13 1UH, NP13 1YA, NP3 1NB, NP3 1ND, NP3 1NE, NP3 1NG, NP3 1NQ, NP3 1NY, NP3 1NZ, NP3 1TA, NP3 1TE, NP3 1TF, NP3 1TH, NP3 1TJ, NP3 1UA, NP3 1UE, NP3 1UF, NP3 1UH",277,262,15
W00007595,NP13,"NP13 1SB, NP13 1TG, NP13 1TL, NP13 1TN, NP13 1TP, NP13 1TQ, NP13 1TU, NP13 1TW, NP3 1JT, NP3 1NF, NP3 1SA, NP3 1SB, NP3 1SD, NP3 1SG, NP3 1SH, NP3 1SS, NP3 1ST, NP3 1SU, NP3 1TP, NP3 1TQ, NP3 1TR, NP3 1TT, NP3 1TU, NP3 1TW",305,288,17
W00007549,NP13,"NP13 3BQ, NP13 3BR, NP13 3BS, NP13 3BY, NP13 3BZ, NP13 3DR, NP13 3DS, NP13 3EA, NP13 3EJ, NP3 3BQ, NP3 3BR, NP3 3BX, NP3 3BY, NP3 3BZ, NP3 3DR, NP3 3DS, NP3 3DY, NP3 3DZ, NP3 3EA, NP3 3EB, NP3 3EJ, NP3 3EL, NP3 3ET",234,216,18
W00007551,NP13,"NP13 3DN, NP13 3HE, NP13 3HF, NP13 3HL, NP13 3HN, NP3 3HE, NP3 3HF, NP3 3HN, NP3 3HP, NP3 3HQ, NP3 3HS, NP3 3HW, NP3 3HZ, NP3 3XE",296,268,28
W00007593,NP13,"NP13 1PN, NP13 1PP, NP13 1PR, NP13 1PS, NP13 1PT, NP13 1PU, NP13 1QD, NP13 1QW, NP3 1PS, NP3 1PT, NP3 1PU, NP3 1QD, NP3 1QE, NP3 1QN",278,256,22
W00007592,NP13,"NP13 1PD, NP13 1PJ, NP13 1PL, NP13 1PQ, NP13 1PW, NP13 1PX, NP13 1RT",260,244,16
W00007508,NP13,"NP13 1HD, NP13 1HE, NP13 1HH, NP13 1HJ, NP13 1HN, NP13 1HP, NP13 1HQ, NP13 1HW, NP3 1HH, NP3 1HJ, NP3 1HL, NP3 1HQ, NP3 1JE, NP3 1JX",262,245,17
W00007507,NP13,"NP13 1AP, NP13 1BB, NP13 1BE, NP13 1BF, NP13 1BU, NP3 1AT, NP3 1BD, NP3 1BF, NP3 1BH, NP3 1BN, NP3 1BQ",282,261,21
W00007506,NP13,"NP13 1DN, NP13 1DP, NP13 1DR, NP13 1DU, NP13 1DW, NP13 2LD, NP13 2LE, NP13 2LF, NP3 1AL, NP3 1AP, NP3 1AR, NP3 1BE, NP3 1DN, NP3 1DS, NP3 1DX, NP3 2PP",321,308,13
W00007505,NP13,"NP13 1AB, NP13 1AD, NP13 1AH, NP13 1AJ, NP13 1AL, NP13 1AN, NP13 1AR, NP13 1DD, NP13 1DG, NP13 1DH, NP13 1DJ, NP13 1DL, NP13 1DQ, NP13 1DX, NP13 1XR, NP13 1XT, NP13 1XX, NP13 1YB, NP13 1ZY, NP3 1AA, NP3 1AB, NP3 1AD, NP3 1AE, NP3 1AF, NP3 1AG, NP3 1AJ, NP3 1AS, NP3 1BB, NP3 1XJ, NP3 1XP, NP3 1XS, NP3 1YB",225,217,8
W00007550,NP13,"NP13 3JD, NP13 3JE, NP13 3JF, NP13 3JH, NP3 3JD, NP3 3JE, NP3 3JF, NP3 3JG, NP3 3JQ",327,304,23
W00007504,NP13,"NP13 1AE, NP13 1AF, NP13 1AG, NP13 1AS, NP13 1BD, NP13 1BR, NP13 1BS, NP13 1BY, NP3 1BG, NP3 1BJ, NP3 1BL, NP3 1BP, NP3 1BR, NP3 1BS, NP3 1BT, NP3 1BX, NP3 2PW",273,265,8
W00007502,NP13,"NP13 1AA, NP13 1BG, NP13 1BH, NP13 1BJ, NP13 1BL, NP13 1BN, NP13 1BP, NP13 1BT, NP13 1BW, NP13 1EW, NP13 1HG, NP3 1EL, NP3 1EW",282,258,24
W00007591,NP13,"NP13 1HX, NP13 1HY, NP13 1JE, NP13 1JX, NP3 1LX",245,229,16
W00007590,NP13,"NP13 1AQ, NP13 1LR, NP13 1QY, NP13 1QZ, NP13 1RA, NP13 1RB, NP13 1RE, NP13 1RL, NP13 1RN, NP13 1RR, NP13 1RS, NP13 3EU, NP3 1JF, NP3 1QL, NP3 1QW, NP3 1QY, NP3 1QZ, NP3 1RA, NP3 1RB, NP3 1RD, NP3 1RE, NP3 1RF, NP3 1RL, NP3 1RR, NP3 1RS, NP3 1XE",288,269,19
W00007555,NP13,"NP13 3AA, NP13 3AB, NP13 3AG, NP13 3AN, NP13 3AQ, NP13 3AW, NP13 3BJ, NP13 3DA, NP13 3JQ, NP13 3JU, NP13 3JW, NP13 3JY, NP13 3LB, NP13 3LD, NP13 3LH, NP13 3XB, NP13 3XD, NP3 3AA, NP3 3AB, NP3 3AL, NP3 3AN, NP3 3BG, NP3 3BH, NP3 3JN, NP3 3JP, NP3 3JT, NP3 3JU, NP3 3JW, NP3 3JZ, NP3 3LH, NP3 3XL, NP3 3XN, NP3 3XP, NP3 4UE",342,314,28
W00007554,NP13,"NP13 3EE, NP13 3EG, NP13 3HP, NP13 3HQ, NP13 3HS, NP13 3HZ, NP3 3HT",258,237,21
W00007552,NP13,"NP13 3DP, NP13 3DT, NP13 3DX, NP13 3DZ, NP13 3EB, NP13 3ED, NP13 3HT, NP13 3HU, NP13 3HX, NP3 3DP, NP3 3DX, NP3 3ED, NP3 3HU, NP3 3HX, NP3 3JH, NP3 3XH",267,232,35
W00007503,NP13,"NP13 1DE, NP13 1DF, NP13 1DS, NP13 1DT, NP13 1DY, NP13 1TE, NP13 1UL, NP13 1UP, NP13 1UR, NP13 2EF, NP13 2LB, NP3 1AH, NP3 1AN, NP3 1DE, NP3 1DF, NP3 1DG, NP3 1DH, NP3 1DJ, NP3 1DL, NP3 1DP, NP3 1DQ, NP3 1DR, NP3 1DT, NP3 1DU, NP3 1DW, NP3 1UB, NP3 1UL, NP3 1UR, NP3 1XL, NP3 1XR, NP3 1XT, NP3 1XX, NP3 2LB, NP3 2LD, NP3 2LE, NP3 2LF, NP3 2XB",229,216,13
W00007514,NP13,"NP13 1EL, NP13 1EQ, NP13 1ES, NP13 1ET, NP13 1HA, NP13 1HF, NP3 1EQ, NP3 1ES, NP3 1ET, NP3 1EX, NP3 1HA",290,273,17
W00007543,NP13,"NP13 3JZ, NP13 3LA, NP13 3LJ, NP13 3LL, NP13 3LP, NP3 3BD, NP3 3BE, NP3 3JX, NP3 3LL, NP3 3LP, NP3 3NB, NP3 3NF, NP3 3NG, NP3 3NH, NP3 3NJ, NP3 3NL",255,236,19
W00008171,NP15,"NP15 2DJ, NP15 2LE, NP15 2LF, NP15 2LG, NP15 2LL, NP15 2LQ, NP25 5EN, NP25 5HL, NP25 5HN, NP25 5HP, NP25 5HR, NP25 5HW, NP5 2DJ, NP5 2LE, NP5 2LF, NP5 2LG, NP5 2LQ, NP5 4DU, NP5 4HJ, NP5 4HL, NP5 4HN, NP5 4HP, NP5 4HW, NP7 8SU, NP7 8SY, NP7 8TB, NP7 8TD, NP7 8TE, NP7 8TF, NP7 8TL, NP7 8TN",360,328,32
W00008133,NP15,"NP15 1DD, NP15 1FA, NP15 1GY, NP15 1HR, NP15 1HS, NP15 1HT, NP15 1HU, NP15 1HY, NP15 1HZ, NP15 1JA, NP15 1JB, NP15 1JD, NP15 1JE, NP15 1JF, NP15 1JG, NP15 1JH, NP15 1JQ, NP15 1JU, NP15 1JX, NP15 1JZ, NP15 1LA, NP15 1LB, NP15 1LD, NP15 1PP, NP15 1QX, NP15 1RA, NP15 1RB, NP15 1RD, NP15 1RE, NP15 1RG, NP15 1RH, NP15 1RJ, NP15 1RL, NP15 1RP, NP15 1RQ, NP15 1RT, NP5 1DD, NP5 1HR, NP5 1HS, NP5 1HT, NP5 1HY, NP5 1HZ, NP5 1JA, NP5 1JB, NP5 1JD, NP5 1JE, NP5 1JF, NP5 1JG, NP5 1JH, NP5 1JQ, NP5 1JU, NP5 1JX, NP5 1JZ, NP5 1LA, NP5 1LB, NP5 1LD, NP5 1PP, NP5 1QX, NP5 1RA, NP5 1RB, NP5 1RD, NP5 1RE, NP5 1RG, NP5 1RH, NP5 1RJ, NP5 1RL, NP5 1RP, NP5 1RQ, NP5 1RS, NP5 1RT, NP5 1RU, NP5 1RW",493,451,42
W00008283,NP15,"NP15 1LF, NP15 1LX, NP15 1NA, NP16 6AL, NP16 6AN, NP16 6AP, NP16 6AR, NP16 6AS, NP16 6AT, NP16 6AU, NP16 6AW, NP16 6BA, NP16 6FE, NP16 6RD, NP16 6RE, NP16 6RF, NP16 6RH, NP16 6RX, NP16 6RY, NP16 6RZ, NP16 6SA, NP16 6SB, NP16 6SL, NP16 6TZ, NP5 1LF, NP5 1LX, NP5 1NA, NP6 3AZ, NP6 3BH, NP6 6AL, NP6 6AN, NP6 6AP, NP6 6AR, NP6 6AS, NP6 6AU, NP6 6AW, NP6 6RD, NP6 6RE, NP6 6RF, NP6 6RH, NP6 6RN, NP6 6RY, NP6 6RZ, NP6 6SB",464,441,23
W00008109,NP15,"NP15 1QP, NP4 0AE, NP4 0AG, NP4 0BN, NP4 8SD, NP5 1QD, NP7 9DH, NP7 9DL, NP7 9DN, NP7 9DP, NP7 9DR, NP7 9DW, NP7 9EG, NP7 9EH, NP7 9EL, NP7 9EN, NP7 9EP, NP7 9EW",263,233,30
W00008307,NP15,"NP15 1AH, NP15 1AP, NP15 1AS, NP15 1AW, NP15 1AY, NP15 1AZ, NP15 1DQ, NP5 1AF, NP5 1AH, NP5 1AL, NP5 1AP, NP5 1AR, NP5 1AS, NP5 1AW, NP5 1AZ, NP5 1TF, NP5 1XP",249,235,14
W00008308,NP15,"NP15 1HX, NP15 1RU, NP15 1RX, NP15 1RY, NP15 1RZ, NP15 1SA, NP15 1SB, NP15 1SD, NP15 1SG, NP5 1BQ, NP5 1RZ, NP5 1SA, NP5 1SB, NP5 1SD, NP5 1SP, NP5 1SQ, NP5 1SR, NP5 1SW",312,284,28
W00008309,NP15,"NP15 1AA, NP15 1SE, NP15 1SH, NP15 1SJ, NP15 1SL, NP15 1ST, NP5 1SG, NP5 1SJ, NP5 1SL, NP5 1SN, NP5 1ST",287,270,17
W00008311,NP15,"NP15 1AD, NP15 1AG, NP15 1AJ, NP15 1AN, NP15 1AR, NP15 1AX, NP15 1BD, NP15 1BJ, NP15 1BR, NP15 1BY, NP15 1FB, NP15 1XP, NP5 1AD, NP5 1BB, NP5 1BD, NP5 1BE, NP5 1BU, NP5 1BW, NP5 1BY, NP5 1BZ, NP5 1XN, NP5 1XR, NP5 1XW",557,511,46
W00008134,NP15,"NP15 1PR, NP15 1PS, NP15 1PT, NP15 1PX, NP15 1QA, NP15 1QB, NP15 1QD, NP15 1QG, NP15 1QH, NP15 1QJ, NP15 1QS, NP15 1QT, NP15 1XL, NP4 0TD, NP4 0TE, NP4 0TF, NP4 0TG, NP4 0TJ, NP4 0TX, NP4 0TY, NP4 0TZ, NP4 0UA, NP4 0UB, NP4 8RT, NP4 8RU, NP5 1PR, NP5 1PS, NP5 1PT, NP5 1PX, NP5 1QA, NP5 1QB, NP5 1QF, NP5 1QG, NP5 1QH, NP5 1QJ, NP5 1QQ, NP5 1QS, NP5 1QT",519,495,24
W00008314,NP15,"NP15 1AB, NP15 1AE, NP15 1AQ, NP15 1BF, NP15 1RW, NP15 1UA, NP15 1WA, NP15 1WB, NP15 1WZ, NP5 1AA, NP5 1AB, NP5 1AG, NP5 1AX, NP5 1BF, NP5 1BH, NP5 1BJ, NP5 1BR, NP5 1XS, NP5 1XT, NP5 1XU, NP5 1YF, NP5 1YH, NP5 1YL, NP5 1YN, NP5 1YS, NP5 1YT, NP5 1YU, NP5 1YW, NP5 1YX, NP5 1YY, NP5 1ZY",160,153,7
W00008083,NP15,"NP15 1DT, NP15 1DU, NP15 1EH, NP16 6BX, NP16 6BY, NP16 6DA, NP16 6DB, NP16 6DD, NP16 6DG, NP16 6DH, NP16 6DJ, NP16 6NU, NP16 6NX, NP16 6NY, NP16 6NZ, NP16 6PA, NP16 6PB, NP16 6PD, NP16 6PJ, NP16 6PL, NP16 6PN, NP16 6PP, NP16 6PR, NP16 6PT, NP16 6PW, NP5 1DT, NP5 1DU, NP5 1EH, NP6 6BU, NP6 6BY, NP6 6BZ, NP6 6DA, NP6 6DB, NP6 6DD, NP6 6DG, NP6 6DY, NP6 6DZ, NP6 6NU, NP6 6NX, NP6 6NY, NP6 6NZ, NP6 6PA, NP6 6PB, NP6 6PD, NP6 6PN, NP6 6PP, NP6 6PR, NP6 6PT, NP6 6PU, NP6 6PW, NP6 6SA",344,318,26
W00008172,NP15,"NP15 2DE, NP15 2DF, NP15 2DH, NP15 2LJ, NP5 2DE, NP5 2DF, NP5 2DH, NP5 2LJ, NP7 8AJ, NP7 8AL, NP7 8LA, NP7 8NT, NP7 8NU, NP7 8NY, NP7 8PA, NP7 8PU, NP7 8PY, NP7 8RA, NP7 8RB, NP7 8RL, NP7 8SR, NP7 8SS, NP7 8ST, NP7 8TA, NP7 8TG, NP7 8TH, NP7 8UD, NP7 8UE",370,327,43
W00009802,NP15,"NP15 1SN, NP15 1SP, NP15 1SQ, NP15 1SR, NP15 1TN, NP15 1TR, NP15 1TS, NP5 1QY, NP5 1SS",297,279,18
W00009806,NP15,"NP15 1BP, NP15 1BS, NP15 1BT, NP15 1GZ, NP15 1QN, NP15 1QW, NP15 1QY, NP15 1QZ, NP15 1RR, NP15 1SF, NP15 1TZ, NP5 1BP, NP5 1BS, NP5 1QZ, NP5 1RR, NP5 1SE, NP5 1SF, NP5 1SH, NP5 1XB, NP5 1XD",275,248,27
W00009809,NP15,"NP15 1AF, NP15 1BB, NP15 1BL, NP15 1BX, NP15 1HN, NP15 1LH, NP15 1YA, NP15 1YQ, NP5 1BN, NP5 1BX, NP5 1LH, NP5 1YA, NP5 1YB, NP5 1YD, NP5 1YE, NP5 1YG, NP5 1YJ, NP5 1YP, NP5 1YQ, NP5 1YR",113,109,4
W00009814,NP15,"NP15 1BE, NP15 1BH, NP15 1BN, NP15 1BU, NP15 1BW, NP15 1BZ, NP15 1XB, NP5 1BT",123,118,5
W00009817,NP15,"NP15 1EL, NP15 1NL, NP15 1NP, NP15 1NR, NP15 1NT, NP15 1NU, NP15 1PA, NP15 1PJ, NP15 1PN, NP15 1PQ, NP15 1PZ, NP15 1QF, NP15 1QU, NP15 1RF, NP15 1TT, NP15 1TU, NP15 1TW, NP15 1TX, NP15 1TY, NP5 1NL, NP5 1NP, NP5 1NR, NP5 1NT, NP5 1NU, NP5 1PA, NP5 1PJ, NP5 1PN, NP5 1PZ, NP5 1TT, NP5 1TU, NP5 1TW, NP5 1TX, NP5 1TY",421,392,29
W00008084,NP15,"NP15 1DA, NP15 1DE, NP15 1DF, NP15 1DX, NP15 1EF, NP15 1EP, NP15 1ET, NP15 1EU, NP15 1EX, NP15 1HA, NP15 1HB, NP15 1HD, NP15 1HG, NP15 1HH, NP15 1HJ, NP15 1HL, NP15 1HP, NP15 1HQ, NP15 1HW, NP15 1LT, NP15 1NQ, NP5 1DA, NP5 1DE, NP5 1DF, NP5 1DX, NP5 1EF, NP5 1EG, NP5 1EP, NP5 1EQ, NP5 1ET, NP5 1EU, NP5 1EX, NP5 1HB, NP5 1HD, NP5 1HG, NP5 1HH, NP5 1HJ, NP5 1HL, NP5 1HN, NP5 1HP, NP5 1HQ, NP5 1HW, NP5 1LT, NP6 6AT",405,381,24
W00008135,NP15,"NP15 1GA, NP15 1PL, NP15 1PU, NP15 1PW, NP15 1PY, NP15 1QE, NP15 1QL, NP15 1QR, NP15 1SS, NP15 1SU, NP15 1SX, NP15 1SY, NP15 1SZ, NP15 1TA, NP15 1TB, NP15 1TD, NP15 1TE, NP15 1TF, NP15 1TG, NP15 1TJ, NP15 1TL, NP15 1TP, NP15 1TQ, NP15 1XJ, NP15 9BA, NP15 9TA, NP15 9ZZ, NP5 1HU, NP5 1HX, NP5 1PL, NP5 1PU, NP5 1PW, NP5 1PY, NP5 1QE, NP5 1QL, NP5 1QP, NP5 1QR, NP5 1SU, NP5 1SX, NP5 1SY, NP5 1SZ, NP5 1TA, NP5 1TB, NP5 1TD, NP5 1TE, NP5 1TG, NP5 1TJ, NP5 1TL, NP5 1TP, NP5 1TQ, NP5 1XJ, NP5 1XL",337,311,26
W00008313,NP15,"NP15 1AL, NP15 1AT, NP15 1AU, NP15 1BA, NP15 1BG, NP15 1BQ, NP15 1EA, NP15 1ED, NP15 1EG, NP15 1SW, NP15 1WD, NP15 1WE, NP15 1WH, NP15 1WL, NP15 1WN, NP15 1WP, NP15 1WQ, NP15 1WR, NP15 1WS, NP15 1WT, NP15 1WU, NP15 1WW, NP15 1WX, NP15 1WY, NP15 1XA, NP15 1XD, NP15 1XE, NP15 1XF, NP15 1XH, NP15 1XQ, NP15 1XW, NP15 1XY, NP15 1XZ, NP15 1YB, NP15 1YD, NP15 1YE, NP15 1YF, NP15 1YG, NP15 1YH, NP15 1YJ, NP15 1YL, NP15 1YN, NP15 1YP, NP15 1YR, NP15 1YS, NP15 1YT, NP15 1YU, NP15 1YW, NP15 1YX, NP15 1YY, NP15 1YZ, NP15 1ZA, NP15 1ZB, NP15 1ZR, NP15 1ZT, NP15 1ZW, NP15 1ZY, NP15 2WA, NP15 2WY, NP15 2WZ, NP15 2YA, NP15 2YF, NP15 2YG, NP15 2YS, NP15 9AA, NP15 9AE, NP15 9AG, NP15 9AH, NP15 9AJ, NP15 9AL, NP15 9AN, NP15 9AQ, NP15 9AR, NP15 9AS, NP15 9AT, NP15 9AU, NP15 9AW, NP15 9AX, NP15 9AY, NP15 9AZ, NP5 1AE, NP5 1AJ, NP5 1AN, NP5 1AQ, NP5 1AT, NP5 1AU, NP5 1AY, NP5 1BA, NP5 1BG, NP5 1RX, NP5 1RY, NP5 1XA, NP5 1XE, NP5 1XF, NP5 1XG, NP5 1XH, NP5 1XQ",216,206,10
W00008160,NP15,"NP15 1DB, NP15 1EJ, NP15 1EN, NP15 1ER, NP15 1ES, NP15 1EW, NP15 1EY, NP15 1EZ, NP15 1HE, NP15 1HF, NP15 1LE, NP15 1LG, NP15 1LJ, NP15 1LL, NP15 1LN, NP15 1LP, NP15 1LQ, NP15 1LR, NP15 1LS, NP15 1LU, NP15 1LW, NP15 1NB, NP15 1ND, NP15 1NE, NP15 1NF, NP15 1NG, NP15 1NH, NP5 1BL, NP5 1EA, NP5 1EJ, NP5 1EL, NP5 1EN, NP5 1ER, NP5 1ES, NP5 1EW, NP5 1EY, NP5 1EZ, NP5 1HA, NP5 1HE, NP5 1HF, NP5 1LE, NP5 1LG, NP5 1LJ, NP5 1LL, NP5 1LN, NP5 1LP, NP5 1LQ, NP5 1LR, NP5 1LS, NP5 1LU, NP5 1LW, NP5 1NB, NP5 1ND, NP5 1NE, NP5 1NF, NP5 1NG, NP5 1NH, NP5 1NQ",424,398,26
W00008161,NP15,"NP15 1JJ, NP15 1JR, NP15 1JT, NP15 2AJ, NP15 2AL, NP15 2AP, NP15 2AR, NP15 2AS, NP15 2AT, NP15 2AU, NP15 2AW, NP15 2AZ, NP15 2BA, NP15 2BB, NP15 2BD, NP15 2BE, NP15 2BJ, NP15 2BN, NP15 2BP, NP15 2BQ, NP15 2BR, NP15 2BS, NP15 2YB, NP15 2YD, NP5 1JP, NP5 1JR, NP5 1JT, NP5 2AF, NP5 2AP, NP5 2AR, NP5 2AS, NP5 2AT, NP5 2AU, NP5 2AW, NP5 2AX, NP5 2AZ, NP5 2BA, NP5 2BB, NP5 2BD, NP5 2BE, NP5 2BG, NP5 2BN, NP5 2BQ, NP5 2BR, NP5 2BS, NP5 2DG, NP5 2YD, NP5 2YE, NP5 2YF, NP5 2YG, NP5 2YH, NP5 2YJ, NP5 2YL, NP7 9BH, NP7 9BJ, NP7 9BL, NP7 9BN, NP7 9BW, NP7 9UA, NP7 9UE",292,267,25
W00008162,NP15,"NP15 1EQ, NP15 1JL, NP15 1JN, NP15 1JP, NP15 1JS, NP15 1JW, NP15 1JY, NP15 2AB, NP15 2AE, NP15 2AF, NP15 2AG, NP15 2AH, NP15 2AN, NP15 2BG, NP15 2BH, NP15 2BL, NP15 2BW, NP15 2DA, NP15 2DB, NP15 2JG, NP15 2JH, NP15 2JJ, NP15 2JP, NP15 2JQ, NP5 1JJ, NP5 1JL, NP5 1JN, NP5 1JS, NP5 1JW, NP5 1JY, NP5 2AB, NP5 2AD, NP5 2AE, NP5 2AG, NP5 2AJ, NP5 2AL, NP5 2AN, NP5 2AQ, NP5 2BH, NP5 2BJ, NP5 2BL, NP5 2BP, NP5 2BW, NP5 2BZ, NP5 2DA, NP5 2DB, NP5 2JG, NP5 2JH, NP5 2JJ, NP5 2JP, NP5 2JQ, NP5 2YB",281,252,29
W00008163,NP15,"NP15 2AQ, NP15 2AX, NP15 2AY, NP15 2DD, NP15 2DN, NP15 2LU, NP15 2LX, NP15 2LY, NP15 2LZ, NP15 2NA, NP15 2NB, NP15 2XZ, NP5 2AH, NP5 2AY, NP5 2DD, NP5 2DN, NP5 2LU, NP5 2LX, NP5 2LY, NP5 2LZ, NP5 2NA, NP5 2NB, NP5 2XZ, NP7 8SG, NP7 8SH, NP7 8SL, NP7 8SN, NP7 8SW, NP7 9UB",255,234,21
W00008159,NP15,"NP15 1LY, NP15 1LZ, NP15 1NS, NP15 1PE, NP15 1PF, NP18 1HS, NP18 1HT, NP18 1HU, NP18 1HW, NP18 1LR, NP18 1LS, NP18 1LT, NP18 1LU, NP18 1LW, NP18 1NU, NP5 1LY, NP5 1LZ, NP5 1NS, NP5 1PE, NP5 1PF, NP6 1HL, NP6 1HN, NP6 1HS, NP6 1HT, NP6 1HU, NP6 1HW, NP6 1JB, NP6 1LQ, NP6 1LR, NP6 1LS, NP6 1LT, NP6 1LU, NP6 1LW, NP6 1LX, NP6 1LY, NP6 1LZ",491,442,49
W00008157,NP15,"NP15 1NJ, NP15 1NN, NP15 1NW, NP15 1NX, NP15 1NY, NP15 1NZ, NP15 1PB, NP15 1PD, NP15 1PG, NP15 1PH, NP15 1QQ, NP15 1TH, NP18 1DD, NP18 1HP, NP18 1HX, NP18 1HY, NP18 1HZ, NP18 1JA, NP4 0SS, NP4 0SY, NP4 0SZ, NP4 0TB, NP4 0TH, NP4 0TQ, NP44 2BY, NP44 2DB, NP44 2DE, NP5 1NJ, NP5 1NN, NP5 1NW, NP5 1NX, NP5 1NY, NP5 1NZ, NP5 1PB, NP5 1PD, NP5 1PG, NP5 1PH, NP5 1PQ, NP5 1TH, NP5 1UA, NP6 1HP, NP6 1HX, NP6 1HY, NP6 1HZ, NP6 1JA",442,418,24
W00008232,NP15,"NP15 1DJ, NP15 2AA, NP15 2BT, NP15 2BX, NP15 2DX, NP15 2ER, NP15 2ES, NP15 2EU, NP15 2EX, NP15 2EY, NP15 2EZ, NP15 2HH, NP15 2HN, NP15 2HQ, NP15 2HR, NP15 2HW, NP15 2HY, NP15 2HZ, NP15 2JL, NP15 2LD, NP15 2YH, NP25 4BB, NP25 4BN, NP25 4BS, NP25 4BT, NP25 4BU, NP25 4BW, NP25 4DA, NP5 1DJ, NP5 2AA, NP5 2BT, NP5 2BX, NP5 2EB, NP5 2ER, NP5 2ES, NP5 2EU, NP5 2EX, NP5 2EY, NP5 2EZ, NP5 2HH, NP5 2HN, NP5 2HR, NP5 2HW, NP5 2HZ, NP5 2JB, NP5 2JL, NP5 2LA, NP5 2LB, NP5 2LD, NP5 2YA, NP5 4BN, NP5 4BS, NP5 4BW",367,337,30
W00008233,NP15,"NP15 2DP, NP15 2DS, NP15 2DY, NP15 2EA, NP15 2EB, NP15 2ED, NP15 2EH, NP15 2EN, NP15 2HE, NP15 2HF, NP15 2YE, NP5 2DP, NP5 2DR, NP5 2DS, NP5 2DX, NP5 2DY, NP5 2DZ, NP5 2EH, NP5 2EJ, NP5 2EN, NP5 2EP, NP5 2HE",283,250,33
W00008230,NP15,"NP15 2AD, NP15 2FA, NP15 2FB, NP15 2FD, NP15 2HA, NP15 2HB, NP15 2HD, NP5 2EG, NP5 2FA, NP5 2FB, NP5 2HA, NP5 2HB, NP5 2HD, NP5 2HF",250,232,18
W00008234,NP15,"NP15 1DG, NP15 1DH, NP15 1DL, NP15 1DN, NP15 1DP, NP15 1DR, NP15 1DS, NP15 1DW, NP15 1DY, NP15 1DZ, NP15 1EB, NP15 1EE, NP15 1RS, NP15 2HP, NP15 2HS, NP15 2HT, NP15 2HU, NP15 2HX, NP15 2JA, NP5 1DB, NP5 1DG, NP5 1DH, NP5 1DL, NP5 1DN, NP5 1DP, NP5 1DQ, NP5 1DR, NP5 1DS, NP5 1DW, NP5 1DY, NP5 1DZ, NP5 1EB, NP5 1ED, NP5 1EE, NP5 2HP, NP5 2HS, NP5 2HT, NP5 2HU, NP5 2HX, NP5 2HY, NP5 2JA",379,336,43
W00008235,NP15,"NP15 2DR, NP15 2DT, NP15 2DU, NP15 2DW, NP15 2EP, NP15 2ET, NP15 2HG, NP15 2JU, NP15 2JW, NP15 2JX, NP15 2JY, NP15 2JZ, NP15 2LA, NP15 2LB, NP5 2BU, NP5 2DT, NP5 2DU, NP5 2DW, NP5 2ET, NP5 2HG, NP5 2HQ, NP5 2JU, NP5 2JW, NP5 2JX, NP5 2JY, NP5 2JZ",322,295,27
W00008202,NP15,"NP15 2BY, NP15 2BZ, NP15 2DL, NP15 2LH, NP15 2LN, NP25 4DL, NP25 4DR, NP25 4DS, NP25 4DT, NP25 4DU, NP25 4DX, NP25 4DY, NP25 4DZ, NP25 4EA, NP25 4EB, NP25 4ED, NP25 5EP, NP5 2BY, NP5 2DL, NP5 2LH, NP5 2LL, NP5 2LN, NP5 4BG, NP5 4BR, NP5 4DJ, NP5 4DL, NP5 4DR, NP5 4DS, NP5 4DT, NP5 4DX, NP5 4DY, NP5 4DZ, NP5 4EA, NP5 4EB, NP5 4ED, NP5 4EP",315,285,30
W00008231,NP15,"NP15 2EE, NP15 2EF, NP15 2EG, NP15 2EJ, NP15 2EL, NP15 2EQ, NP15 2EW, NP15 2HJ, NP15 2HL, NP15 2JB, NP5 2EA, NP5 2ED, NP5 2EE, NP5 2EF, NP5 2EL, NP5 2EQ, NP5 2EW, NP5 2HJ, NP5 2HL",300,270,30
W00008246,NP16,"NP16 5AA, NP16 5QH, NP16 5QJ, NP16 5QN, NP16 5QQ, NP16 5QT, NP16 5QW, NP6 5QE, NP6 5QG, NP6 5QH, NP6 5QJ, NP6 5QQ, NP6 5QR, NP6 5QS, NP6 5QU, NP6 5QW",299,274,25
W00008247,NP16,"NP16 5AH, NP16 5AQ, NP16 5RF, NP16 5RH, NP16 5RR, NP6 5RH, NP6 5RJ",269,252,17
W00008081,NP16,"NP16 6FD, NP16 6NB, NP16 6NN, NP16 6NR, NP16 6NS, NP16 6NT, NP16 6NW, NP16 6PF, NP16 6PG, NP16 6PS, NP16 6PZ, NP6 6NN, NP6 6NR, NP6 6NS, NP6 6NT, NP6 6NW, NP6 6PF, NP6 6PG, NP6 6PS, NP6 6PY, NP6 6PZ",309,276,33
W00008082,NP16,"NP16 6BD, NP16 6BL, NP16 6BN, NP16 6BP, NP16 6BR, NP16 6BS, NP16 6BW, NP16 6BZ, NP16 6PE, NP16 6PH, NP16 6PQ, NP16 6PU, NP16 6PX, NP16 6QA, NP16 6SS, NP16 6XP, NP16 6XQ, NP16 6YF, NP16 6YL, NP6 6BD, NP6 6BL, NP6 6BN, NP6 6BR, NP6 6BS, NP6 6BW, NP6 6BX, NP6 6PE, NP6 6PH, NP6 6PJ, NP6 6PL, NP6 6PQ, NP6 6PX, NP6 6YD, NP6 6YF, NP6 6YH, NP6 6YU",315,290,25
W00008046,NP16,"NP16 6LN, NP16 6LP, NP16 6LS, NP16 6LU, NP16 6LW, NP16 6LX, NP16 6LY, NP16 6LZ, NP16 6RA, NP16 6RB, NP16 6SR, NP16 6TA, NP16 6UH, NP26 5PA, NP26 5PD, NP6 4PA, NP6 6LN, NP6 6LP, NP6 6LS, NP6 6LU, NP6 6LW, NP6 6LX, NP6 6LY, NP6 6LZ, NP6 6RA, NP6 6RB, NP6 6YB, NP6 6YG, NP6 6YJ, NP6 6YL, NP6 6YY",294,269,25
W00009816,NP16,"NP16 5AY, NP16 5BB, NP16 5BL, NP16 5BN, NP16 5XP, NP16 5XR, NP16 5YX, NP16 6AA, NP16 6AB, NP16 6AD, NP6 5BA, NP6 5BD, NP6 5BL, NP6 5BP, NP6 5YU, NP6 6AA, NP6 6AB",255,237,18
W00009815,NP16,"NP16 5UG, NP16 6BB, NP16 6DP, NP16 6DQ, NP6 5YX, NP6 6BE",273,235,38
W00009810,NP16,"NP16 6DS, NP16 6DT, NP16 6DU, NP16 6DX",289,256,33
W00009807,NP16,"NP16 5LZ, NP16 5SD, NP16 5TN, NP16 5TW, NP16 5TX, NP16 5TZ, NP16 6BE, NP16 6FA, NP16 6YE, NP6 5LY, NP6 5LZ, NP6 5SA, NP6 5SD, NP6 6AE, NP6 6BG, NP6 6YE, NP6 6YN, NP6 6YP, NP6 6YQ, NP6 6YR, NP6 6YW",372,327,45
W00009803,NP16,"NP16 6AE, NP16 6AZ, NP16 6DR, NP16 6DW, NP16 6FB",323,278,45
W00008303,NP16,"NP16 6NA, NP16 6ND, NP16 6NE, NP16 6NG, NP16 6NH, NP16 6NP, NP16 6NQ, NP16 6PY, NP16 6UG, NP16 6UL, NP25 4PN, NP25 4PT, NP25 4PW, NP25 4QD, NP25 4QE, NP25 4QX, NP25 4RD, NP25 4TN, NP5 4PN, NP5 4PT, NP5 4QF, NP5 4QJ, NP5 4TN, NP6 6NA, NP6 6NB, NP6 6ND, NP6 6NE, NP6 6NF, NP6 6NG, NP6 6NH, NP6 6NJ, NP6 6NP, NP6 6NQ",382,358,24
W00008299,NP16,"NP16 6QB, NP16 6QD, NP16 6QE, NP16 6QF, NP16 6QG, NP16 6QH, NP16 6QJ, NP16 6QL, NP16 6QQ, NP16 6QS, NP16 6QT, NP16 6QU, NP16 6QX, NP16 6QY, NP16 6QZ, NP25 4PY, NP6 6QA, NP6 6QB, NP6 6QD, NP6 6QE, NP6 6QF, NP6 6QG, NP6 6QH, NP6 6QJ, NP6 6QL, NP6 6QQ, NP6 6QS, NP6 6QT, NP6 6QU, NP6 6QX, NP6 6QY, NP6 6QZ",371,332,39
W00008297,NP16,"NP16 5FA, NP16 5SW, NP16 5SX, NP16 5SY, NP16 5TA, NP16 6UD, NP16 6UN, NP16 6UP, NP6 5RP, NP6 5RS",251,235,16
W00008261,NP16,"NP16 5EJ, NP16 5EL, NP16 5EN, NP16 5EY, NP16 5EZ, NP16 5FE, NP16 5GA, NP16 5HB, NP16 5HD, NP16 5HZ, NP16 5JA, NP16 5LH, NP16 5LJ, NP16 5LL, NP16 5LN, NP16 5LP, NP16 5LR, NP16 5LW, NP16 5NF, NP16 5UJ, NP16 5UQ, NP16 5UW, NP16 5XG, NP16 5XL, NP16 5XQ, NP16 5XS, NP16 5XX, NP16 5YA, NP16 5YD, NP16 5YH, NP6 5EL, NP6 5EN, NP6 5EP, NP6 5ET, NP6 5EU, NP6 5EW, NP6 5EY, NP6 5HB, NP6 5HD, NP6 5HQ, NP6 5HT, NP6 5JA, NP6 5LG, NP6 5LL, NP6 5LN, NP6 5LQ, NP6 5LS, NP6 5LW, NP6 5PQ, NP6 5UR, NP6 5UW, NP6 5WH, NP6 5WJ, NP6 5WL, NP6 5WN, NP6 5WP, NP6 5XE, NP6 5XG, NP6 5XH, NP6 5XJ, NP6 5XL, NP6 5XN, NP6 5XP, NP6 5XQ, NP6 5XR, NP6 5XS, NP6 5XU, NP6 5XX, NP6 5XY, NP6 5YA, NP6 5YG, NP6 5YH, NP6 5YQ",348,327,21
W00008260,NP16,"NP16 5DA, NP16 5DB, NP16 5DD, NP16 5DE, NP16 5DF, NP16 5DG, NP16 5DH, NP16 5DJ, NP16 5DR, NP16 5DS, NP16 5DT, NP16 5EF, NP16 5XW, NP6 5DA, NP6 5DB, NP6 5DD, NP6 5DE, NP6 5DJ, NP6 5DR, NP6 5DX, NP6 5EF, NP6 5LH, NP6 5UT, NP6 5UU, NP6 5UX, NP6 5XF, NP6 5XW, NP6 5YJ",249,234,15
W00008257,NP16,"NP16 5AU, NP16 5AZ, NP16 5SA, NP16 5SE, NP16 5SF, NP16 5SG, NP16 5SL, NP6 5AU, NP6 5AX, NP6 5NE, NP6 5SB, NP6 5SE, NP6 5SF, NP6 5SG, NP6 5SJ, NP6 5SL, NP6 5SN, NP6 5SP, NP6 5SQ, NP6 5SR, NP6 5SS, NP6 5ST, NP6 5SU, NP6 5SW, NP6 5SX, NP6 5SY, NP6 5SZ, NP6 5TA, NP6 5TB, NP6 5TD, NP6 5TE, NP6 5TF, NP6 5TG, NP6 5TH, NP6 5TJ, NP6 5TL, NP6 5TN, NP6 5TP, NP6 5TQ, NP6 5TR, NP6 5TS, NP6 5TT, NP6 5TU, NP6 5TX, NP6 5TY, NP6 5TZ",342,311,31
W00008129,NP16,"NP16 5JF, NP16 5JG, NP16 5JQ, NP16 5JS, NP16 5JZ, NP16 5LD, NP6 5JD, NP6 5JF, NP6 5JG, NP6 5JL, NP6 5JQ, NP6 5JS, NP6 5JU, NP6 5JZ, NP6 5LA, NP6 5LD, NP6 5QD",305,286,19
W00008130,NP16,"NP16 5BE, NP16 5BH, NP16 5DU, NP16 5JD, NP16 5JE, NP16 5JH, NP16 5JL, NP16 5LA, NP16 5LB, NP6 5DU, NP6 5DW, NP6 5EB, NP6 5JE, NP6 5JJ, NP6 5PN",306,288,18
W00008131,NP16,"NP16 5BD, NP16 5BQ, NP16 5BU, NP16 5BW, NP16 5BX, NP6 5BE, NP6 5BH, NP6 5BQ, NP6 5BU, NP6 5BW",270,258,12
W00008132,NP16,"NP16 5JJ, NP16 5JP, NP16 5JR, NP16 5JT, NP16 5JU, NP16 5JX, NP16 5JY, NP16 5WA, NP16 5WE, NP16 5WJ, NP16 5YJ, NP16 5ZD, NP6 5JR, NP6 5JT, NP6 5UB, NP6 5UE, NP6 5UY, NP6 5UZ, NP6 5WA, NP6 5WD, NP6 5WE, NP6 5WF, NP6 5WG, NP6 5WR, NP6 5YE, NP6 5YF, NP6 5YN, NP6 5YR",367,337,30
W00008249,NP16,"NP16 5AE, NP16 5AJ, NP16 5AL, NP16 5AN, NP16 5AP, NP16 5RA, NP6 5AL, NP6 5AN, NP6 5AW, NP6 5JN, NP6 5XZ",309,282,27
W00008250,NP16,"NP16 5JN, NP16 5JW, NP16 5QE, NP16 5QG, NP16 5QU, NP16 5QX, NP16 5QZ, NP6 5JP, NP6 5JW, NP6 5JX, NP6 5JY, NP6 5QT, NP6 5QX, NP6 5QY, NP6 5QZ, NP6 5XD",255,238,17
W00008251,NP16,"NP16 5AB, NP16 5AD, NP16 5AF, NP16 5AG, NP6 5AA, NP6 5AE, NP6 5AF, NP6 5AG, NP6 5AQ",330,305,25
W00008252,NP16,"NP16 5BA, NP16 5FF, NP16 5PJ, NP16 5PL, NP16 5PN, NP16 5PR, NP16 5PS, NP16 5PT, NP16 5PU, NP16 5PW, NP16 5QB, NP16 5QY, NP16 5UF, NP16 5YS, NP6 5DF, NP6 5DG, NP6 5DS, NP6 5DT, NP6 5JB, NP6 5JH, NP6 5LB, NP6 5PR, NP6 5PS, NP6 5PT, NP6 5PU, NP6 5PW",323,302,21
W00008253,NP16,"NP16 5BJ, NP16 5BT, NP16 5EG, NP16 5EH, NP16 5FB, NP16 5FD, NP16 5PP, NP16 5PX, NP16 5PY, NP16 5PZ, NP6 5BJ, NP6 5BN, NP6 5BR, NP6 5BS, NP6 5BT, NP6 5PJ, NP6 5PL, NP6 5PP, NP6 5PX, NP6 5PY, NP6 5PZ, NP6 5QB, NP6 5YP, NP6 5YS, NP6 5YT",298,279,19
W00008298,NP16,"NP16 5GB, NP16 5GE, NP16 5GF, NP16 5GH, NP16 5RU, NP16 5RW, NP16 5SQ, NP16 5SZ, NP16 5TB, NP16 5TD, NP16 5TQ, NP16 5TY, NP16 5UH, NP16 5UP, NP16 6HT, NP6 6HT",438,394,44
W00008254,NP16,"NP16 5LF, NP16 5LS, NP16 5LT, NP16 5LY, NP16 5NZ, NP6 5LF, NP6 5LT, NP6 5NZ",303,275,28
W00008243,NP16,"NP16 6NL, NP16 6SE, NP16 6SG, NP16 6SJ, NP16 6SN, NP16 6SP, NP16 6SQ, NP16 6ST, NP16 6SX, NP16 6TX, NP16 6TY, NP16 7NX, NP6 6NL, NP6 6SJ, NP6 6SL, NP6 6SN, NP6 6SP, NP6 6SQ, NP6 6SR, NP6 6SS, NP6 6ST, NP6 6SX, NP6 6TX, NP6 6TY, NP6 7NH, NP6 7NX",332,314,18
W00008255,NP16,"NP16 5JB, NP16 5LE, NP16 5LU, NP16 5LX, NP16 5NA, NP16 5UA, NP16 5UE, NP6 5LE, NP6 5LU, NP6 5NA, NP6 5UP, NP6 5US",342,313,29
W00008256,NP16,"NP16 5NB, NP16 5ND, NP16 5NE, NP16 5NU, NP16 5QA, NP16 5SB, NP16 5SJ, NP6 5NB, NP6 5ND, NP6 5NU, NP6 5QA, NP6 5SH",265,242,23
W00008245,NP16,"NP16 6HH, NP16 6SD, NP16 6SF, NP16 6SH, NP16 6SY, NP16 6SZ, NP16 6TB, NP16 6TD, NP16 6TE, NP16 6TF, NP16 6TG, NP16 6TH, NP16 6TJ, NP16 6TL, NP16 6TN, NP16 6TQ, NP16 6TW, NP16 6UJ, NP6 6HG, NP6 6HL, NP6 6HQ, NP6 6SD, NP6 6SE, NP6 6SF, NP6 6SH, NP6 6SY, NP6 6SZ, NP6 6TA, NP6 6TB, NP6 6TD, NP6 6TE, NP6 6TF, NP6 6TG, NP6 6TH, NP6 6TJ, NP6 6TL, NP6 6TN, NP6 6TQ, NP6 6TW",253,218,35
W00008244,NP16,"NP16 6HJ, NP16 6HL, NP16 6HQ, NP16 6NF, NP16 6NJ, NP16 6QN, NP16 6QR, NP16 6QW, NP16 6SU, NP16 6TP, NP16 6TR, NP16 6TS, NP16 6TT, NP16 6TU, NP25 4JA, NP5 4JA, NP6 6HJ, NP6 6QN, NP6 6QP, NP6 6QR, NP6 6QW, NP6 6SU, NP6 6TP, NP6 6TR, NP6 6TS, NP6 6TT, NP6 6TU",212,181,31
W00008262,NP16,"NP16 5AX, NP16 5BZ, NP16 5ED, NP16 5ET, NP16 5EW, NP16 5FN, NP16 5HT, NP16 5HU, NP16 5LQ, NP16 5PA, NP16 5PB, NP16 5PD, NP16 5PE, NP16 5PF, NP16 5PG, NP16 5PH, NP16 5PQ, NP16 5QD, NP16 5UB, NP16 5UL, NP16 5UN, NP16 5UT, NP16 5UU, NP16 5UX, NP16 5UY, NP16 5UZ, NP16 5WB, NP16 5WD, NP16 5WF, NP16 5WL, NP16 5WN, NP16 5WP, NP16 5WQ, NP16 5WR, NP16 5WS, NP16 5WT, NP16 5WU, NP16 5WW, NP16 5WX, NP16 5WY, NP16 5WZ, NP16 5XA, NP16 5XB, NP16 5XD, NP16 5XE, NP16 5XF, NP16 5XH, NP16 5XN, NP16 5XU, NP16 5XY, NP16 5XZ, NP16 5YB, NP16 5YE, NP16 5YF, NP16 5YG, NP16 5YL, NP16 5YN, NP16 5YP, NP16 5YQ, NP16 5YR, NP16 5YT, NP16 5YU, NP16 5YW, NP16 5YY, NP16 5YZ, NP16 5ZA, NP16 5ZB, NP16 5ZE, NP16 5ZF, NP16 5ZG, NP16 5ZH, NP16 5ZJ, NP16 5ZL, NP16 5ZQ, NP16 5ZR, NP16 6WA, NP16 6WB, NP16 6WL, NP16 6WN, NP16 6WP, NP16 6WQ, NP16 6WR, NP16 6WS, NP16 6WT, NP16 6WU, NP16 6WW, NP16 6WX, NP16 6WY, NP16 6WZ, NP16 6XB, NP16 6XG, NP16 6XL, NP16 6XN, NP16 6XR, NP16 6XS, NP16 6YB, NP16 6YD, NP16 6YG, NP16 6YH, NP16 6YJ, NP16 6YN, NP16 6YP, NP16 6YQ, NP16 6YR, NP16 6YS, NP16 6YT, NP16 6YU, NP16 6YW, NP16 6YX, NP16 6YY, NP16 6YZ, NP16 6ZA, NP16 6ZB, NP16 6ZD, NP16 6ZE, NP16 6ZG, NP16 6ZS, NP16 7WE, NP16 7WJ, NP16 7WL, NP16 7WN, NP16 7WP, NP16 7WQ, NP16 7WR, NP16 7WS, NP16 7WT, NP16 7WU, NP16 7WW, NP16 7WX, NP16 7WY, NP16 7WZ, NP16 7YA, NP16 7YH, NP16 7YP, NP16 7YQ, NP16 7YR, NP16 7YS, NP16 7YT, NP16 7YU, NP16 7YW, NP16 7YY, NP16 7ZS, NP16 7ZX, NP16 9AB, NP16 9AE, NP16 9AH, NP16 9AL, NP16 9AP, NP16 9AQ, NP16 9AR, NP16 9AS, NP16 9AT, NP16 9AU, NP16 9AW, NP16 9AX, NP16 9AY, NP16 9AZ, NP16 9BA, NP16 9BB, NP16 9BD, NP16 9BE, NP16 9BF, NP16 9BG, NP16 9BH, NP16 9BJ, NP16 9BL, NP16 9BN, NP16 9BP, NP16 9BQ, NP16 9BR, NP16 9BS, NP16 9BT, NP16 9BU, NP16 9BW, NP16 9BX, NP16 9BY, NP16 9BZ, NP16 9DA, NP16 9DB, NP16 9DD, NP16 9DE, NP16 9DF, NP6 5EG, NP6 5EX, NP6 5LJ, NP6 5PA, NP6 5PB, NP6 5PD, NP6 5PE, NP6 5PF, NP6 5PG, NP6 5PH, NP6 5UF, NP6 5UG, NP6 5UH, NP6 5UJ, NP6 5UL, NP6 5UN, NP6 5UQ, NP6 5XA, NP6 5XB, NP6 5YB, NP6 5YD, NP6 5YL, NP6 5YY, NP6 5YZ, NP6 5ZA, NP6 5ZB, NP6 5ZD, NP6 5ZT",236,216,20
W00008263,NP16,"NP16 5DL, NP16 5DN, NP16 5DP, NP16 5DX, NP16 5EE, NP16 5UR, NP16 5US, NP16 5WG, NP16 5WH, NP6 5DL, NP6 5DN, NP6 5ED, NP6 5EE",287,266,21
W00008258,NP16,"NP16 5AT, NP16 5AW, NP16 5BP, NP16 5BR, NP16 5BS, NP16 5BY, NP16 5SN, NP6 5AT, NP6 5BY, NP6 5BZ, NP6 5DH, NP6 5DQ, NP6 5LP, NP6 5LR, NP6 5NF, NP6 5UA, NP6 5UD",294,272,22
W00008265,NP16,"NP16 5FG, NP16 5FH, NP16 5FJ, NP16 5FY, NP16 5HE, NP16 5HF, NP16 5HG, NP16 5HH, NP16 5HJ, NP16 5HL, NP16 5HN, NP16 5HP, NP16 5HQ, NP16 5HS, NP16 5HW, NP16 5XT, NP6 5EZ, NP6 5FA, NP6 5FB, NP6 5HE, NP6 5HF, NP6 5HG, NP6 5HH, NP6 5HL, NP6 5HN, NP6 5HS, NP6 5HW, NP6 5XT",254,245,9
W00008295,NP16,"NP16 5RP, NP16 5RQ, NP16 5RS, NP16 5RT, NP6 5NG, NP6 5NN, NP6 5NW, NP6 5RQ, NP6 5RR, NP6 5RT, NP6 5RU, NP6 5RW, NP6 5RX, NP6 5RY, NP6 5RZ, NP6 6HU",232,219,13
W00008296,NP16,"NP16 5NP, NP16 5NR, NP16 5NW, NP6 5NP, NP6 5NR",271,249,22
W00008292,NP16,"NP16 5AR, NP16 5NH, NP16 5NJ, NP16 5UD, NP6 5AB, NP6 5AD, NP6 5AR, NP6 5AS, NP6 5NH",281,264,17
W00008241,NP16,"NP16 6DZ, NP16 6EB, NP16 6ED, NP16 6EE, NP16 6EL, NP16 6EN, NP16 6EP, NP16 6ER, NP16 6ES, NP16 6ET, NP16 6EU, NP16 6EW, NP16 6HU, NP6 6EA, NP6 6EB, NP6 6ED, NP6 6EE, NP6 6EL, NP6 6EN, NP6 6EP, NP6 6ER, NP6 6ES, NP6 6ET, NP6 6EU, NP6 6EW, NP6 6XA, NP6 6XB, NP6 6XD, NP6 6XE, NP6 6XF, NP6 6XG, NP6 6XH, NP6 6XN, NP6 6XP, NP6 6XQ, NP6 6XR",309,291,18
W00008264,NP16,"NP16 5DQ, NP16 5DW, NP16 5DY, NP16 5DZ, NP16 5EA, NP16 5EB, NP6 5DP, NP6 5DY, NP6 5DZ, NP6 5EA",260,234,26
W00008291,NP16,"NP16 5SR, NP16 5SS, NP16 5ST, NP16 5SU, NP16 5TF, NP16 5TH, NP16 5TJ, NP16 5TL",264,247,17
W00008290,NP16,"NP16 5AS, NP16 5NS, NP16 5NY, NP16 5QF, NP6 5NS, NP6 5NX, NP6 5QN",253,241,12
W00008293,NP16,"NP16 5NT, NP16 5RX, NP16 5RY, NP16 5RZ, NP16 5SH, NP16 5SP, NP16 5TE, NP16 5TG, NP6 5NT",261,239,22
W00008288,NP16,"NP16 5NX, NP16 5QP, NP16 5QR, NP16 5QS, NP6 5QF, NP6 5QL, NP6 5QP",288,261,27
W00008289,NP16,"NP16 5QL, NP16 5TP, NP16 5TR, NP16 5TS, NP16 5TT, NP16 5TU",340,316,24
W00008242,NP16,"NP16 6BH, NP16 6BJ, NP16 6BQ, NP16 6DL, NP16 6DN, NP16 6DY, NP16 6EA, NP16 6EF, NP16 6EG, NP16 6EH, NP16 6EJ, NP16 6EQ, NP16 6EX, NP16 6EY, NP16 6EZ, NP16 6HA, NP16 6HB, NP16 6HD, NP16 6HE, NP16 6HF, NP16 6HG, NP6 5LX, NP6 6BH, NP6 6BJ, NP6 6BQ, NP6 6EF, NP6 6EG, NP6 6EH, NP6 6EJ, NP6 6EQ, NP6 6EX, NP6 6EY, NP6 6EZ, NP6 6HA, NP6 6HB, NP6 6HD, NP6 6HE, NP6 6HF, NP6 6HH",385,353,32
W00008282,NP16,"NP16 6AH, NP16 6AJ, NP16 6AQ, NP16 6AY, NP16 6FF, NP16 6LT, NP16 6QP, NP16 6RG, NP16 6RN, NP16 6RR, NP16 6RT, NP16 6RU, NP16 6SW, NP16 6UA, NP6 6SW",278,256,22
W00008281,NP16,"NP16 6AG, NP16 6AX, NP16 6BT, NP16 6BU, NP16 6DE, NP16 6RJ, NP16 6RL, NP16 6RP, NP16 6RQ, NP16 6RS, NP16 6RW, NP6 6AG, NP6 6AH, NP6 6AJ, NP6 6AQ, NP6 6AX, NP6 6AY, NP6 6AZ, NP6 6BP, NP6 6BT, NP6 6DE, NP6 6RG, NP6 6RJ, NP6 6RL, NP6 6RP, NP6 6RQ, NP6 6RW, NP6 6UA",372,337,35
W00008280,NP16,"NP16 6AF, NP16 6BG, NP16 6HP, NP16 6HZ, NP16 6JS, NP16 6JU, NP16 6JX, NP16 6LF, NP16 6LH, NP16 6LJ, NP16 6LL, NP16 6LR, NP16 6YA, NP26 5UT, NP6 6AD, NP6 6AF, NP6 6HP, NP6 6HW, NP6 6JS, NP6 6JT, NP6 6JU, NP6 6JX, NP6 6LD, NP6 6LF, NP6 6LG, NP6 6LJ, NP6 6LL, NP6 6LR, NP6 6RR, NP6 6YA",247,225,22
W00008279,NP16,"NP16 5BG, NP16 6DF, NP16 6HW, NP16 6HX, NP16 6HY, NP16 6JT, NP16 6JY, NP16 6JZ, NP16 6LA, NP16 6LB, NP16 6LD, NP16 6LE, NP16 6LQ, NP16 6UB, NP16 6UE, NP6 5BB, NP6 5BG, NP6 5BX, NP6 5RA, NP6 5RG, NP6 5RL, NP6 6HX, NP6 6HY, NP6 6JY, NP6 6JZ, NP6 6LB, NP6 6LE, NP6 6LH, NP6 6LQ, NP6 6UB, NP6 6UD, NP6 6UE, NP6 6UF, NP6 6UN, NP6 6UP, NP6 6XJ, NP6 6XL, NP6 6XS",321,278,43
W00008278,NP16,"NP16 6HN, NP16 6HR, NP16 6HS, NP16 6JA, NP16 6JB, NP16 6JD, NP16 6JE, NP16 6JF, NP16 6JG, NP16 6JH, NP16 6JJ, NP16 6JL, NP16 6JN, NP16 6JP, NP16 6JQ, NP16 6JR, NP16 6JW, NP16 6LG, NP16 6UF, NP6 6HN, NP6 6HR, NP6 6HS, NP6 6HZ, NP6 6JA, NP6 6JB, NP6 6JD, NP6 6JE, NP6 6JF, NP6 6JG, NP6 6JH, NP6 6JJ, NP6 6JL, NP6 6JN, NP6 6JP, NP6 6JQ, NP6 6JR, NP6 6JW, NP6 6LA, NP6 6YS, NP6 6YT, NP6 6YZ",396,361,35
W00008266,NP16,"NP16 5EP, NP16 5EQ, NP16 5ER, NP16 5ES, NP16 5EU, NP16 5EX, NP16 5HA, NP16 5HR, NP16 5HX, NP16 5HY, NP16 5LG, NP16 5XJ, NP16 5ZT, NP6 5EH, NP6 5EJ, NP6 5EQ, NP6 5ER, NP6 5ES, NP6 5HA, NP6 5HJ, NP6 5HP, NP6 5HR, NP6 5HU, NP6 5HX, NP6 5HY, NP6 5HZ",184,180,4
W00008248,NP16,"NP16 5RB, NP16 5RD, NP16 5RE, NP16 5RG, NP16 5RJ, NP16 5RL, NP16 5RN, NP6 5AH, NP6 5AJ, NP6 5AP, NP6 5RB, NP6 5RD, NP6 5RE, NP6 5RF, NP6 5RN",254,230,24
W00008294,NP16,"NP16 5NG, NP16 5NL, NP16 5NN, NP16 5NQ, NP16 5ZN, NP6 5NJ, NP6 5NL, NP6 5NQ, NP6 5NY",270,251,19
W00008461,NP18,"NP18 3SA, NP18 3SB, NP18 3SD, NP18 3SE, NP18 3SG, NP6 1SA, NP6 1SG, NP6 1SH, NP6 1SJ, NP6 1SL",269,239,30
W00008460,NP18,"NP18 3RF, NP18 3SF, NP18 3SH, NP18 3SJ, NP6 1SF",199,186,13
W00008462,NP18,"NP18 1AR, NP18 1AT, NP18 1AU, NP18 1AW, NP18 1BB, NP18 1BD, NP18 1BE, NP18 1NG, NP18 1RE, NP6 1AN, NP6 1AP, NP6 1AT, NP6 1AU, NP6 1BB, NP6 1BD, NP6 1BH, NP6 1LH, NP6 1NG, NP6 1XF, NPT 4YA",291,281,10
W00007879,NP18,"NP18 1GY, NP18 1HE, NP18 1HG, NP18 1HL, NP18 1HN, NP18 1PN, NP18 1PP, NP18 1QW, NP6 1GY, NP6 1GZ, NP6 1HE, NP6 1HF, NP6 1HG",390,357,33
W00007882,NP18,"NP18 1GE, NP18 1HR, NP18 1PB, NP18 1PG, NP18 1PH, NP18 1PJ, NP18 1PL, NP18 1PY, NP18 1PZ, NP18 1RY, NP18 1TN, NP6 1GJ, NP6 1HR, NP6 1PH, NP6 1PJ, NP6 1PY, NP6 1PZ",269,253,16
W00007881,NP18,"NP18 1GA, NP18 1GD, NP18 1GQ, NP18 1GR, NP18 1GS, NP18 1GT, NP18 1GW, NP18 1GX, NP18 1GZ, NP18 1HA, NP18 1HB, NP18 1HD, NP6 1GN, NP6 1GQ, NP6 1GR, NP6 1GS, NP6 1GT, NP6 1GU, NP6 1GX, NP6 1HA, NP6 1HB, NP6 1HD, NP6 1PP",286,261,25
W00008511,NP18,"NP18 2JL, NP18 2JQ, NP18 2JS, NP18 2JT, NP18 2JU, NP18 2JW, NP6 2JH, NP6 2JL, NP6 2JS, NP6 2JT, NP6 2JU, NP6 2JW",347,310,37
W00008459,NP18,"NP18 1BU, NP18 1LJ, NP18 1ND, NP18 1NE, NP18 1NH, NP18 1NJ, NP18 1NL, NP18 1NP, NP18 1NQ, NP18 1NR, NP18 1QS, NP18 1XT, NP6 1BE, NP6 1BU, NP6 1LJ, NP6 1LL, NP6 1ND, NP6 1NE, NP6 1NH, NP6 1NJ, NP6 1NL, NP6 1NR, NP6 1XT, NP6 1XU, NP6 1XX, NP6 1XY, NP6 1XZ, NP6 1YB, NP6 1YU, NP6 1YW, NP6 1YX, NP6 1YY, NP6 1ZY, NP9 4XJ, NP9 4YQ, NP9 4YS",297,264,33
W00007883,NP18,"NP18 1GF, NP18 1GG, NP18 1GH, NP18 1GJ, NP18 1GL, NP18 1GN, NP18 1GP, NP18 1GU, NP18 1PA, NP6 1GE, NP6 1GF, NP6 1GG, NP6 1GH, NP6 1GL, NP6 1GP, NP6 1GW, NP6 1PG, NP6 1PL, NP6 1PN, NP6 1PW, NP9 9ZB, NP9 9ZE, NP9 9ZF, NPT 9ZB",296,267,29
W00008458,NP18,"NP18 3BX, NP18 3DA, NP18 3DD, NP18 3DF, NP18 3DG, NP18 3DH, NP18 3EH, NP18 3QQ, NP18 3QX, NP18 3XQ, NP18 3XS, NP18 3YJ, NP6 1DA, NP6 1DB, NP6 1DD, NP6 1DE, NP6 1DF, NP6 1DH, NP6 1DY, NP6 1EH, NP6 1EJ, NP6 1QT, NP6 1RA, NP6 1XH",241,222,19
W00008442,NP18,"NP18 1BN, NP18 1BP, NP18 1BR, NP18 1BY, NP18 1JG, NP18 1JH, NP18 1JT, NP18 1JU, NP18 1JW, NP18 1JX, NP18 1JY, NP18 1QE, NP18 1QG, NP18 1QH, NP18 1QJ, NP18 1QL, NP18 1QN, NP18 1QP, NP18 1QQ, NP6 1BR, NP6 1JH, NP6 1JT, NP6 1JU, NP6 1JW, NP6 1JX, NP6 1QG, NP6 1QJ, NP6 1QL, NP6 1QN, NP6 1QP, NP6 1QQ, NP6 1QW, NP6 1XB, NP6 1XE",277,256,21
W00008456,NP18,"NP18 3QW, NP18 3QY, NP18 3SS, NP18 3SU, NP18 3SY, NP18 3SZ, NP18 3TA, NP6 1DP, NP6 1QY, NP6 1ST, NP6 1SU, NP6 1SX, NP6 1SY, NP6 1SZ",352,318,34
W00008512,NP18,"NP18 2BP, NP18 2JH, NP18 2JJ, NP18 2JP, NP18 2JX, NP18 2LB, NP18 2LD, NP18 2LE, NP18 2LF, NP18 2LJ, NP6 2JJ, NP6 2JP, NP6 2JX, NP6 2LB",371,338,33
W00008633,NP18,"NP18 2DB, NP18 2LL, NP18 2LN, NP18 2YE, NP19 9LE, NP19 9PB, NP19 9PD, NP19 9PE, NP19 9RG, NP19 9RH, NP6 2LH, NP6 2LL, NP6 2YD, NP6 2YE, NP9 9LF, NP9 9LH, NP9 9NF, NP9 9PB, NP9 9PD, NP9 9PE, NP9 9PF, NP9 9RE, NPT 9LF, NPT 9LG, NPT 9NF, NPT 9PD, NPT 9PE, NPT 9PF, NPT 9RE",321,299,22
W00008436,NP18,"NP18 1BG, NP18 1BH, NP18 1BW, NP18 1BZ, NP18 1LF, NP18 1NS, NP6 1BG, NP6 1BQ, NP6 1LF, NP6 1LG, NP6 1XG",294,262,32
W00008437,NP18,"NP18 3BZ, NP18 3FY, NP18 3PB, NP18 3SL, NP18 3SW, NP18 3SX, NP6 1EE, NP6 1PA, NP6 1PB, NP6 1SW, NP6 1TH",307,285,22
W00008438,NP18,"NP18 1AJ, NP18 1AL, NP18 1AN, NP18 1AP, NP18 1AQ, NP18 1BJ, NP18 1BL, NP18 1BS, NP6 1BJ, NP6 1BL, NP6 1BS",229,217,12
W00008439,NP18,"NP18 3QZ, NP18 3RD, NP18 3RH, NP18 3RJ, NP18 3RQ, NP18 3RU, NP18 3RW, NP18 3RX, NP18 3SN, NP18 3SQ, NP6 1QX, NP6 1RB, NP6 1RH, NP6 1RJ, NP6 1RQ, NP6 1RU, NP6 1RX, NP6 1RY, NP6 1SB, NP6 1SD, NP6 1SQ, NP6 1XQ",458,429,29
W00008440,NP18,"NP18 1AA, NP18 1AB, NP18 1AD, NP18 1AE, NP18 1AF, NP18 1AG, NP18 1AH, NP18 1AS, NP18 1AX, NP18 1AY, NP18 1AZ, NP18 1BA, NP18 1BT, NP18 1BX, NP18 1DA, NP18 1DY, NP18 1NF, NP18 1QD, NP18 1QF, NP18 1ZY, NP6 1AA, NP6 1AB, NP6 1AD, NP6 1AE, NP6 1AF, NP6 1AG, NP6 1AH, NP6 1AJ, NP6 1AL, NP6 1AQ, NP6 1AR, NP6 1AS, NP6 1AW, NP6 1AX, NP6 1AY, NP6 1AZ, NP6 1BA, NP6 1BN, NP6 1BP, NP6 1BT, NP6 1BW, NP6 1BX, NP6 1BY, NP6 1NF, NP6 1NP, NP6 1NQ, NP6 1QD, NP6 1QE, NP6 1QH, NP6 1QS, NP6 1XD",251,234,17
W00008441,NP18,"NP18 3RB, NP18 3RG, NP18 3RL, NP18 3RN, NP18 3RP, NP18 3RR, NP18 3RS, NP18 3RT, NP6 1RD, NP6 1RE, NP6 1RF, NP6 1RG, NP6 1RL, NP6 1RN, NP6 1RP, NP6 1RR, NP6 1RS, NP6 1RT, NP6 1RW, NP6 1SE",258,239,19
W00008443,NP18,"NP18 1HF, NP18 1HQ, NP18 1JF, NP18 1JJ, NP18 1JL, NP18 1JN, NP18 1JP, NP18 1JQ, NP18 1JZ, NP18 1LB, NP18 1LD, NP18 1LP, NP18 1LQ, NP18 1LY, NP18 1LZ, NP18 1QA, NP18 1QB, NP18 1QR, NP18 1WA, NP18 2LW, NP18 2YA, NP19 7EE, NP6 1JD, NP6 1JE, NP6 1JF, NP6 1JG, NP6 1JJ, NP6 1JL, NP6 1JN, NP6 1JP, NP6 1JY, NP6 1JZ, NP6 1LB, NP6 1LD, NP6 1LE, NP6 1LP, NP6 1QA, NP6 1QB, NP6 1QF, NP6 1QR, NP6 2YA",361,337,24
W00008457,NP18,"NP18 3BY, NP18 3DB, NP18 3DE, NP18 3DJ, NP18 3DL, NP18 3DN, NP18 3DP, NP18 3EB, NP18 3ST, NP6 1BZ, NP6 1DJ, NP6 1DL, NP6 1DN, NP6 1DQ, NP6 1DR, NP6 1DS, NP6 1DT, NP6 1EB, NP6 1EG",276,248,28
W00008445,NP18,"NP18 3EU, NP18 3EW, NP18 3FA, NP18 3FQ, NP18 3FU, NP18 3FW, NP18 3FZ, NP6 1FA, NP6 1FQ, NP6 1FU, NP6 1FW, NP6 1FX, NP6 1FY, NP6 1FZ, NP6 1XR",208,198,10
W00008447,NP18,"NP18 3FR, NP18 3FX, NP18 3NN, NP18 3NR, NP18 3NS, NP18 3NT, NP18 3NX, NP18 3PR, NP18 3PW, NP18 3QT, NP18 3SP, NP18 3TH, NP18 3TJ, NP18 3XL, NP6 1NS, NP6 1NT, NP6 1NW, NP6 1NX, NP6 1PR, NP6 1PU, NP6 1TB, NP6 1TD, NP6 1TE, NP6 1TF, NP6 1TG, NP6 1TJ, NP6 1TN, NP6 1XJ, NP6 1XL, NP6 1YE, NP6 1YG",296,274,22
W00008448,NP18,"NP18 3BU, NP18 3ER, NP18 3ES, NP18 3ET, NP18 3EY, NP18 3FB, NP18 3FS, NP18 3FT, NP6 1ER, NP6 1ES, NP6 1ET, NP6 1EU, NP6 1EW, NP6 1EY, NP6 1FD, NP6 1FE, NP6 1FF, NP6 1FN, NP6 1FS, NP6 1FT",290,283,7
W00008449,NP18,"NP18 3DT, NP18 3DU, NP18 3DZ, NP18 3EA, NP18 3ED, NP18 3EE, NP18 3EG, NP6 1DU, NP6 1DX, NP6 1DZ, NP6 1EA, NP6 1ED, NP6 1EF",247,215,32
W00008450,NP18,"NP18 1NA, NP18 1NB, NP18 3NU, NP18 3QP, NP18 3QR, NP18 3XR, NP6 1NA, NP6 1NB, NP6 1NU, NP6 1XS",138,136,2
W00008451,NP18,"NP18 3DQ, NP18 3DR, NP18 3DS, NP18 3EX, NP6 1DG, NP6 1EX, NP6 1FB",305,268,37
W00008452,NP18,"NP18 3BS, NP18 3BT, NP18 3EP, NP18 3EQ, NP18 3FD, NP18 3FE, NP18 3FF, NP18 3FL, NP18 3FN, NP18 3FP, NP6 1EP, NP6 1FG, NP6 1FH, NP6 1FJ, NP6 1FL, NP6 1FP, NP6 1FR, NP6 1YA, NP6 1YD, NP6 1YF, NP6 1YH, NP6 1YJ, NP6 1YL, NP6 1YN, NP6 1YP, NP6 1YQ, NP6 1YR, NP6 1YS, NP6 1YT",302,273,29
W00008453,NP18,"NP18 3DY, NP18 3EJ, NP18 3EL, NP18 3EN, NP18 3FG, NP18 3FH, NP18 3FJ, NP18 3QU, NP18 3RA, NP6 1EL, NP6 1EN, NP6 1EQ, NP6 1QU",295,276,19
W00008454,NP18,"NP18 3NW, NP18 3PS, NP18 3PT, NP18 3PU, NP18 3PX, NP6 1NN, NP6 1PS, NP6 1PT, NP6 1PX",270,243,27
W00008455,NP18,"NP18 1JB, NP18 1LE, NP18 1LG, NP18 1LH, NP18 1LL, NP18 1LN, NP18 1LX, NP18 1NN, NP18 1NT, NP18 1NX, NP18 1XE, NP18 1YA, NP18 1YF, NP18 1YH, NP18 1YR, NP18 1YY, NP6 1LN",274,247,27
W00008446,NP18,"NP18 3BW, NP18 3DW, NP18 3DX, NP18 3EF, NP18 3EZ, NP6 1DW, NP6 1EZ",274,249,25
W00008513,NP18,"NP18 2NA, NP18 2NB, NP18 2NJ, NP6 2NA, NP6 2NB",141,130,11
W00008444,NP18,"NP18 1BQ, NP18 1HH, NP18 1PD, NP18 1PE, NP18 1PF, NP18 1PQ, NP18 1PR, NP18 3NY, NP18 3NZ, NP18 3PA, NP18 3PD, NP18 3PE, NP18 3PF, NP18 3PG, NP18 3TB, NP18 3TD, NP18 3TE, NP18 3TF, NP18 3TG, NP18 3XH, NP6 1NY, NP6 1NZ, NP6 1PD, NP6 1PE, NP6 1PF, NP6 1PQ, NP6 1XN, NP6 1XP, NP6 1XW",537,483,54
W00008558,NP18,"NP18 2AQ, NP18 2AR, NP18 2AS, NP18 2AZ, NP18 2BD, NP18 2BE, NP18 2BT, NP18 2BU, NP18 2BW, NP18 2BX, NP18 2BY, NP18 2BZ, NP18 2DA, NP18 2DD, NP18 2EP, NP18 2YH, NP19 0RB, NP19 4PL, NP19 4PN, NP19 4PP, NP19 4PQ, NP19 4RE, NP19 4SS, NP19 4SW, NP19 4SY, NP19 4SZ, NP19 4XE, NP19 4XF, NP19 4XJ, NP19 4YR, NP6 2AQ, NP6 2AR, NP6 2AS, NP6 2AZ, NP6 2BB, NP6 2BD, NP6 2BE, NP6 2BG, NP6 2BH, NP6 2BJ, NP6 2BQ, NP6 2BR, NP6 2BT, NP6 2BU, NP6 2BW, NP6 2BX, NP6 2BY, NP6 2BZ, NP6 2DA, NP6 2DB, NP6 2DD, NP9 0HF, NP9 0PL, NP9 0PN, NP9 0PP, NP9 0PQ, NP9 0PT, NP9 0PW, NP9 0RB, NP9 0RD, NP9 0RE, NP9 0RF, NP9 0RQ, NP9 0XE, NP9 0XF, NP9 0XG, NP9 0XH, NP9 0XJ, NP9 0XP, NP9 0XW, NP9 2WQ, NPT 0HF, NPT 0PL, NPT 0PN, NPT 0PP, NPT 0PQ, NPT 0RB, NPT 0RD, NPT 0RE, NPT 0RF, NPT 0RQ, NPT 0WZ, NPT 0XE, NPT 0XF, NPT 0XG, NPT 0XH, NPT 0XJ, NPT 0XR, NPT 0YF, NPT 0YG, NPT 0YJ, NPT 0YP, NPT 0YR",266,237,29
W00009886,NP18,"NP18 1WX, NP18 1WY, NP18 1WZ, NP18 1YB, NP18 1YE, NP18 1YG, NP18 1YJ, NP18 1YP, NP18 1YQ, NP18 1ZB, NP18 1ZW, NP18 2WA, NP18 2WP, NP18 2WQ, NP18 2WR, NP18 2WS, NP18 2WT, NP18 2WU, NP18 2WW, NP18 2WX, NP18 2WZ, NP18 2XA, NP18 2YD, NP18 2YL, NP18 2YP, NP18 2YU, NP18 2ZA, NP18 2ZQ, NP18 2ZR, NP18 3WT, NP18 3WU, NP18 3WW, NP18 3WX, NP18 3WY, NP18 3WZ, NP18 3XY, NP18 3XZ, NP18 3YB, NP18 3YD, NP18 3YF, NP18 3YG, NP18 3YH, NP18 3YR, NP18 3ZN, NP19 0WA, NP19 0WU, NP19 0WW, NP19 0WX, NP19 0WZ, NP19 0XT, NP19 0YF, NP19 0YH, NP19 0YL, NP19 0YP, NP19 1AD, NP19 1AF, NP19 1AJ, NP19 1AN, NP19 1AT, NP19 1BB, NP19 1BD, NP19 1BF, NP19 1BG, NP19 1BH, NP19 1BJ, NP19 1BL, NP19 1BN, NP19 1BP, NP19 1BQ, NP19 1BR, NP19 1BS, NP19 1BT, NP19 1BU, NP19 1BW, NP19 1BX, NP19 1BY, NP19 1BZ, NP19 1DA, NP19 1DB, NP19 1DD, NP19 1DE, NP19 1DF, NP19 1DH, NP19 1DJ, NP19 1DL, NP19 1DN, NP19 1DP, NP19 1DQ, NP19 1DR, NP19 1DS, NP19 1DT, NP19 1DU, NP19 1DW, NP19 1DX, NP19 1DY, NP19 1DZ, NP19 1EA, NP19 1EB, NP19 1ED, NP19 1EE, NP19 1EF, NP19 1EG, NP19 1EH, NP19 1EJ, NP19 4AA, NP19 4PA, NP19 4PB, NP19 4QQ, NP19 4QR, NP19 4QS, NP19 4QT, NP19 4QW, NP19 4SX, NP19 4TA, NP19 4TX, NP19 4WU, NP19 4WW, NP19 4WX, NP19 4WY, NP19 4WZ, NP19 4XA, NP19 4XN, NP19 4XP, NP19 4YD, NP19 4YE, NP19 4YF, NP19 4YJ, NP19 4YU, NP19 4YZ, NP19 4ZB, NP19 7UP, NP19 7WW, NP19 7WX, NP19 7WY, NP19 7WZ, NP19 7YA, NP19 7YD, NP19 7YQ, NP19 7YU, NP19 7YW, NP19 7ZP, NP19 7ZQ, NP19 8WP, NP19 8WR, NP19 8WT, NP19 8WW, NP19 8WX, NP19 8WY, NP19 8XJ, NP19 8XT, NP19 8YE, NP19 8YF, NP19 8YG, NP19 8YP, NP19 8YR, NP19 8YW, NP19 8YX, NP19 8YY, NP19 8ZE, NP19 8ZF, NP19 8ZJ, NP19 8ZR, NP19 9WY, NP19 9WZ, NP19 9YF, NP19 9YQ, NP19 9YR, NP19 9YY, NP19 9ZG, NP9 0PA, NP9 0TA, NP9 0TN, NP9 0TX, NP9 0TY, NPT 0PA, NPT 0TA",112,106,6
W00010548,NP18,"NP18 2DJ, NP18 2DN, NP18 2DP, NP18 2DQ, NP18 2DR, NP18 2DS, NP18 2DU, NP18 2DW, NP18 2DX, NP18 2DY, NP18 2EN, NP18 2FA, NP18 2TA, NP18 2WB, NP18 2XU, NP19 4RG, NP19 4RH, NP6 2AH, NP6 2DP, NP6 2DQ, NP6 2DR, NP6 2DS, NP6 2DT, NP6 2DU, NP6 2DW, NP6 2DX, NP6 2DY, NP6 2NG, NP6 2YH, NP6 2YJ, NP6 2YT, NP9 0QX, NP9 0XN, NP9 0XQ, NP9 0XR, NP9 0XS, NP9 0XT, NP9 0XU, NP9 0XY, NPT 0QX, NPT 0XQ",286,261,25
W00008566,NP18,"NP18 2HF, NP18 2HG, NP18 2JA, NP6 2HF",435,410,25
W00010592,NP18,"NP18 2JN, NP18 2NE, NP18 2NF, NP18 2NG, NP18 2NR, NP18 2NS, NP18 2NT, NP6 2JN, NP6 2LU, NP6 2ND, NP6 2NE, NP6 2NF",384,332,52
W00008565,NP18,"NP18 2ET, NP18 2EW, NP18 2EZ, NP18 2HA, NP18 2HB, NP18 2XT, NP18 2XY, NP18 2XZ, NP18 2YF, NP18 2YJ, NP6 2ET, NP6 2EU, NP6 2EW, NP6 2EZ, NP6 2GG, NP6 2HA, NP6 2HB, NP6 2HS, NP6 2XW, NP6 2XX, NP6 2XY, NP6 2XZ, NP6 2YF, NP6 2YL, NP6 2YN, NP6 2YP, NP6 2YR, NP6 2YS, NP6 2YU, NP6 2YX",291,279,12
W00008564,NP18,"NP18 2DT, NP18 2DZ, NP18 2EA, NP18 2EE, NP19 4QZ, NP26 3DA, NP6 2DZ, NP6 2EA, NP6 2HR, NP6 3DA, NPT 0YD",170,164,6
W00008563,NP18,"NP18 2ES, NP18 2EU, NP18 2EX, NP18 2HS, NP6 2ES, NP6 2EX, NP6 2HT, NP6 2HU",309,277,32
W00008562,NP18,"NP18 2HP, NP18 2HX, NP18 2HZ, NP6 2HH, NP6 2HP, NP6 2HX, NP6 2HZ, NP6 2JA",274,262,12
W00008561,NP18,"NP18 2EQ, NP18 2EY, NP18 2HR, NP18 2HT, NP18 2HU, NP6 2ER, NP6 2EY, NP6 2HQ, NP6 2HW",304,287,17
W00008560,NP18,"NP18 2HD, NP18 2HE, NP18 2HH, NP18 2HN, NP6 2HD, NP6 2HE, NP6 2HL, NP6 2HN",273,248,25
W00008559,NP18,"NP18 2ER, NP18 2HQ, NP18 2HW, NP18 2HY, NP18 2JB, NP6 2HG, NP6 2HY, NP6 2JB, NP6 2YZ",189,175,14
W00010499,NP18,"NP18 2DG, NP18 2DH, NP18 2DL, NP18 2EF, NP18 2EH, NP18 2EJ, NP18 2EL, NP18 2NH, NP19 4DP, NP19 4EF, NP19 4EG, NP19 4EH, NP19 4EJ, NP6 2NH, NP6 2NQ",288,258,30
W00008519,NP18,"NP18 1DB, NP18 1JR, NP18 1JS, NP18 1LA, NP18 2AA, NP18 2AB, NP18 2GG, NP18 2JR, NP18 2JY, NP18 2JZ, NP18 2LA, NP6 1JQ, NP6 1JR, NP6 1JS, NP6 1LA, NP6 2AA, NP6 2AB, NP6 2JR, NP6 2JY, NP6 2JZ, NP6 2LA",212,198,14
W00008518,NP18,"NP18 2AD, NP18 2AE, NP18 2AF, NP18 2AG, NP18 2AH, NP18 2AJ, NP18 2AL, NP18 2EB, NP18 2ED, NP18 2EG, NP6 2AD, NP6 2AE, NP6 2AG, NP6 2AJ, NP6 2AL, NP6 2EB, NP6 2ED, NP6 2EE",403,371,32
W00008567,NP18,"NP18 2AT, NP18 2AU, NP18 2AW, NP18 2AX, NP18 2AY, NP18 2BA, NP18 2BB, NP18 2PG, NP18 2PH, NP18 2PJ, NP18 2PL, NP18 2PN, NP18 2PP, NP19 4QX, NP6 2AP, NP6 2AT, NP6 2AU, NP6 2AW, NP6 2AX, NP6 2AY, NP6 2BA, NP6 2PG, NP6 2PH, NP6 2PJ, NP6 2PL, NP6 2PN, NP6 2PP, NP6 2TA, NP6 2XT, NP6 2XU, NPT 0XP",320,302,18
W00008516,NP18,"NP18 2BG, NP18 2BH, NP18 2BJ, NP18 2ND, NP18 2NN, NP18 2NP, NP6 2LF, NP6 2LG, NP6 2LQ, NP6 2LY, NP6 2NJ",264,246,18
W00008536,NP18,"NP18 1YD, NP18 1YS, NP18 1YW, NP18 1YX, NP18 2YN, NP18 2YQ, NP18 2YR, NP18 2YS, NP18 2YT, NP18 2YW, NP18 2YX, NP18 3YA, NP18 3YE, NP18 3YL, NP18 3YN, NP18 3YP, NP18 3YQ, NP18 3YS, NP18 3YU, NP18 3ZF, NP18 3ZR, NP19 0XR, NP19 0YA, NP19 0YB, NP19 0YJ, NP19 0YN, NP19 0YQ, NP19 0ZA, NP19 4NH, NP19 4NS, NP19 4NT, NP19 4NU, NP19 4XS, NP19 4XW, NP19 4YA, NP19 4YB, NP19 4YG, NP19 4YL, NP19 4YN, NP19 4YP, NP19 4YQ, NP19 4YY, NP19 7UE, NP19 7WA, NP19 7WB, NP19 7YE, NP19 7YH, NP19 7YJ, NP19 7YL, NP19 7YN, NP19 7YP, NP19 7YR, NP19 7ZH, NP19 8XH, NP19 8YA, NP19 8YB, NP19 8YH, NP19 8YQ, NP19 8YT, NP19 8YU, NP19 9YA, NP19 9YD, NP19 9YE, NP19 9YS, NP19 9YU, NP9 0NL, NP9 0NS, NP9 0NU, NPT 0NL, NPT 0NS, NPT 0NU",327,307,20
W00008635,NP18,"NP18 1JD, NP18 1JE, NP18 2LR, NP18 2LS",279,260,19
W00008517,NP18,"NP18 2AN, NP18 2AP, NP18 2BQ, NP18 2LQ, NP18 2LZ, NP18 2NQ, NP18 2NU, NP18 2NW, NP6 2LD, NP6 2LE, NP6 2LZ, NP6 2NL, NP6 2NN, NP6 2NP, NP6 2NR",500,458,42
W00008638,NP18,"NP18 2YG, NP19 9GR, NP19 9GS, NP19 9GY, NP19 9HA, NP6 2LT, NP6 2YG, NP6 2YQ, NP6 2YW",285,272,13
W00008639,NP18,"NP18 2LP, NP19 9GL, NP19 9GN, NP6 2LR, NP6 2LS, NP9 9GN, NP9 9GP, NP9 9GQ, NP9 9GR, NP9 9GY, NP9 9GZ, NP9 9HA, NPT 9GN, NPT 9GP, NPT 9GQ, NPT 9GR, NPT 9GZ, NPT 9HA, NPT 9HD",247,228,19
W00008540,NP18,"NP18 2BS, NP19 0UJ, NP19 4AB, NP19 4PT, NP19 4QU, NP19 4RA, NP19 4RB, NP19 4RL, NP19 4RP, NP19 4RQ, NP19 4RR, NP19 4SJ, NP19 4SL, NP19 4SN, NP19 4SP, NP19 4SQ, NP19 4SR, NP19 4ST, NP19 4SU, NP19 4TE, NP19 4TF, NP19 4TG, NP19 4TS, NP19 4WN, NP19 4YX, NP6 2BS, NP9 0PJ, NP9 0QT, NP9 0QW, NP9 0RJ, NP9 0RL, NP9 0RP, NP9 0RR, NP9 0RW, NP9 0SJ, NP9 0SL, NP9 0SN, NP9 0SP, NP9 0SQ, NP9 0SR, NP9 0SS, NP9 0ST, NP9 0SU, NP9 0SW, NP9 0SX, NP9 0SY, NP9 0SZ, NP9 0TE, NP9 0TF, NP9 0TG, NP9 0TQ, NP9 0TS, NP9 0TW, NP9 0UJ, NP9 0UL, NP9 0XA, NP9 0YH, NP9 0YY, NP9 0YZ, NP9 9ZA, NPT 0QT, NPT 0QU, NPT 0QW, NPT 0RL, NPT 0RP, NPT 0RR, NPT 0SF, NPT 0SL, NPT 0SN, NPT 0SP, NPT 0SR, NPT 0TE, NPT 0TG, NPT 0TS, NPT 0TW, NPT 0WW, NPT 0YH, NPT 0YX, NPT 0YY, NPT 1QE, NPT 9ZA",340,321,19
W00008637,NP18,"NP18 2YB, NP19 9GP, NP19 9GQ, NP19 9GZ, NP9 9GS, NPT 9GS",275,253,22
W00008515,NP18,"NP18 2BN, NP18 2BR, NP18 2DE, NP18 2DF, NP18 2HJ, NP18 2HL, NP18 2JD, NP18 2JE, NP18 2JF, NP18 2JG, NP18 2LG, NP18 2LH, NP18 2LX, NP18 2LY, NP18 2NX, NP18 2NY, NP18 2NZ, NP6 2LW, NP6 2LX",490,440,50
W00008699,NP19,"NP19 7AA, NP19 7AB, NP19 7AE, NP19 7AF, NP19 7AG, NP19 7AH, NP19 7AJ, NP19 7AN, NP19 7EA, NP9 7AA, NP9 7AB, NP9 7AD, NP9 7AE, NP9 7AF, NP9 7AG, NP9 7AH, NP9 7AJ, NP9 7AL, NP9 7AN, NP9 7AT, NPT 7AA, NPT 7AB, NPT 7AD, NPT 7AE, NPT 7AF, NPT 7AG, NPT 7AH, NPT 7AJ, NPT 7AL, NPT 7AN, NPT 7AT",242,217,25
W00008700,NP19,"NP19 7HY, NP19 7JB, NP19 7JD, NP19 7JP, NP19 7LX, NP9 7LX, NPT 7LX",284,255,29
W00008363,NP19,"NP19 9ED, NP19 9NX, NP19 9NY, NP19 9RZ, NP19 9SA, NP19 9SD, NP9 9XA, NP9 9XU, NP9 9YB, NP9 9YE, NP9 9YF, NP9 9YH, NP9 9YR, NP9 9YS, NPT 9XA",450,413,37
W00008362,NP19,"NP19 9BN, NP19 9BP, NP19 9BR, NP19 9DA, NP19 9DB, NP9 9BP, NP9 9BU, NP9 9BW, NP9 9BY, NP9 9BZ, NP9 9DA, NP9 9DB, NPT 9BN, NPT 9BP, NPT 9BU, NPT 9BW, NPT 9BY, NPT 9BZ, NPT 9DA",303,275,28
W00008361,NP19,"NP19 8AD, NP19 8AQ, NP19 8AT, NP19 8AX, NP19 8AY, NP19 8AZ, NP19 8HL, NP19 8XR, NP19 9BH, NP9 9BH, NP9 9BQ, NPT 9BH, NPT 9BQ",334,307,27
W00008360,NP19,"NP19 9BJ, NP19 9BL, NP19 9BQ, NP19 9DD, NP19 9DE, NP9 8AX, NP9 8AY, NP9 8AZ, NP9 9BL, NP9 9BN, NP9 9BR, NP9 9DD, NPT 8AX, NPT 8AY, NPT 8AZ, NPT 9BL, NPT 9BR, NPT 9DB, NPT 9DD",256,243,13
W00008359,NP19,"NP19 8BA, NP19 8BB, NP19 8BL, NP19 8BN, NP9 8BB, NP9 8BJ, NP9 8BL, NPT 8BB, NPT 8BJ",249,232,17
W00008697,NP19,"NP19 7EZ, NP19 7FB, NP19 7FD, NP19 7FE, NP19 7FF, NP9 7BY, NP9 7EH, NP9 7EN, NP9 7EP, NP9 7EQ, NP9 7EY, NP9 7EZ, NP9 7FD, NPT 7EH, NPT 7EN, NPT 7EP, NPT 7EQ, NPT 7EY, NPT 7EZ, NPT 7FD",301,273,28
W00008358,NP19,"NP19 8AA, NP19 8AB, NP19 8AE, NP19 8AR, NP19 8AS, NP9 8AB, NP9 8AE, NP9 8AF, NP9 8AT, NPT 8AB, NPT 8AE, NPT 8AF, NPT 8AT",293,263,30
W00008702,NP19,"NP19 7BJ, NP19 7BN, NP19 7HX, NP19 7HZ, NP19 7JN, NP19 7JS, NP9 7BN, NP9 7BP, NP9 7BQ, NP9 7JN, NP9 7JP, NP9 7JR, NPT 7BN, NPT 7BP, NPT 7BQ, NPT 7JN",356,322,34
W00008694,NP19,"NP19 7AY, NP19 7BA, NP19 7BB, NP19 7BD, NP19 7BE, NP19 7BG, NP19 7XL, NP9 7BE, NP9 7BG, NP9 7BH, NP9 7BZ, NP9 7DA, NP9 7DB, NP9 7DD, NP9 7DU, NP9 7XL, NPT 7BE, NPT 7BG, NPT 7BH, NPT 7BZ, NPT 7DA, NPT 7DB, NPT 7DD, NPT 7DU, NPT 7XL",248,239,9
W00008698,NP19,"NP19 7BX, NP19 7BY, NP19 7BZ, NP19 7DA, NP19 7EG, NP19 7FA, NP19 7FG, NP19 7FH, NP19 7FJ, NP19 7XP, NP9 7BD, NP9 7EL, NP9 7FE, NP9 7FF, NP9 7FG, NP9 7FU, NP9 7FW, NP9 7FX, NP9 7GS, NP9 7XP, NPT 7BD, NPT 7BY, NPT 7EJ, NPT 7EL, NPT 7FE, NPT 7FF, NPT 7FG, NPT 7FW, NPT 7FX, NPT 7GS, NPT 7XP",313,283,30
W00008701,NP19,"NP19 7JL, NP19 7LJ, NP19 7LL, NP19 7LN",317,297,20
W00008703,NP19,"NP19 7HD, NP19 7HE, NP19 7JX, NP19 7JY, NP9 7BJ, NP9 7HX, NP9 7HZ, NP9 7JS, NP9 7LT, NP9 7LU, NPT 7BJ, NPT 7BS, NPT 7HX, NPT 7HZ, NPT 7LT, NPT 7LU",255,246,9
W00008695,NP19,"NP19 7ES, NP19 7EU, NP19 7EW, NP19 7GB, NP19 8LN, NP9 7GA, NP9 7GD, NP9 7GE, NP9 7SR, NPT 7GA, NPT 7GD, NPT 7GE, NPT 7SR",283,270,13
W00008696,NP19,"NP19 7EN, NP19 7EP, NP19 7EQ, NP19 7ER, NP19 7EX, NP19 7GZ, NP9 7ER, NP9 7ES, NP9 7EW, NP9 7EX, NP9 7GB, NPT 7ER, NPT 7ES, NPT 7EW, NPT 7EX, NPT 7GB",310,281,29
W00008357,NP19,"NP19 9RY, NP19 9SH, NP19 9SJ, NP19 9SR, NP19 9SS, NP19 9SW, NP19 9SX, NP9 9SB, NP9 9SJ, NP9 9SL, NP9 9SN, NP9 9SR, NPT 9SB, NPT 9SJ, NPT 9SL, NPT 9SN, NPT 9SR, NPT 9SX",322,306,16
W00008777,NP19,"NP19 7EH, NP19 7EJ, NP19 8AP, NP19 8DN, NP19 8DQ, NP19 8DR, NP19 8DS, NP9 2UP, NP9 7EJ, NP9 7FJ, NP9 8DE, NP9 8DL, NP9 8DN, NP9 8DP, NP9 8DQ, NP9 8DU, NP9 8WP, NPT 2UP, NPT 7FJ, NPT 8DE, NPT 8DL, NPT 8DN, NPT 8DP, NPT 8DQ, NPT 8DU, NPT 8WP",328,298,30
W00008710,NP19,"NP19 7HF, NP19 7HW, NP19 7JJ, NP19 7JQ, NP19 7JR, NP9 7JH, NP9 7JJ, NPT 7JH, NPT 7JJ",241,229,12
W00008705,NP19,"NP19 7BP, NP19 7BS, NP19 7LT, NP19 7LU, NP19 7LW, NP9 7JB, NP9 7JD, NPT 7JB, NPT 7JD",334,311,23
W00008371,NP19,"NP19 9AB, NP19 9AH, NP19 9AL, NP19 9AN, NP19 9AP, NP19 9BD, NP9 9AB, NP9 9AG, NP9 9AH, NP9 9AJ, NP9 9AQ, NP9 9AR, NPT 9AB, NPT 9AH, NPT 9AJ, NPT 9AQ, NPT 9AR",351,315,36
W00008370,NP19,"NP19 8JE, NP19 8JG, NP19 8JH, NP19 8JQ, NP19 8JR, NP19 8JZ, NP19 8LA, NP19 8LD, NP9 8AS, NP9 8HJ, NP9 8HL, NP9 8HY, NP9 8JE, NP9 8JF, NP9 8JG, NP9 8JH, NP9 8JZ, NP9 8LA, NP9 8LE, NP9 8XQ, NP9 8XR, NP9 8XT, NP9 8XU, NP9 8XZ, NPT 8AS, NPT 8HJ, NPT 8HL, NPT 8HY, NPT 8JF, NPT 8JG, NPT 8JH, NPT 8JZ, NPT 8LA, NPT 8XQ, NPT 8XR, NPT 8XT, NPT 8XU",325,305,20
W00008369,NP19,"NP19 9AJ, NP19 9AS, NP19 9AT, NP19 9AU, NP19 9AW, NP19 9AX, NP19 9AZ, NP19 9DG, NP19 9PZ, NP19 9QF, NP9 9AN, NP9 9AT, NP9 9AU, NP9 9AW, NP9 9AX, NP9 9DE, NP9 9DG, NP9 9QF, NPT 9AN, NPT 9AT, NPT 9AU, NPT 9AW, NPT 9AX, NPT 9DE, NPT 9QF",238,229,9
W00008368,NP19,"NP19 8JJ, NP19 8JL, NP19 8JN, NP19 8JP, NP19 8NQ, NP19 8NR, NP9 8JJ, NP9 8JL, NP9 8JN, NP9 8JQ, NP9 8NQ, NP9 8NR, NPT 8JE, NPT 8JJ, NPT 8JL, NPT 8JN, NPT 8JQ, NPT 8LD, NPT 8NQ, NPT 8NR",328,303,25
W00008367,NP19,"NP19 9HJ, NP19 9PA, NP19 9PG, NP19 9PH, NP19 9PJ, NP19 9PU, NP9 9DW, NP9 9LD, NP9 9LE, NP9 9PG, NP9 9PJ, NP9 9PL, NPT 9DW, NPT 9ED, NPT 9LE, NPT 9PG, NPT 9PJ, NPT 9PL",300,287,13
W00008366,NP19,"NP19 9QG, NP19 9QH, NP19 9QJ, NP19 9QL, NP19 9QN, NP9 9QA, NP9 9QG, NP9 9QH, NP9 9QJ, NP9 9QL, NPT 9QG, NPT 9QH, NPT 9QJ, NPT 9QL",264,236,28
W00008365,NP19,"NP19 9SB, NP19 9SE, NP19 9SF, NP19 9SG, NP19 9ST, NP19 9SU, NP9 9SD, NP9 9SE, NP9 9SF, NP9 9SU, NP9 9SW, NPT 9SD, NPT 9SE, NPT 9SF, NPT 9SU, NPT 9SW",381,358,23
W00008554,NP19,"NP19 0GW, NP19 0GY, NP19 0GZ, NP19 0HD, NP9 0GZ, NP9 0HA, NP9 0HL, NPT 0GZ, NPT 0HA",220,203,17
W00008555,NP19,"NP19 0JG, NP19 0JH, NP19 0JJ, NP19 0JX, NP19 0JY, NP19 0JZ, NP19 0RJ, NP19 0SE, NP19 4SD, NP9 0JG, NP9 0JH, NP9 0JX, NP9 0LA, NP9 0SA, NP9 0SB, NP9 0SD, NPT 0JG, NPT 0JH, NPT 0JR, NPT 0JX, NPT 0LA, NPT 0SA, NPT 0SB, NPT 0SD, NPT 0SG",340,321,19
W00008556,NP19,"NP19 0GP, NP19 0GR, NP19 0GS, NP19 0GT, NP19 0HE, NP19 0LQ, NP19 0LR, NP19 0LS, NP19 0LT, NP9 0GP, NP9 0GR, NP9 0GS, NP9 0GT, NP9 0GU, NP9 0GW, NP9 0GX, NP9 0HB, NP9 0HE, NP9 0TL, NP9 0WS, NP9 0WT, NP9 0WU, NPT 0GP, NPT 0GR, NPT 0GS, NPT 0GT, NPT 0GU, NPT 0GW, NPT 0GX, NPT 0HB, NPT 0HE, NPT 0HL, NPT 0WT, NPT 0WU",581,536,45
W00008557,NP19,"NP19 4PE, NP19 4PF, NP9 0PE, NPT 0PE, NPT 0PF, NPT 0PG",337,312,25
W00008711,NP19,"NP19 7BT, NP19 7GQ, NP19 7GR, NP19 7HA, NP19 7JW, NP19 7JZ, NP19 7XS, NP9 7BS, NP9 7GG, NP9 7GQ, NP9 7JT, NP9 7JU, NP9 7JX, NP9 7JY, NP9 7JZ, NP9 7XS, NP9 7XW, NP9 7YQ, NP9 7YW, NPT 7DX, NPT 7GG, NPT 7GQ, NPT 7JT, NPT 7JU, NPT 7JX, NPT 7JY, NPT 7JZ, NPT 7XS, NPT 7XW",304,281,23
W00008693,NP19,"NP19 7AD, NP19 7AQ, NP19 7AR, NP19 7AS, NP19 7AT, NP19 7ED, NP9 7AP, NP9 7AQ, NP9 7AS, NP9 7XG, NP9 7XH, NP9 7XQ, NPT 7AP, NPT 7AQ, NPT 7AS, NPT 7XH",274,257,17
W00008776,NP19,"NP19 8EZ, NP19 8FR, NP19 8FS, NP19 8FT, NP19 8FU, NP19 8FY, NP19 8FZ, NP19 8GY, NP9 8FT, NP9 8GY, NPT 8FT, NPT 8GY",289,277,12
W00008709,NP19,"NP19 7DN, NP19 7DQ, NP19 7DW, NP19 7DX, NP19 7HB, NP19 7HU, NP19 7JG, NP19 7LP, NP9 7DW, NP9 7GR, NP9 7HB, NP9 7HD, NP9 7HE, NP9 7HW, NP9 7JW, NPT 7DW, NPT 7GR, NPT 7HB, NPT 7HD, NPT 7HE, NPT 7HW, NPT 7JW",332,274,58
W00008708,NP19,"NP19 7HN, NP19 7HP, NP19 7HQ, NP19 7HR, NP19 7JF, NP9 7HT, NP9 7XT, NPT 7HT, NPT 7XT",273,246,27
W00008707,NP19,"NP19 7LD, NP19 7LE, NP19 7LG, NP19 7QZ, NP19 7RH, NP19 7XU, NP9 7QX, NP9 7QZ, NP9 7RA, NP9 7RB, NP9 7RH, NPT 7LH, NPT 7QX, NPT 7QZ, NPT 7RA, NPT 7RB, NPT 7RH",242,210,32
W00008706,NP19,"NP19 7HJ, NP19 7HL, NP19 7HS, NP19 7HT, NP19 7JE, NP9 7HF, NP9 7HG, NP9 7HJ, NP9 7HS, NP9 7JE, NP9 7JQ, NPT 7HF, NPT 7HG, NPT 7HJ, NPT 7HS, NPT 7JE",312,285,27
W00008364,NP19,"NP19 9QA, NP19 9QD, NP19 9QE, NP19 9SL, NP19 9SN, NP19 9SP, NP19 9SQ, NP9 9EB, NP9 9QB, NP9 9QD, NP9 9QE, NP9 9SG, NP9 9SP, NP9 9SQ, NPT 9EB, NPT 9QD, NPT 9QE, NPT 9SG, NPT 9SP, NPT 9SQ",388,351,37
W00008704,NP19,"NP19 7BL, NP19 7BQ, NP19 7BR, NP9 7BL, NP9 7BR, NP9 7LN, NP9 7LW, NP9 7NE, NP9 7NL, NPT 7BL, NPT 7BR, NPT 7LW, NPT 7NE, NPT 7NL",288,273,15
W00008692,NP19,"NP19 7AL, NP19 7AP, NP19 7AU, NP19 7AW, NP19 7AX, NP19 7AZ, NP19 7BH, NP19 7BU, NP19 7BW, NP19 7DZ, NP19 7EF, NP19 7FQ, NP19 7FR, NP19 7XE, NP19 7XH, NP9 7AR, NP9 7AU, NP9 7AW, NP9 7AX, NP9 7AY, NP9 7AZ, NP9 7BA, NP9 7BB, NP9 7BW, NP9 7BX, NP9 7DF, NP9 7DG, NP9 7EG, NP9 7FA, NP9 7FH, NP9 7HL, NP9 7HN, NP9 7HP, NP9 7HQ, NP9 7XD, NP9 7XE, NP9 7XF, NP9 7XN, NP9 7XR, NPT 7AR, NPT 7AU, NPT 7AW, NPT 7AX, NPT 7AY, NPT 7AZ, NPT 7BA, NPT 7BB, NPT 7BW, NPT 7BX, NPT 7DF, NPT 7EG, NPT 7FA, NPT 7FH, NPT 7HL, NPT 7HN, NPT 7HP, NPT 7HQ, NPT 7XE, NPT 7XF, NPT 7XG, NPT 7XN, NPT 7XR",398,355,43
W00008685,NP19,"NP19 7DL, NP19 7DP, NP19 7DR, NP19 7DS, NP19 7EB, NP9 7BT, NP9 7DN, NP9 7DP, NP9 7DQ, NP9 7DR, NP9 7HR, NP9 7HU, NP9 7JF, NP9 7JG, NPT 7BT, NPT 7DN, NPT 7DP, NPT 7DQ, NPT 7DR, NPT 7HR, NPT 7HU, NPT 7JF, NPT 7JG",294,270,24
W00008690,NP19,"NP19 7DB, NP19 7DH, NP19 7DU, NP19 7EY, NP19 7FW, NP19 7GS, NP9 7DT, NP9 7ET, NP9 7EU, NP9 7FY, NP9 7HA, NPT 7DT, NPT 7ET, NPT 7EU, NPT 7FU, NPT 7FY, NPT 7HA",266,246,20
W00008653,NP19,"NP19 9HT, NP19 9JR, NP19 9JT, NP19 9NA, NP9 9HH, NP9 9HZ, NP9 9JJ, NP9 9JL, NP9 9JP, NP9 9JR, NPT 9HZ, NPT 9JJ, NPT 9JL, NPT 9JP, NPT 9JR",293,274,19
W00010567,NP19,"NP19 0AP, NP19 0AQ, NP19 0AX, NP19 0BG, NP19 0BH, NP19 0NT, NP19 0NW, NP19 0PR, NP9 0AQ, NP9 0AX, NP9 0BG, NP9 0BH, NP9 0BJ, NP9 0BL, NP9 0BQ, NP9 0BS, NP9 0BT, NP9 0BU, NP9 0TU, NP9 0WA, NP9 0WF, NPT 0AQ, NPT 0AX, NPT 0BG, NPT 0BH, NPT 0BJ, NPT 0BL, NPT 0BQ, NPT 0BR, NPT 0BS, NPT 0BT, NPT 0BU, NPT 0TF, NPT 0UU, NPT 0WA, NPT 0WF, NPT 1PU",351,336,15
W00010583,NP19,"NP19 4AL, NP19 4AS, NP19 4AT, NP19 4BL, NP19 4BQ, NP19 4BY, NP19 4BZ, NP19 4DA, NP19 4DB, NPT 0TN",257,237,20
W00010588,NP19,"NP19 4BB, NP19 4BS, NP19 4BU, NP19 4TU",332,300,32
W00008652,NP19,"NP19 9PQ, NP19 9PR, NP19 9PS, NP6 2YB, NP9 9FU, NP9 9PR, NP9 9PS, NP9 9PT, NPT 9FU, NPT 9PR, NPT 9PS, NPT 9PT",137,116,21
W00008651,NP19,"NP19 9HZ, NP19 9JL, NP19 9JP, NP9 9GX, NP9 9HY, NP9 9JG, NP9 9JH, NP9 9JN, NPT 9GX, NPT 9HY, NPT 9JG, NPT 9JH, NPT 9JN",274,256,18
W00010607,NP19,"NP19 4BG, NP19 4BH, NP19 4BJ, NP19 4BR, NP19 4BT, NP19 4DJ, NP19 4DL",277,258,19
W00008650,NP19,"NP19 9DW, NP19 9DX, NP19 9DY, NP19 9DZ, NP19 9EX, NP9 9DZ, NP9 9EN, NP9 9ER, NP9 9EY, NPT 9DZ, NPT 9EN, NPT 9EY",319,294,25
W00008649,NP19,"NP19 9BY, NP19 9DF, NP19 9DH, NP19 9DL, NP19 9DU, NP9 9DF, NP9 9DJ, NP9 9DL, NP9 9ES, NP9 9ET, NP9 9EU, NP9 9EW, NP9 9EZ, NP9 9FA, NPT 9DF, NPT 9DJ, NPT 9DL, NPT 9EW, NPT 9EZ, NPT 9FA",354,332,22
W00010616,NP19,"NP19 4TN, NP19 4TR, NP19 4TT, NP19 4TZ, NP19 4UA, NP19 4UD, NP19 4UF, NP19 4UH, NP19 4UL, NP19 4UN, NP9 0QU",329,296,33
W00010625,NP19,"NP19 0AA, NP19 0AD, NP19 0AE, NP19 0AF, NP19 0AG, NP19 0LY, NP19 0PW, NP19 0UW, NP19 0UX, NP9 0UN, NP9 0UQ, NP9 0UR, NP9 0UW, NP9 1PR, NP9 7EA, NPT 0UQ, NPT 0UW, NPT 7EA",400,394,6
W00008648,NP19,"NP19 9BA, NP19 9BB, NP19 9BG, NP19 9DJ, NP19 9EF, NP19 9EJ, NP19 9EL, NP19 9EN, NP19 9ET, NP19 9EU, NP19 9EW, NP19 9EY, NP19 9EZ, NP19 9FA, NP19 9GA, NP9 9DN, NP9 9EF, NP9 9EH, NP9 9EJ, NP9 9EL, NP9 9EQ, NPT 9EF, NPT 9EH, NPT 9EJ, NPT 9EL",325,298,27
W00010624,NP19,"NP19 4TL, NP19 4TP, NP19 4TW",269,244,25
W00008647,NP19,"NP19 9HE, NP19 9HF, NP19 9HG, NP19 9HQ, NP19 9JQ, NP19 9JU, NP9 9GG, NP9 9HD, NP9 9HE, NP9 9HF, NP9 9HG, NP9 9HJ, NP9 9HQ, NP9 9JQ, NP9 9JS, NP9 9JT, NP9 9JU, NPT 9GG, NPT 9HE, NPT 9HF, NPT 9HG, NPT 9HQ, NPT 9JQ, NPT 9JS, NPT 9JT",101,99,2
W00008646,NP19,"NP19 9GX, NP19 9JB, NP19 9JF, NP19 9JG, NP19 9JH, NP19 9JJ, NP19 9JN",364,349,15
W00008645,NP19,"NP19 9EG, NP19 9EH, NP19 9FD, NP19 9FF, NP19 9FG, NP19 9NG, NP19 9NH, NP19 9NJ, NP19 9NL, NP19 9NN, NP19 9NP, NP19 9NQ, NP19 9NR, NP19 9TD, NP19 9TF, NP19 9TH, NP19 9TN, NP19 9TP, NP9 9FB, NP9 9FD, NP9 9FF, NP9 9FG, NP9 9FH, NP9 9FT, NPT 9FB, NPT 9FD, NPT 9FF, NPT 9FG, NPT 9FH, NPT 9FT",242,234,8
W00008644,NP19,"NP19 9FQ, NP19 9FR, NP19 9FU, NP9 9FP, NP9 9FQ, NP9 9FR, NP9 9GH, NP9 9PU, NPT 9FP, NPT 9FQ, NPT 9FR, NPT 9GH",298,281,17
W00008643,NP19,"NP19 9DN, NP19 9DP, NP19 9ER, NP19 9ES, NP9 9DP, NP9 9FE, NPT 9FE",357,327,30
W00008642,NP19,"NP19 9GG, NP19 9GT, NP19 9GU, NP19 9GW, NP19 9HB, NP19 9HD, NP19 9HH, NP6 2LN, NP9 9GF, NP9 9GL, NP9 9GT, NP9 9GU, NP9 9GW, NP9 9HB, NPT 9GF, NPT 9GL, NPT 9GT, NPT 9GU, NPT 9GW, NPT 9HB",247,232,15
W00008641,NP19,"NP19 9FS, NP19 9GF, NP19 9GH, NP19 9GJ, NP6 2LP, NP9 9FS, NP9 9GJ, NPT 9FS, NPT 9GJ, NPT 9GY, NPT 9PU, NPT 9PW",265,248,17
W00008640,NP19,"NP19 9DQ, NP19 9DR, NP19 9DS, NP19 9DT, NP19 9EQ, NP9 9DQ, NP9 9DR, NP9 9DS, NP9 9DT",247,234,13
W00008636,NP19,"NP19 9FB, NP19 9FE, NP19 9FH, NP19 9FJ, NP19 9FL, NP19 9FN, NP19 9FP, NP19 9FT, NP19 9TA, NP19 9TB, NP19 9TE, NP19 9TG, NP19 9TJ, NP19 9TL, NP9 9FJ, NP9 9FL, NP9 9FN, NPT 9FJ, NPT 9FL, NPT 9FN",277,272,5
W00008632,NP19,"NP19 9HP, NP19 9LF, NP19 9LG, NP19 9LS, NP19 9NF, NP19 9PF, NP9 9LG, NP9 9LS, NP9 9LT, NP9 9LU, NPT 9LS, NPT 9LT",294,277,17
W00008631,NP19,"NP19 9LT, NP19 9LU, NP19 9NE, NP19 9PL, NP19 9PN, NP19 9PP, NP19 9YB, NP19 9YN, NP19 9YP, NP9 9LW, NP9 9LX, NP9 9NE, NP9 9PN, NP9 9PP, NP9 9PQ, NP9 9PW, NP9 9YA, NP9 9YD, NP9 9YJ, NP9 9YL, NP9 9YN, NP9 9YP, NP9 9YQ, NP9 9YT, NPT 9LU, NPT 9LW, NPT 9LX, NPT 9NE, NPT 9PN, NPT 9PP, NPT 9PQ",299,280,19
W00008691,NP19,"NP19 7GD, NP19 7GE, NP19 7RW, NP19 7SQ, NP19 7SR, NP9 7RW, NP9 7SL, NP9 7SS, NPT 7RW, NPT 7SL, NPT 7SS",238,218,20
W00010563,NP19,"NP19 0AS, NP19 0AU, NP19 0PP, NP19 0PQ, NP19 0PS, NP19 0PT, NP19 0PU, NP19 0PX, NP19 0PY, NP19 0PZ, NP19 0QA, NP19 0QB, NP19 0QE, NP19 0UU, NP9 0AD, NP9 0AJ, NP9 0AN, NP9 0AP, NP9 0AR, NP9 0AS, NP9 0AT, NP9 0AU, NP9 0AW, NP9 0TP, NP9 0UU, NP9 7XB, NP9 8EA, NP9 8WQ, NPT 0AD, NPT 0AJ, NPT 0AN, NPT 0AP, NPT 0AR, NPT 0AS, NPT 0AT, NPT 0AU, NPT 0TP, NPT 0UR, NPT 8EA, NPT 8WQ",292,277,15
W00009889,NP19,"NP19 4NW, NP19 4NX, NP19 4TD",145,138,7
W00008689,NP19,"NP19 7GF, NP19 7GL, NP19 7LF, NP19 7RU, NP19 7RX, NP19 7SS, NP9 7LE, NP9 7LG, NP9 7RU, NP9 7RX, NPT 7LE, NPT 7LG, NPT 7RU, NPT 7RX",289,258,31
W00008688,NP19,"NP19 7DT, NP19 7ET, NP19 7FU, NP19 7FX, NP19 7FY, NP19 7FZ, NP19 7GA, NP9 7FZ, NP9 7GH, NPT 7FZ, NPT 7GH",311,286,25
W00008687,NP19,"NP19 7GG, NP19 7GH, NP19 7JT, NP19 7JU, NP9 7GF, NP9 7GJ, NP9 7GL, NP9 7LA, NPT 7GF, NPT 7GJ, NPT 7GL, NPT 7LA, NPT 7YA",310,290,20
W00008686,NP19,"NP19 7GJ, NP19 7GN, NP19 7GP, NP19 7LA, NP19 7LB, NP19 7YB, NP19 7YF, NP19 7YG, NP9 4XH, NP9 7GN, NP9 7GP, NP9 7LB, NP9 7LD, NP9 7LF, NP9 7XU, NP9 7XX, NP9 7XY, NP9 7YA, NP9 7YB, NP9 7YD, NP9 7YE, NP9 7YG, NP9 7YH, NP9 7YJ, NP9 7YL, NP9 7YN, NP9 7YP, NPT 7GN, NPT 7GP, NPT 7LB, NPT 7LD, NPT 7LF, NPT 7XU",310,273,37
W00008372,NP19,"NP19 8JF, NP19 8LB, NP19 8LE, NP19 9AA, NP19 9AD, NP19 9AF, NP19 9AG, NP19 9AY, NP9 8LB, NP9 9AA, NP9 9AY, NP9 9AZ, NP9 9BJ, NPT 8LB, NPT 8LE, NPT 9AA, NPT 9AG, NPT 9AY, NPT 9AZ, NPT 9BJ, NPT 9DG",364,342,22
W00008684,NP19,"NP19 7HG, NP19 7HH, NP19 7JA, NP19 7JH, NP9 7HH, NP9 7HY, NP9 7JA, NPT 7HH, NPT 7HY, NPT 7JA",270,261,9
W00008683,NP19,"NP19 7DD, NP19 7DE, NP19 7DF, NP19 7DG, NP19 7DJ, NP19 7DY, NP19 7FL, NP19 7FN, NP19 7FP, NP9 7DE, NP9 7DH, NP9 7DJ, NP9 7DL, NP9 7DS, NP9 7DX, NP9 7DY, NP9 7DZ, NPT 7DE, NPT 7DG, NPT 7DH, NPT 7DJ, NPT 7DL, NPT 7DS, NPT 7XQ, NPT 7XX",355,335,20
W00008626,NP19,"NP19 9HY, NP19 9JA, NP19 9JE, NP9 9JA, NP9 9JB, NP9 9JD, NP9 9JE, NP9 9JF, NPT 9JA, NPT 9JB, NPT 9JD, NPT 9JE, NPT 9JF",278,266,12
W00008627,NP19,"NP19 9LX, NP19 9LY, NP19 9LZ, NP19 9NB, NP19 9ND, NP9 9LZ, NP9 9NA, NP9 9NB, NP9 9ND, NPT 9LZ, NPT 9NA, NPT 9NB, NPT 9ND",295,285,10
W00010506,NP19,"NP19 4DD, NP19 4DG, NP19 4DH, NP19 4DN, NP19 4DQ, NP19 4DR, NP19 4DS, NP19 4DU, NP19 4DW, NP19 4EB",256,241,15
W00008628,NP19,"NP19 9HS, NP19 9HU, NP19 9HW, NP19 9HX, NP19 9JD, NP19 9JS, NP9 9HX, NPT 9HX",345,321,24
W00008629,NP19,"NP19 9LL, NP19 9LP, NP19 9LQ, NP19 9LR, NP19 9LW, NP9 9HP, NP9 9HR, NP9 9HS, NP9 9LQ, NP9 9LY, NPT 9HR, NPT 9HS, NPT 9LQ, NPT 9LY",376,347,29
W00010509,NP19,"NP19 0RD, NP19 4AD, NP19 4AE, NP19 4AF, NP19 4AJ, NP19 4AU, NP19 4AW, NP19 4AX, NP19 4BD, NP19 4BE, NP19 4DE, NP19 4DF, NP19 4ED, NP19 4PU, NP19 4PW, NP19 4RD, NP19 4RF, NP19 4XB, NP19 4XH, NP19 4YH, NP9 0PU, NP9 0RH, NP9 0XL, NP9 0YP, NP9 0YR, NP9 0YX, NPT 0PU, NPT 0PW, NPT 0RH, NPT 0RJ, NPT 0TL, NPT 0XD, NPT 0YT",217,205,12
W00010514,NP19,"NP19 4QF, NP19 4QG, NP19 4QH, NP19 4RS, NP9 0QD, NP9 0QE, NP9 0QF, NP9 0QG, NP9 0QH, NP9 0QJ, NP9 0QQ, NP9 0RS, NP9 0RT, NPT 0QD, NPT 0QE, NPT 0QF, NPT 0QG, NPT 0QH, NPT 0QJ, NPT 0RS",261,245,16
W00010515,NP19,"NP19 0BN, NP19 0BY, NP19 0BZ, NP9 0BY, NPT 0BY, NPT 1PZ",466,440,26
W00008630,NP19,"NP19 9HR, NP19 9LA, NP19 9LD, NP19 9LH, NP19 9LJ, NP19 9LN, NP9 9HT, NP9 9HU, NP9 9HW, NP9 9LJ, NP9 9LL, NP9 9LN, NP9 9LP, NP9 9LR, NPT 9HT, NPT 9HU, NPT 9HW, NPT 9LH, NPT 9LJ, NPT 9LL, NPT 9LN, NPT 9LP, NPT 9LR",352,323,29
W00009868,NP19,"NP19 0LE, NP19 0LJ, NP19 0LN, NPT 0GL, NPT 1AL",366,338,28
W00010521,NP19,"NP19 4DT, NP19 4DX, NP19 4DY, NP19 4DZ, NP19 4EA, NP19 4EN, NP19 4EQ, NP19 4ER, NP19 4ET, NP19 4EW, NP19 4EX, NP19 4TJ, NP19 4TQ, NP19 4TY",283,265,18
W00010524,NP19,"NP19 0BB, NP19 0BD, NP19 0LZ, NP19 0NL, NP19 0NP, NP19 0NQ, NP19 0NR, NP19 0NS, NP19 0NU, NP19 0NX, NP19 0NY, NP19 0UQ, NP19 0WF, NP9 0DL, NP9 0DN, NPT 0DL, NPT 0DN",238,225,13
W00009874,NP19,"NP19 0DG, NP19 0DJ, NP19 0DW, NP19 0EW, NP19 0NZ, NP9 0DW, NP9 0FB, NP9 0GE, NP9 0WL, NP9 0WN, NP9 0WP, NP9 0WW, NP9 0XX, NP9 8WN, NPT 0DW, NPT 0FB, NPT 0WL, NPT 0WP, NPT 0XX, NPT 8WN, NPT 8WX",159,145,14
W00010540,NP19,"NP19 4AN, NP19 4AP, NP19 4AQ, NP19 4BN, NP19 4BP, NP19 4BW",250,236,14
W00009878,NP19,"NP19 0LA, NP19 0LB, NP19 0LD, NP19 0LF, NP19 0LG, NP19 0NA, NP19 0NB, NP19 0ND, NP19 0NE, NP19 0NG, NP19 0NH, NP19 0NJ, NP19 0NN, NP9 0GD, NP9 0GF, NPT 0TH",396,367,29
W00010551,NP19,"NP19 0LW, NP19 0PA, NP19 0PB, NP19 0PD, NP19 0PE, NP19 0PF, NP19 0PL, NP9 8JT, NP9 8NT, NP9 8NW, NPT 8JT, NPT 8NT, NPT 8NW",364,331,33
W00010561,NP19,"NP19 4AG, NP19 4AH, NP19 4AR, NP19 4BX, NP9 0XD, NPT 0XT, NPT 0XY",343,314,29
W00008373,NP19,"NP19 9QR, NP19 9QT, NP19 9QU, NP19 9QW, NP19 9QX, NP19 9QZ, NP9 9QQ, NP9 9QT, NP9 9QX, NP9 9QY, NP9 9QZ, NP9 9RA, NP9 9RU, NP9 9RW, NP9 9RX, NPT 9QQ, NPT 9QT, NPT 9QX, NPT 9QY, NPT 9QZ, NPT 9RA",318,296,22
W00008634,NP19,"NP19 9NZ, NP19 9RB, NP19 9RD, NP19 9RE, NP19 9RF, NP9 9NX, NP9 9NZ, NP9 9PA, NP9 9RF, NP9 9RG, NPT 9NX, NPT 9NZ, NPT 9PA, NPT 9PB, NPT 9RF, NPT 9RG",269,240,29
W00008375,NP19,"NP19 8JS, NP19 8JT, NP19 8JW, NP19 8LF, NP9 8JP, NP9 8JS, NP9 8JW, NPT 8JP, NPT 8JS, NPT 8JW",274,262,12
W00008374,NP19,"NP19 9AQ, NP19 9QB, NP9 9AS, NP9 9QN, NPT 9AS, NPT 9QN",351,325,26
W00008532,NP19,"NP19 0JL, NP19 0JN, NP19 0RW, NP9 0JF, NP9 0JJ, NP9 0JL, NP9 0JY, NPT 0JF, NPT 0JJ, NPT 0JL, NPT 0JY",247,229,18
W00008531,NP19,"NP19 4LF, NP19 4LQ, NP19 4NL, NP19 4NN, NP9 0LP, NP9 0LQ, NP9 0NN, NPT 0LP, NPT 0LQ, NPT 0NN, NPT 0NW",272,257,15
W00008530,NP19,"NP19 4NY, NP19 4PD, NP19 4PH, NP9 0NY, NP9 0PD, NP9 0PF, NP9 0PH, NPT 0NY, NPT 0PD, NPT 0PH",202,191,11
W00008529,NP19,"NP19 4JZ, NP19 4LA, NP19 4LB, NP19 4LD, NP19 4LZ, NP19 4NG, NP9 0JZ, NP9 0LB, NP9 0LD, NP9 0LE, NP9 0LF, NP9 0LG, NP9 0LU, NP9 0LY, NP9 0LZ, NP9 0NH, NPT 0JZ, NPT 0LB, NPT 0LD, NPT 0LE, NPT 0LF, NPT 0LG, NPT 0LH, NPT 0LU, NPT 0LY, NPT 0LZ",286,268,18
W00008527,NP19,"NP19 0FW, NP19 0FX, NP19 0FZ, NP19 0GB, NP19 0GQ, NP9 0FU, NP9 0FZ, NP9 0GQ, NP9 0HN, NP9 0HP, NP9 0HQ, NP9 0YE, NP9 0ZA, NP9 0ZB, NPT 0FU, NPT 0FZ, NPT 0GQ, NPT 0HN, NPT 0HP, NPT 0HQ, NPT 0YE",280,266,14
W00008526,NP19,"NP19 4EE, NP19 4LJ, NP19 4LL, NP19 4LN, NP19 4LS, NP19 4LT, NP19 4LW, NP19 4QY, NP9 0LN, NP9 0LS, NP9 0LT, NP9 0NA, NP9 0QY, NPT 0LN, NPT 0LT, NPT 0NA, NPT 0QY",282,264,18
W00008524,NP19,"NP19 0FA, NP19 0FD, NP19 0FE, NP19 0FF, NP19 0FG, NP9 0ES, NP9 0ET, NP9 0EU, NP9 0EX, NP9 0EY, NP9 8PA, NP9 8PB, NPT 0FE, NPT 8PA, NPT 8PB",313,293,20
W00008758,NP19,"NP19 8DJ, NP19 8DL, NP19 8DP, NP19 8DU, NP19 8GB",267,258,9
W00008759,NP19,"NP19 8DA, NP19 8DB, NP19 8DD, NP19 8DE, NP19 8DG, NP19 8DH, NP19 8DW, NP9 8DB, NP9 8DD, NP9 8DH, NP9 8FJ, NP9 8FL, NPT 8DB, NPT 8DD, NPT 8FJ, NPT 8FL, NPT 8XS, NPT 8YF",288,269,19
W00008760,NP19,"NP19 8BZ, NP19 8FF, NP19 8FG, NP19 8FH, NP19 8FJ, NP19 8GA, NP19 8XG, NP19 8XN, NP9 8DY, NP9 8FS, NP9 8FW, NP9 8FY, NP9 8FZ, NPT 8FS, NPT 8FY, NPT 8YB, NPT 8YD",346,317,29
W00008401,NP19,"NP19 8NN, NP19 8NZ, NP19 8PB, NP19 8PD, NP9 8NZ, NPT 8NZ",309,280,29
W00008400,NP19,"NP19 8EJ, NP19 8ER, NP19 8ES, NP19 8ET, NP19 8GH, NP19 8HA, NP19 8XP, NP9 0WB, NP9 8EH, NP9 8EJ, NP9 8EL, NP9 8EN, NP9 8ER, NP9 8ES, NP9 8ET, NP9 8GB, NP9 8GH, NP9 8GJ, NP9 8GL, NP9 8XF, NP9 8XP, NPT 0WB, NPT 8EL, NPT 8EN, NPT 8ER, NPT 8ES, NPT 8GB, NPT 8GH, NPT 8GJ, NPT 8GL, NPT 8XF, NPT 8XH, NPT 8XP, NPT 8YE",270,263,7
W00008399,NP19,"NP19 8GW, NP19 8HH, NP19 8HJ, NP19 8HN, NP19 8HP, NP19 8HY, NP9 8AA, NP9 8AR, NP9 8GW, NP9 8HA, NP9 8HN, NP9 8HP, NP9 8HQ, NP9 8HW, NP9 8HX, NP9 8NF, NPT 8AA, NPT 8AR, NPT 8GW, NPT 8HN, NPT 8HP, NPT 8HQ, NPT 8HX, NPT 8NF",307,285,22
W00008535,NP19,"NP19 4NZ, NP19 4TB, NP19 4TH, NP9 0NZ, NP9 0PB, NP9 0TB, NP9 0TH, NPT 0NZ, NPT 0PB, NPT 0TB",264,255,9
W00010628,NP19,"NP19 0ET, NP19 0EU, NP19 0EX, NP19 0EY",335,307,28
W00008398,NP19,"NP19 8HT, NP19 8HU, NP19 8HW, NP19 8HX, NP19 8HZ, NP9 1AE, NP9 8AD, NP9 8HS, NP9 8HU, NP9 8HZ, NPT 1AE, NPT 8AD, NPT 8HS, NPT 8HU, NPT 8HZ",293,270,23
W00008402,NP19,"NP19 8NP, NP19 8NS, NP19 8NU, NP19 8NX, NP9 8NP, NP9 8NU, NPT 8NP, NPT 8NU",305,286,19
W00010632,NP19,"NP19 0AB, NP19 0AH, NP19 0AJ, NP19 0AL, NP19 0AN, NP19 0AR, NP19 0AT, NP19 8AL, NP19 8AN, NP19 8BW, NP19 8EA, NP19 8WA, NP19 8WB, NP19 8WD, NP19 8WF, NP19 8WG, NP9 0AE, NP9 0AF, NP9 0AG, NP9 0AH, NP9 0AL, NP9 0UX, NP9 0UY, NP9 0UZ, NP9 7BU, NP9 8BN, NP9 8BW, NP9 8DR, NP9 8WA, NP9 8WB, NP9 8WD, NP9 8WF, NP9 8WG, NP9 8WR, NPT 0AE, NPT 0AG, NPT 0AH, NPT 0AL, NPT 0AZ, NPT 0TR, NPT 0UX, NPT 0UY, NPT 7BU, NPT 8BW, NPT 8DR, NPT 8WA, NPT 8WD, NPT 8WF, NPT 8WG, NPT 8WR, NPT 8XW",470,465,5
W00008403,NP19,"NP19 8DY, NP19 8DZ, NP19 8EL, NP19 8EN, NP19 8EP, NP19 8EQ, NP19 8GX, NP19 8NL, NP19 8PA, NP19 8XF, NP9 8DZ, NP9 8EP, NP9 8EQ, NP9 8GU, NP9 8GX, NP9 8NL, NP9 8NN, NP9 8PD, NP9 8UU, NPT 8EP, NPT 8EQ, NPT 8GU, NPT 8GX, NPT 8NL, NPT 8NN, NPT 8PD",318,304,14
W00008405,NP19,"NP19 7LY, NP19 7LZ, NP19 7NA, NP19 7NN, NP19 7NY, NP19 7QA, NP9 7JL, NPT 7JL",292,276,16
W00008537,NP19,"NP19 0RA, NP19 0RE, NP19 0RF, NP19 0RG, NP19 0RH, NP19 0RL, NP19 0RN, NP19 0RQ, NP19 0RT, NP19 0RU, NP19 0RX, NP19 0RY, NP19 0RZ, NP19 0XS, NP19 0XU, NP19 4QJ, NP19 4XD, NP9 0QL, NP9 0QN, NP9 0QP, NP9 0QR, NP9 0RU, NP9 0RX, NP9 0RY, NP9 0RZ, NP9 0TJ, NPT 0QL, NPT 0QN, NPT 0QP, NPT 0SE",388,354,34
W00008538,NP19,"NP19 4NJ, NP19 4QA, NP19 4QB, NP19 4QD, NP19 4QE, NP19 4QL, NP19 4QN, NP19 4QP, NP9 0NG, NP9 0NP, NP9 0NQ, NP9 0QA, NP9 0QB, NPT 0NG, NPT 0NH, NPT 0NJ, NPT 0NP, NPT 0NQ, NPT 0QA, NPT 0QB",258,247,11
W00008539,NP19,"NP19 4NP, NP19 4NQ, NP19 4NR, NP19 4PJ, NP19 4RN, NP9 0NJ, NP9 0NR, NP9 0NT, NP9 0NW, NP9 0NX, NP9 0RN, NP9 0TD, NP9 0YL, NPT 0NR, NPT 0NT, NPT 0NX, NPT 0RN, NPT 0SQ, NPT 0TD, NPT 0YQ",285,267,18
W00008542,NP19,"NP19 0GD, NP19 0GE, NP19 0HR, NP19 0HS, NP19 0LX, NP9 0HR, NP9 0YA, NP9 0YB, NP9 0YD, NP9 0YF, NP9 0YJ, NP9 0YN, NP9 0YQ, NP9 0YS, NP9 0YU, NPT 0HR",285,270,15
W00008543,NP19,"NP19 0GF, NP19 0HT, NP19 0HY, NP19 0HZ, NP19 0JA, NP19 0JW, NP9 0HY, NP9 0HZ, NP9 0JA, NP9 0JD, NP9 0JS, NP9 0JU, NP9 0JW, NP9 8JU, NP9 8JX, NPT 0HZ, NPT 0JA, NPT 8JU, NPT 8JX",264,246,18
W00008544,NP19,"NP19 0EZ, NP19 0FH, NP19 0FJ, NP19 0FL, NP19 0FN, NP19 0FQ, NP19 0FR, NP19 0FS, NP19 0PG, NP19 0PH, NP19 0PJ, NP19 0PN, NP19 0WS, NP19 0XY, NP19 0YD, NPT 0FH, NPT 0WS",409,385,24
W00008545,NP19,"NP19 0HN, NP19 0HP, NP19 0HQ",293,274,19
W00008546,NP19,"NP19 0JS, NP19 0JT, NP19 0JU, NP19 4SA, NP9 9AL, NPT 9AL",249,239,10
W00008547,NP19,"NP19 0FP, NP19 0FT, NP19 0FU, NP19 0FY, NP19 0HG, NP9 0FL, NP9 0FQ, NP9 0FR, NPT 0FL, NPT 0FQ, NPT 0FR",318,293,25
W00008548,NP19,"NP19 4LU, NP19 4LY, NP19 4SB, NP19 4SF, NP19 4SG, NP9 0SE, NP9 0SF, NP9 0SG, NP9 9AP, NPT 9AP",285,267,18
W00008549,NP19,"NP19 0HH, NP19 0HL, NP19 0HU, NP19 0HW, NP19 0HX, NP9 0FY, NP9 0HH, NP9 0HJ, NP9 0HS, NP9 0HU, NP9 0HW, NP9 0HX, NP9 0XZ, NP9 0YG, NP9 0YT, NP9 0YW, NPT 0HS, NPT 0HT, NPT 0HU, NPT 0HW, NPT 0HX",300,288,12
W00008550,NP19,"NP19 4NA, NP19 4NB, NP9 0NB, NP9 0ND, NPT 0NB, NPT 0ND",348,318,30
W00008551,NP19,"NP19 0HJ, NP19 0JB, NP19 0JD, NP19 0JE, NP19 0JF, NP19 0JP, NP19 0JQ, NP19 0JR, NP9 0HT, NP9 0JB, NP9 0JE, NP9 0JN, NP9 0JP, NP9 0JQ, NP9 0JR, NP9 0JT, NP9 0UA, NP9 0UB, NP9 1PH, NPT 0HY, NPT 0JB, NPT 0JD, NPT 0JE, NPT 0JN, NPT 0JP, NPT 0JQ, NPT 0UA, NPT 0XA, NPT 0XB, NPT 0XZ, NPT 0YS, NPT 1PH",282,266,16
W00008552,NP19,"NP19 4ND, NP19 4NE, NP19 4PG, NP9 0NE, NP9 0PG, NPT 0NE",507,408,99
W00008408,NP19,"NP19 7NP, NP19 7NQ, NP19 7NR, NP19 7NU, NP19 7NW, NP19 7NZ, NP19 7UB, NP9 7NA, NP9 7NZ, NPT 7NA, NPT 7NZ",223,212,11
W00008407,NP19,"NP19 7NB, NP19 7ND, NP19 7NE, NP19 7NH, NP19 7NL, NP9 7LY, NP9 7LZ, NP9 7NB, NP9 7ND, NP9 7NH, NP9 7NN, NP9 7NY, NP9 7QA, NPT 7LY, NPT 7LZ, NPT 7NB, NPT 7ND, NPT 7NH, NPT 7NJ, NPT 7NN, NPT 7NT, NPT 7NY, NPT 7QA",336,319,17
W00008406,NP19,"NP19 7NG, NP19 7PX, NP19 7PY, NP19 7PZ, NP9 7NF, NP9 7NG, NP9 7NJ, NP9 7NQ, NP9 7NR, NP9 7NS, NP9 7NT, NP9 7NX, NP9 7PY, NP9 7PZ, NPT 7NG, NPT 7NQ, NPT 7NR, NPT 7NS, NPT 7NU, NPT 7NX, NPT 7PY, NPT 7PZ",258,237,21
W00008404,NP19,"NP19 8NT, NP19 8NW, NP19 8NY, NP9 1QT, NP9 8HH, NP9 8NS, NP9 8NX, NP9 8NY, NPT 1QT, NPT 8HH, NPT 8NS, NPT 8NX, NPT 8NY",244,211,33
W00010637,NP19,"NP19 0BP, NP19 0BQ, NP19 0BR, NP9 0BP, NP9 0BR, NPT 0BP",203,196,7
W00008534,NP19,"NP19 0GU, NP19 0GX, NP19 0HA, NP19 0HB, NP19 0XB, NP19 0XH, NP19 0YG, NP9 0GY, NP9 0HD, NP9 0RA, NP9 0UD, NP9 0XB, NPT 0GY, NPT 0HD, NPT 0RA, NPT 0TQ, NPT 0XU",293,263,30
W00008763,NP19,"NP19 8FN, NP19 8FP, NP19 8FQ, NP19 8FX, NP19 8GG, NP9 8FP, NP9 8FQ, NP9 8LN, NP9 8LP, NP9 8LR, NP9 8LS, NPT 8FP, NPT 8FQ, NPT 8LN, NPT 8LP, NPT 8LR, NPT 8LS",373,350,23
W00008769,NP19,"NP19 0DA, NP19 0DB, NP19 0DD, NP19 0DE, NP19 0ED, NP9 0DA, NP9 0EE, NP9 0EH, NP9 8EU, NP9 8YB, NP9 8YE, NP9 8YF, NP9 8YG, NP9 8YJ, NP9 8ZA, NP9 8ZB, NP9 8ZY, NPT 0DA, NPT 0EE, NPT 0EH, NPT 8EU",292,271,21
W00008770,NP19,"NP19 0EF, NP19 0EG, NP19 0EH, NP19 0EJ, NP19 0EN, NP9 0ED, NP9 0EF, NP9 0EG, NPT 0ED, NPT 0EF, NPT 0EG",276,242,34
W00008771,NP19,"NP19 0BJ, NP19 0DL, NP19 0DN, NP19 0DP, NP19 0DQ, NP19 0DR, NP19 0QD, NP9 0BZ, NP9 0DB, NP9 0DE, NP9 0DP, NP9 0DQ, NP9 0DR, NP9 0WG, NPT 0BZ, NPT 0DB, NPT 0DE, NPT 0DP, NPT 0DQ, NPT 0DR, NPT 0WG",269,256,13
W00009857,NP19,"NP19 0FB, NP19 0GA, NP19 0GG, NP19 0GH, NP19 0GJ, NP19 0GN, NP19 0NF, NP19 0WY, NP9 0FE, NP9 0FF, NP9 0FG, NP9 0FH, NP9 0FJ, NP9 0FN, NP9 0FP, NP9 0FS, NP9 0FT, NP9 0FW, NP9 0FX, NP9 0GA, NP9 0GB, NP9 0GG, NP9 0GH, NP9 0GL, NP9 0GN, NP9 0TR, NP9 0WY, NP9 0WZ, NPT 0FF, NPT 0FG, NPT 0FJ, NPT 0FN, NPT 0FP, NPT 0FS, NPT 0FT, NPT 0FW, NPT 0FX, NPT 0FY, NPT 0GA, NPT 0GB, NPT 0GG, NPT 0GH, NPT 0GN, NPT 0WN, NPT 0WY",318,302,16
W00009864,NP19,"NP19 0DF, NP19 0DH, NP19 0DS, NP19 0DT, NP19 0DU, NP19 0WL, NP9 0DS, NP9 0DT, NP9 0DU, NP9 0DX, NP9 0DY, NP9 0EB, NP9 0EJ, NP9 0FA, NP9 0FD, NP9 0WH, NP9 0WJ, NPT 0DS, NPT 0DT, NPT 0DU, NPT 0DX, NPT 0DY, NPT 0DZ, NPT 0EB, NPT 0EJ, NPT 0FA, NPT 0FD, NPT 0WH, NPT 0WJ, NPT 8ET",416,389,27
W00009865,NP19,"NP19 0GL, NP19 0LH, NP19 0LL, NP19 0LP, NP19 0LU, NP9 0GJ, NP9 0WX, NPT 0GJ, NPT 0WX",262,230,32
W00008773,NP19,"NP19 0DX, NP19 0DY, NP19 0DZ, NP19 0EA, NP19 0EB, NP19 0ES, NP9 0DZ, NP9 0EA, NP9 0EL, NP9 0EN, NP9 0EQ, NP9 0ER, NPT 0EA, NPT 0EL, NPT 0EN, NPT 0EQ, NPT 0ER",304,288,16
W00008390,NP19,"NP19 7PD, NP19 7PE, NP19 7PF, NP19 7PN, NP19 7PP, NP19 7PQ, NP9 7PF, NP9 7PN, NP9 7PP, NP9 7PQ, NP9 7PR, NPT 7PD, NPT 7PE, NPT 7PF, NPT 7PN, NPT 7PP, NPT 7PQ, NPT 7PR",262,248,14
W00008397,NP19,"NP19 8GS, NP19 8HQ, NP19 8HR, NP19 8HS, NP19 8NA, NP19 8NB, NP19 8ND, NP19 8NF, NP19 8YD, NP19 8YJ, NP19 8YL, NP19 8YN, NP19 8YS, NP19 8ZB, NP9 8GT, NP9 8HR, NP9 8HT, NP9 8NA, NP9 8NB, NP9 8ND, NP9 8XH, NP9 8XS, NP9 8XW, NP9 8XX, NP9 8XY, NP9 8YA, NP9 8YD, NP9 8YH, NP9 8YL, NP9 8YN, NP9 8YP, NP9 8YQ, NP9 8YR, NP9 8YS, NPT 8GT, NPT 8HR, NPT 8HT, NPT 8NA, NPT 8NB, NPT 8ND",315,288,27
W00008396,NP19,"NP19 8GD, NP19 8GJ, NP19 8GL, NP19 8GQ, NP19 8GR, NP19 8GT, NP19 8GU, NP9 8GQ, NP9 8GR, NP9 8GS, NPT 8GQ, NPT 8GR, NPT 8GS",285,270,15
W00008391,NP19,"NP19 7RZ, NP19 7TD, NP19 7TE, NP19 7TF, NP19 7TG, NP19 7TH, NP19 7TJ, NP9 7LH, NP9 7LJ, NP9 7LL, NP9 7QR, NP9 7QS, NP9 7QT, NP9 7TD, NP9 7TE, NP9 7TF, NP9 7TG, NP9 7TH, NP9 7TJ, NPT 7QR, NPT 7QS, NPT 7QT, NPT 7TA, NPT 7TB, NPT 7TD, NPT 7TE, NPT 7TF, NPT 7TG, NPT 7TH, NPT 7TJ",272,255,17
W00008392,NP19,"NP19 7PG, NP19 7PH, NP19 7PJ, NP19 7PL, NP19 7QL, NP9 7PE, NP9 7PG, NP9 7PH, NP9 7PJ, NPT 7PG, NPT 7PH, NPT 7PJ",230,209,21
W00008761,NP19,"NP19 0BE, NP19 0EE, NP19 0EL, NP19 0EP, NP19 0EQ, NP19 0ER, NP19 0HF, NP19 0YE, NP9 0EP, NPT 0EP, NPT 0ES",393,361,32
W00008393,NP19,"NP19 7RY, NP19 7SB, NP19 7SD, NP19 7SE, NP19 7SH, NP19 7SL, NP19 8LX, NP9 7QN, NP9 7RZ, NP9 8LX, NPT 7QN, NPT 7RZ, NPT 8HW, NPT 8LX",304,281,23
W00008394,NP19,"NP19 7QN, NP19 7QP, NP19 7QQ, NP19 7QR, NP19 7QS, NP19 7QT, NP19 7QU, NP9 7PL, NP9 7QQ, NP9 7QU, NPT 7PL, NPT 7QQ, NPT 7QU",340,309,31
W00008395,NP19,"NP19 7SA, NP19 8AJ, NP19 8LY, NP19 8LZ, NP19 8NE, NP9 7QL, NP9 7QP, NP9 7SA, NP9 8AG, NP9 8AH, NP9 8AJ, NP9 8BD, NP9 8LY, NP9 8LZ, NP9 8NE, NPT 7QL, NPT 7QP, NPT 7SA, NPT 8AG, NPT 8AH, NPT 8AJ, NPT 8BD, NPT 8FW, NPT 8LY, NPT 8LZ, NPT 8NE",285,262,23
W00008774,NP19,"NP19 7SP, NP19 8LL, NP19 8LP, NP19 8LQ, NP19 8LR, NP19 8PE, NP9 7SJ, NP9 7SP, NP9 7SQ, NP9 8LL, NP9 8LQ, NPT 7SP, NPT 7SQ, NPT 8LL, NPT 8LQ",292,274,18
W00008389,NP19,"NP19 7FS, NP19 7LH, NP19 7QX, NP19 7TA, NP19 7TB, NP9 7QW, NP9 7QY, NP9 7TA, NP9 7TB, NPT 7QW, NPT 7QY",234,214,20
W00008768,NP19,"NP19 0WB, NP19 8EG, NP19 8EH, NP19 8EU, NP19 8EW, NP19 8EX, NP19 8EY, NP19 8FB, NP19 8FD, NP19 8GE, NP19 8GF, NP19 8XE, NP9 8BY, NP9 8BZ, NP9 8EE, NP9 8EF, NP9 8EG, NP9 8EW, NP9 8EX, NP9 8FB, NP9 8FD, NP9 8FE, NP9 8FF, NP9 8FG, NP9 8FH, NP9 8FU, NP9 8GE, NP9 8GF, NP9 8WY, NP9 8WZ, NP9 8XA, NP9 8XE, NP9 8XG, NP9 8XJ, NP9 8XN, NPT 8BY, NPT 8BZ, NPT 8EE, NPT 8EF, NPT 8EG, NPT 8EH, NPT 8EW, NPT 8EX, NPT 8FF, NPT 8FG, NPT 8FH, NPT 8FU, NPT 8GE, NPT 8GF, NPT 8WZ, NPT 8XA, NPT 8XE, NPT 8XG, NPT 8XN",383,371,12
W00008381,NP19,"NP19 8AF, NP19 8AG, NP19 8AH, NP19 8AU, NP9 8AU, NP9 8AW, NP9 8BA, NP9 8BE, NPT 8AU, NPT 8AW, NPT 8BA, NPT 8BE",317,290,27
W00008376,NP19,"NP19 9QP, NP19 9QQ, NP19 9RU, NP19 9RW, NP19 9RX, NP19 9SY, NP19 9SZ, NP19 9XA, NP9 9NS, NP9 9QP, NP9 9RY, NP9 9SA, NP9 9SH, NP9 9SS, NP9 9ST, NP9 9SX, NP9 9SY, NP9 9SZ, NPT 9QP, NPT 9RW, NPT 9RX, NPT 9RY, NPT 9SA, NPT 9SH, NPT 9SS, NPT 9ST, NPT 9SY",306,288,18
W00008377,NP19,"NP19 8JU, NP19 8JX, NP19 8JY, NP19 8LG, NP19 9AE, NP9 8JR, NP9 8JY, NP9 8LD, NP9 8LF, NP9 8LG, NP9 9AD, NP9 9AE, NP9 9AF, NPT 8JR, NPT 8JY, NPT 8LF, NPT 9AD, NPT 9AE, NPT 9AF",235,224,11
W00008378,NP19,"NP19 9AR, NP19 9NS, NP19 9NT, NP19 9NU, NP19 9NW, NP19 9PT, NP19 9PW, NP19 9PX, NP19 9QS, NP19 9QY, NP19 9RA, NP19 9RJ, NP9 9NT, NP9 9NU, NP9 9NW, NP9 9NY, NP9 9QR, NP9 9QS, NP9 9QU, NP9 9QW, NP9 9RB, NP9 9RD, NP9 9RH, NP9 9RJ, NP9 9RZ, NP9 9YG, NPT 9NS, NPT 9NT, NPT 9NU, NPT 9NW, NPT 9NY, NPT 9QR, NPT 9QS, NPT 9QU, NPT 9QW, NPT 9RB, NPT 9RD, NPT 9RH, NPT 9RZ",379,344,35
W00008379,NP19,"NP19 8AW, NP19 8BD, NP19 8BE, NP19 8BG, NP19 8BJ, NP9 8BG, NP9 9BS, NPT 8BG, NPT 9BS",322,295,27
W00008380,NP19,"NP19 8BH, NP19 9BS, NP19 9BT, NP19 9BU, NP19 9BW, NP19 9BX, NP9 8BH, NP9 9BT, NP9 9BX, NP9 9DH, NP9 9DU, NPT 8BH, NPT 9BT, NPT 9BX, NPT 9DH",315,275,40
W00008388,NP19,"NP19 7QB, NP19 7QW, NP19 7RF, NP19 7RG, NP9 5YG, NP9 5YH, NP9 7PU, NP9 7PW, NP9 7PX, NP9 7QB, NP9 7RF, NP9 7RG, NPT 7PU, NPT 7PW, NPT 7PX, NPT 7QB, NPT 7RF, NPT 7RG",312,297,15
W00008382,NP19,"NP19 9BZ, NP19 9EA, NP19 9EB, NP19 9EE, NP19 9EP, NP9 9DX, NP9 9DY, NP9 9EA, NP9 9ED, NP9 9EE, NP9 9EG, NP9 9EP, NP9 9EX, NP9 9PH, NPT 9DX, NPT 9DY, NPT 9EA, NPT 9EE, NPT 9EG, NPT 9EP, NPT 9ET, NPT 9EX, NPT 9PH",295,267,28
W00008775,NP19,"NP19 7EL, NP19 8BU, NP19 8FL, NP19 8FW, NP9 7FB, NP9 8EZ, NP9 8FN, NP9 8FR, NP9 8FX, NPT 7FB, NPT 8EZ, NPT 8FN, NPT 8FR, NPT 8FX",303,293,10
W00008383,NP19,"NP19 7SF, NP19 7SG, NP19 7SJ, NP19 7SN, NP19 8LU, NP19 8LW, NP9 7RY, NP9 7SB, NP9 7SD, NP9 7SE, NP9 7SF, NP9 7SG, NP9 7SH, NP9 7SN, NP9 8LU, NP9 8LW, NPT 7RY, NPT 7SB, NPT 7SD, NPT 7SE, NPT 7SF, NPT 7SG, NPT 7SH, NPT 7SJ, NPT 7SN, NPT 8LU, NPT 8LW",273,240,33
W00008384,NP19,"NP19 8FE, NP19 8GN, NP19 8GP, NP19 8LS, NP19 8LT, NP9 8GD, NP9 8GG, NP9 8GN, NP9 8GP, NP9 8LT, NPT 8GD, NPT 8GG, NPT 8GN, NPT 8GP, NPT 8LT",293,270,23
W00008767,NP19,"NP19 0AW, NP19 0AY, NP19 0AZ, NP19 0BA, NP19 0BU, NP19 8BX, NP19 8EB, NP19 8PT, NP19 8WS, NP19 8WU, NP19 8XB, NP9 0AY, NP9 0AZ, NP9 0BA, NP9 1PT, NP9 8BU, NP9 8BX, NP9 8DJ, NP9 8EB, NP9 8WH, NP9 8WS, NP9 8WU, NP9 8WW, NP9 8WX, NP9 8XB, NPT 0AW, NPT 0AY, NPT 0BA, NPT 0UZ, NPT 0VA, NPT 1PT, NPT 8BX, NPT 8DJ, NPT 8EB, NPT 8WH, NPT 8WS, NPT 8WU, NPT 8WW, NPT 8XB",528,492,36
W00008553,NP19,"NP19 4LE, NP19 4LG, NP19 4LH, NP19 4LP, NP19 4LR, NP19 4LX, NP19 4NF, NP19 4PY, NP9 0LH, NP9 0LJ, NP9 0LL, NP9 0LR, NP9 0LW, NP9 0LX, NP9 0NF, NPT 0LJ, NPT 0LL, NPT 0LR, NPT 0LS, NPT 0LW, NPT 0LX",332,318,14
W00008385,NP19,"NP19 7NF, NP19 7NJ, NP19 7NS, NP19 7NT, NP19 7NX, NP9 7NU, NPT 7NF",245,227,18
W00008386,NP19,"NP19 7QY, NP19 7RA, NP19 7RB, NP19 7RD, NP19 7RE, NP9 7RD, NP9 7RE, NPT 7RD, NPT 7RE",282,260,22
W00008387,NP19,"NP19 7PA, NP19 7PB, NP19 7PR, NP19 7PS, NP19 7PT, NP19 7PU, NP19 7PW, NP9 7NP, NP9 7PA, NP9 7PB, NP9 7PD, NP9 7PS, NP9 7PT, NPT 7NP, NPT 7PA, NPT 7PB, NPT 7PS, NPT 7PT",273,249,24
W00008765,NP19,"NP19 0BX, NP19 8BP, NP19 8BY, NP19 8DF, NP19 8DT, NP19 8ED, NP19 8EE, NP19 8EF, NP19 8WZ, NP19 8XA, NP19 8XD, NP19 8ZA, NP19 8ZG, NP19 8ZW, NP19 8ZY, NP9 8DA, NP9 8DF, NP9 8DG, NP9 8DW, NP9 8EY, NP9 8XD, NPT 8DA, NPT 8DF, NPT 8DG, NPT 8DH, NPT 8DW, NPT 8EY, NPT 8WY, NPT 8XD",294,274,20
W00008764,NP19,"NP19 0BL, NP19 0BS, NP19 0BT, NP19 0BW, NP9 0BN, NP9 0BW, NP9 0BX, NP9 1PZ, NP9 8DS, NP9 8DT, NP9 8ED, NP9 8WL, NP9 8XL, NPT 0BN, NPT 0BW, NPT 0BX, NPT 8DS, NPT 8DT, NPT 8ED, NPT 8WL",464,427,37
W00007263,NP2,"NP2 6AH, NP2 6EJ, NP2 6ES, NP2 6ET, NP2 6EY, NP2 6EZ, NP2 6HA, NP2 6HD, NP2 6XS, NP24 6EJ, NP24 6EQ, NP24 6ES, NP24 6ET, NP24 6EU, NP24 6EX, NP24 6EY, NP24 6EZ, NP24 6HA, NP24 6HB, NP24 6LX, NP24 6LZ",229,204,25
W00007264,NP2,"NP2 6AJ, NP2 6AQ, NP2 6LG, NP2 6LH, NP24 6AG, NP24 6AQ, NP24 6LG, NP24 6LH, NP24 6LQ, NP24 6XF",303,290,13
W00007262,NP2,"NP2 6BW, NP24 6BL, NP24 6BN, NP24 6BP, NP24 6BS, NP24 6BW",271,258,13
W00007252,NP2,"NP2 6BA, NP2 6BB, NP2 6BD, NP2 6BE, NP2 6BG, NP2 6BN, NP2 6BQ, NP2 6BR, NP24 6AY, NP24 6AZ, NP24 6BA, NP24 6BE",333,315,18
W00007259,NP2,"NP2 6HT, NP2 6HU, NP2 6HZ, NP2 6JA, NP2 6JB, NP2 6JD, NP2 6JN, NP2 6JW, NP2 6XU, NP24 6HU, NP24 6HX, NP24 6HY, NP24 6HZ, NP24 6JA, NP24 6JB, NP24 6JD, NP24 6JE, NP24 6JG, NP24 6JH, NP24 6JW",347,324,23
W00007197,NP2,"NP2 5JP, NP2 5LA, NP2 5LF, NP2 5LG, NP2 5LQ, NP22 5LB, NP22 5LE, NP22 5LF, NP22 5LG, NP22 5LQ",321,298,23
W00007198,NP2,"NP2 5LL, NP2 5LP, NP2 5NB, NP2 5NJ, NP2 5NN, NP2 5NQ, NP2 5NS, NP2 5NU, NP2 5NX, NP2 5NZ, NP2 5PA, NP2 5XJ, NP2 5XL, NP22 5DY, NP22 5LL, NP22 5LP, NP22 5LR, NP22 5LS, NP22 5LZ, NP22 5ND, NP22 5NE, NP22 5NH, NP22 5NJ, NP22 5NN, NP22 5NU, NP22 5XD, NP22 5XE, NP22 5XL, NP22 5YB",222,187,35
W00007199,NP2,"NP2 5LU, NP2 5ND, NP2 5NE, NP2 5NF, NP2 5NG, NP2 5NH, NP2 5NL, NP2 5QF, NP2 5XA, NP2 5XH, NP2 5XN, NP2 5XP, NP2 5XR, NP2 5XS, NP2 5XU, NP2 5YA, NP22 5DZ, NP22 5HE, NP22 5LY, NP22 5NB, NP22 5NF, NP22 5NG, NP22 5NQ, NP22 5XJ",303,241,62
W00007200,NP2,"NP2 5AD, NP2 5AE, NP2 5AF, NP2 5JA, NP2 5JB, NP2 5JN, NP2 5JS, NP2 5LB, NP2 5LH, NP2 5LJ, NP2 5LN, NP2 5LR, NP2 5LS, NP2 5PL, NP2 5PN, NP2 5PP, NP2 5PR, NP2 5PS, NP2 5PT, NP2 5PU, NP2 5PW, NP2 5PX, NP2 5PY, NP2 5PZ, NP2 5QA, NP2 5XB, NP2 5XD, NP2 5XE, NP2 5XF, NP2 5XG, NP22 5AE, NP22 5DX, NP22 5JN, NP22 5LH, NP22 5LJ, NP22 5LN, NP22 5LT, NP22 5PH, NP22 5PY, NP22 5PZ, NP22 5QB, NP22 5XF, NP22 5XS, NP22 5YD, NP22 5YJ",236,216,20
W00007201,NP2,"NP2 5AB, NP2 5AG, NP22 5AB, NP22 5AD, NP22 5AF, NP22 5AG",205,185,20
W00007202,NP2,"NP2 5PF, NP2 5PG, NP22 5NS, NP22 5NX, NP22 5NZ, NP22 5PA, NP22 5PB, NP22 5PF, NP22 5PJ, NP22 5PW",252,222,30
W00007203,NP2,"NP2 5PB, NP2 5PD, NP2 5PE, NP2 5PH, NP2 5PJ, NP2 5PQ, NP22 5JD, NP22 5PD, NP22 5PE, NP22 5PG, NP22 5PL, NP22 5PN, NP22 5PQ, NP22 5XA",251,227,24
W00007204,NP2,"NP2 5JQ, NP22 5HA, NP22 5JA, NP22 5JG, NP22 5JJ, NP22 5JP, NP22 5JQ, NP22 5JR, NP22 5QA",251,238,13
W00007205,NP2,"NP2 5JD, NP2 5JY, NP2 5JZ, NP22 5JB, NP22 5LX, NP22 5PP, NP22 5PR, NP22 5PS, NP22 5PU, NP22 5PX",238,220,18
W00007206,NP2,"NP2 5JE, NP2 5JF, NP2 5JG, NP2 5JH, NP2 5JJ, NP2 5JL, NP2 5JW, NP2 5LD, NP22 5JE, NP22 5JF, NP22 5JH, NP22 5JL, NP22 5JS, NP22 5JW, NP22 5JY, NP22 5LD, NP22 5LU",285,255,30
W00010336,NP2,"NP2 3LQ, NP2 4BX, NP2 4BY, NP2 4DA, NP2 4DB, NP2 4DD, NP2 4NF, NP22 3LQ, NP22 4BQ, NP22 4BX, NP22 4BZ, NP22 4DA, NP22 4DB, NP22 4DD, NP22 4NJ, NP23 6QT, NP3 6QS, NP3 6QT",193,188,5
W00007261,NP2,"NP2 6AY, NP2 6BP, NP2 6BS, NP2 6BT, NP2 6BU, NP2 6BX, NP2 6BY, NP2 6BZ, NP2 6LJ, NP2 6XE, NP24 6AJ, NP24 6BT, NP24 6BU, NP24 6BX, NP24 6BY, NP24 6BZ, NP24 6DA, NP24 6LJ, NP24 6XB, NP24 6XE",259,241,18
W00010350,NP2,"NP2 4BZ, NP22 4FA, NP22 4FD, NP22 4FE, NP22 4FF",351,318,33
W00007209,NP2,"NP2 5AP, NP2 5AW, NP22 5AN, NP22 5AS, NP22 5AT, NP22 5AW, NP22 5AZ",245,227,18
W00007210,NP2,"NP2 5AJ, NP2 5AL, NP22 5AA, NP22 5AJ, NP22 5AL, NP22 5AQ",279,255,24
W00007211,NP2,"NP2 5AH, NP2 5AN, NP2 5AQ, NP2 5AX, NP2 5AY, NP2 5BA, NP2 5BB, NP2 5BD, NP2 5BE, NP22 5AH, NP22 5AX, NP22 5BA, NP22 5BB, NP22 5BD, NP22 5BE, NP22 5BG, NP22 5BJ",328,309,19
W00007212,NP2,"NP2 5ES, NP2 5ET, NP2 5EU, NP2 5HD, NP2 5HE, NP2 5HF, NP2 5HG, NP2 5HP, NP2 5LX, NP2 5LY, NP2 5LZ, NP22 5EU, NP22 5HB, NP22 5HD, NP22 5HP, NP22 5HT, NP22 5HU, NP22 5NL",168,148,20
W00007250,NP2,"NP2 6DY, NP2 6DZ, NP2 6NT, NP2 6NU, NP2 6NX, NP2 6NY, NP2 6NZ, NP2 6PA, NP2 6PB, NP2 6PD, NP24 6DP, NP24 6DR, NP24 6DT, NP24 6DY, NP24 6DZ, NP24 6NN, NP24 6NU, NP24 6NX",299,287,12
W00007251,NP2,"NP2 6AR, NP2 6AW, NP2 6AZ, NP2 6DF, NP2 6DG, NP2 6DQ, NP2 6HF, NP2 6XD, NP2 6XG, NP2 6XH, NP2 6XJ, NP24 6AN, NP24 6AS, NP24 6AW, NP24 6DG, NP24 6DH, NP24 6DQ, NP24 6EE, NP24 6EN, NP24 6FA, NP24 6HF, NP24 6HL, NP24 6XG, NP24 6XJ",285,255,30
W00007253,NP2,"NP2 6AB, NP2 6AE, NP2 6AF, NP2 6AG, NP2 6EL, NP2 6EP, NP2 6ER, NP2 6HE, NP2 6LQ, NP2 6XF, NP24 6AH, NP24 6AR, NP24 6EL, NP24 6EP, NP24 6ER, NP24 6HD, NP24 6XS",182,176,6
W00007254,NP2,"NP2 6AA, NP2 6AD, NP2 6AL, NP2 6AN, NP2 6EN, NP2 6EW, NP2 6HG, NP2 6HH, NP2 6HJ, NP2 6HQ, NP2 6XA, NP2 6XB, NP2 6XL, NP2 6XN, NP2 6XR, NP24 6AA, NP24 6AB, NP24 6AD, NP24 6AE, NP24 6AF, NP24 6AL, NP24 6EH, NP24 6EW, NP24 6HE, NP24 6HG, NP24 6HH, NP24 6HJ, NP24 6HQ",280,263,17
W00007256,NP2,"NP2 6DJ, NP2 6DS, NP2 6DW, NP2 6NP, NP2 6NQ, NP2 6NR, NP2 6NS, NP2 6NW, NP2 6YA, NP2 6YB, NP2 6YD, NP24 6AP, NP24 6DL, NP24 6DN, NP24 6DS, NP24 6DW, NP24 6NG, NP24 6NL, NP24 6XT",257,228,29
W00007257,NP2,"NP2 6AP, NP2 6DD, NP2 6DE, NP2 6DH, NP2 6DL, NP2 6DN, NP2 6DP, NP2 6DR, NP2 6DT, NP2 6NG, NP2 6NN, NP24 6BJ, NP24 6DD, NP24 6DE, NP24 6DF, NP24 6DJ, NP24 6EF, NP24 6EG",139,137,2
W00007258,NP2,"NP2 6DU, NP2 6DX, NP2 6ED, NP24 6BH, NP24 6DU, NP24 6DX, NP24 6HT, NP24 6PA, NP24 6PB, NP24 6PD",272,259,13
W00007208,NP2,"NP2 5AR, NP2 5AS, NP2 5AT, NP2 5AU, NP2 5AZ, NP2 5BH, NP22 5AP, NP22 5AR, NP22 5AU, NP22 5AY, NP22 5BH",314,297,17
W00007207,NP2,"NP2 5JR, NP2 5JT, NP2 5JU, NP2 5JX, NP2 5LE, NP22 5JT, NP22 5JU, NP22 5JX, NP22 5JZ, NP22 5LA",284,255,29
W00007740,NP2,"NP2 3EY, NP2 3HX, NP22 3EQ, NP22 3HR, NP22 3HS, NP22 3HU, NP22 3HY",206,200,6
W00007741,NP2,"NP2 3DA, NP2 3DD, NP2 3DP, NP2 3DR, NP2 3DS, NP2 3DT, NP2 3DX, NP2 3DY, NP2 3ET, NP22 3DP, NP22 3DR, NP22 3DS, NP22 3DT, NP22 3DX, NP22 3EN, NP22 3ES, NP22 3ET, NP22 4NP",284,249,35
W00007698,NP2,"NP2 4AG, NP2 4AH, NP2 4AN, NP2 4AQ, NP2 4AR, NP2 4AS, NP22 4AG, NP22 4AH, NP22 4AN, NP22 4AQ, NP22 4AR, NP22 4AS",250,232,18
W00007697,NP2,"NP2 4PL, NP2 4PN, NP2 4PU, NP2 4PW, NP2 4XP, NP22 4PN, NP22 4PU, NP22 4PW",289,279,10
W00007696,NP2,"NP2 4DE, NP2 4DF, NP2 4DG, NP2 4DQ, NP22 4DE, NP22 4DF, NP22 4DG, NP22 4DQ",189,184,5
W00007695,NP2,"NP2 3SH, NP2 3SJ, NP2 3SN, NP2 3SW, NP22 3SH, NP22 3SJ, NP22 3SN, NP22 3SW",229,208,21
W00007694,NP2,"NP2 3SD, NP2 3SG, NP2 3SL, NP2 3SQ, NP22 3SD, NP22 3SG, NP22 3SL, NP22 3SQ",245,229,16
W00007693,NP2,"NP2 3AA, NP2 3AD, NP2 3AG, NP2 3AH, NP2 3AP, NP2 3AQ, NP2 3AR, NP2 3AU, NP2 3AW, NP2 3AX, NP2 3AY, NP2 3BD, NP2 3BE, NP2 3HJ, NP2 3HQ, NP2 3SS, NP2 3XF, NP2 3XG, NP2 3XQ, NP2 3XW, NP2 3XX, NP2 3XY, NP22 3AA, NP22 3AD, NP22 3AG, NP22 3AJ, NP22 3AL, NP22 3AP, NP22 3AQ, NP22 3AR, NP22 3AS, NP22 3AU, NP22 3AW, NP22 3AX, NP22 3AY, NP22 3AZ, NP22 3BB, NP22 3BD, NP22 3BE, NP22 3BL, NP22 3BN, NP22 3BP, NP22 3RP, NP22 3XX",373,340,33
W00007692,NP2,"NP2 3SE, NP2 3SR, NP2 4DH, NP2 4DJ, NP2 4EP, NP2 4ET, NP22 3SE, NP22 3SR, NP22 4DH, NP22 4DJ, NP22 4EP",260,248,12
W00007691,NP2,"NP2 4ER, NP2 4ES, NP2 4EU, NP2 4EX, NP2 4EY, NP2 4EZ, NP2 4HA, NP2 4HD, NP2 4HE, NP2 4HF, NP2 4HG, NP2 4HH, NP22 4ER, NP22 4ES, NP22 4ET, NP22 4EU, NP22 4EX, NP22 4EY, NP22 4HA, NP22 4HD, NP22 4HE, NP22 4HF, NP22 4HG, NP22 4HH",100,96,4
W00007690,NP2,"NP2 3BB, NP2 4AP, NP2 4DP, NP2 4DW, NP2 4DX, NP2 4DY, NP2 4EA, NP2 4EB, NP2 4EE, NP2 4EF, NP2 4EL, NP2 4EN, NP2 4EW, NP2 4XB, NP2 4XD, NP22 4AP, NP22 4BD, NP22 4BE, NP22 4DL, NP22 4DS, NP22 4DW, NP22 4DX, NP22 4DY, NP22 4EA, NP22 4EB, NP22 4EE, NP22 4EF, NP22 4EL, NP22 4EN, NP22 4EQ, NP22 4EW, NP22 4HP, NP22 4XB, NP22 4XD, NP3 5BY",369,336,33
W00007681,NP2,"NP2 4DL, NP2 4EQ, NP2 4LQ, NP2 4NX, NP2 4XA, NP2 4XH, NP2 4XR, NP2 4XY, NP2 4YA, NP2 4YB, NP2 4YD, NP2 4YE, NP22 4DP, NP23 5AQ, NP23 5BG, NP23 5BP, NP23 5BQ, NP23 5BS, NP23 5BT, NP23 5BU, NP23 5BX, NP23 5BY, NP23 5DA, NP23 5DB, NP23 5DD, NP23 5DR, NP23 5HB, NP23 5SD, NP3 5BP, NP3 5BS, NP3 5BT, NP3 5BU, NP3 5BX, NP3 5DA, NP3 5DB, NP3 5SJ, NP3 5YF",291,271,20
W00007647,NP2,"NP2 4NL, NP2 4QZ, NP2 4RA, NP2 4RB, NP22 4QZ, NP22 4RA, NP22 4RB, NP22 4YE",308,286,22
W00007646,NP2,"NP2 3JL, NP2 3JN, NP2 3LE, NP2 3LP, NP2 3LW, NP22 3JL, NP22 3JN, NP22 3JP, NP22 3JQ, NP22 3JW, NP22 3LP, NP22 3LW",239,231,8
W00007645,NP2,"NP2 4BQ, NP2 4ND, NP2 4NE, NP22 4BY, NP22 4JS, NP22 4ND, NP22 4NE, NP22 4NF",229,217,12
W00007644,NP2,"NP2 4BJ, NP2 4JW, NP2 4LX, NP2 4NA, NP2 4NB, NP2 4NG, NP22 4JB, NP22 4JL, NP22 4JN, NP22 4JW, NP22 4NA, NP22 4NB",240,225,15
W00007643,NP2,"NP2 4JG, NP2 4JH, NP2 4JJ, NP2 4JL, NP2 4JN, NP2 4LR, NP22 4JA, NP22 4JG, NP22 4JH, NP22 4JJ",223,218,5
W00007642,NP2,"NP2 4JQ, NP2 4LF, NP2 4LG, NP2 4LP, NP2 4LS, NP2 4LT, NP2 4LU, NP2 4LW, NP22 4JQ, NP22 4JT, NP22 4LF, NP22 4LG, NP22 4LH, NP22 4LJ, NP22 4LN, NP22 4LS, NP22 4LU, NP22 4NQ",341,311,30
W00007641,NP2,"NP2 3LA, NP2 4JE, NP2 4LD, NP2 4LE, NP2 4LH, NP2 4LN, NP22 4HX, NP22 4JD, NP22 4JE, NP22 4JF, NP22 4LD, NP22 4NN",279,265,14
W00007640,NP2,"NP2 3LB, NP2 4LJ, NP2 4LL, NP22 3AH, NP22 3LA, NP22 3LB, NP22 3LD, NP22 4LE, NP22 4LL, NP22 4LP, NP22 4LQ, NP22 4LW",343,316,27
W00007638,NP2,"NP2 3JT, NP2 3JX, NP2 3JY, NP2 3JZ, NP2 3LD, NP2 3LF, NP22 3JT, NP22 3JU, NP22 3JX, NP22 3JY, NP22 3JZ",232,211,21
W00007475,NP2,"NP2 5BW, NP2 5BY, NP2 5BZ, NP22 5BN, NP22 5BT, NP22 5BU, NP22 5BW, NP22 5DA, NP22 5EF",260,243,17
W00007474,NP2,"NP2 5DL, NP2 5DN, NP2 5DP, NP2 5DW, NP22 5DL, NP22 5DN, NP22 5DP, NP22 5DR, NP22 5DS, NP22 5DW, NP22 5QW",368,335,33
W00007472,NP2,"NP2 5BS, NP2 5BT, NP2 5BU, NP2 5DU, NP2 5EP, NP2 5ER, NP2 5HJ, NP2 5HN, NP2 5HQ, NP22 5BS, NP22 5ER, NP22 5ES, NP22 5HF, NP22 5HG, NP22 5HH, NP22 5HJ, NP22 5HL, NP22 5HN, NP22 5HQ, NP22 5HR, NP22 5HS, NP22 5HW",297,258,39
W00007471,NP2,"NP2 5EA, NP2 5EF, NP2 5EL, NP2 5EW, NP2 5HH, NP2 5HL, NP2 5HR, NP2 5HS, NP2 5HT, NP2 5HW, NP22 5BP, NP22 5EL, NP22 5EN, NP22 5EP, NP22 5ET, NP22 5EW, NP22 5EX",275,234,41
W00007470,NP2,"NP2 5EE, NP2 5EG, NP2 5EH, NP2 5EJ, NP2 5EN, NP2 5EX, NP2 5EY, NP2 5EZ, NP2 5HB, NP2 5QP, NP22 5DF, NP22 5EA, NP22 5ED, NP22 5EE, NP22 5EG, NP22 5EH, NP22 5EJ, NP22 5EY, NP22 5EZ, NP22 5QP, NP22 5RL",265,247,18
W00007469,NP2,"NP2 5DQ, NP2 5DT, NP2 5QN, NP2 5QR, NP22 5DD, NP22 5DG, NP22 5DQ, NP22 5DT, NP22 5DU, NP22 5QN",258,242,16
W00007637,NP2,"NP2 3LG, NP2 3LH, NP2 3LJ, NP22 3LE, NP22 3LF, NP22 3LG, NP22 3LH, NP22 3LJ, NP22 3LL",196,185,11
W00007636,NP2,"NP2 4LY, NP2 4LZ, NP2 4NH, NP22 4BJ, NP22 4LR, NP22 4LT, NP22 4LX, NP22 4LY, NP22 4LZ, NP22 4NG, NP22 4NH",314,284,30
W00007699,NP2,"NP2 3RY, NP2 3RZ, NP2 3SA, NP2 3SB, NP2 3SP, NP2 3ST, NP2 4AJ, NP2 4AL, NP2 4HN, NP2 4XF, NP22 3RY, NP22 3RZ, NP22 3SA, NP22 3SB, NP22 3SF, NP22 3SP, NP22 3ST, NP22 4AJ, NP22 4AL, NP22 4EZ, NP22 4FB, NP22 4FJ, NP22 4HN, NP22 4XF",175,168,7
W00007265,NP2,"NP2 6BJ, NP2 6BL, NP24 6BB, NP24 6BD, NP24 6BG, NP24 6BQ, NP24 6BR",253,237,16
W00007700,NP2,"NP2 4PE, NP2 4PF, NP2 4PH, NP2 4PJ, NP22 4NX, NP22 4PE, NP22 4PF, NP22 4PH, NP22 4PJ",258,243,15
W00007702,NP2,"NP2 4AT, NP2 4AU, NP2 4AW, NP2 4AZ, NP2 4RP, NP2 4RW, NP22 4AT, NP22 4AU, NP22 4AW, NP22 4AZ, NP22 4RP, NP22 4RW",232,223,9
W00007739,NP2,"NP2 4AA, NP2 4AB, NP2 4BA, NP22 3EY, NP22 3HX, NP22 3HZ, NP22 4AB, NP22 4BA",262,249,13
W00007738,NP2,"NP2 3EU, NP2 3EZ, NP2 3HE, NP2 3HP, NP2 3RT, NP2 4AF, NP22 3EU, NP22 3EZ, NP22 3HE, NP22 3HP, NP22 4AF",370,333,37
W00007737,NP2,"NP2 3HH, NP2 3HL, NP2 3HN, NP2 3RU, NP22 3HD, NP22 3HH, NP22 3HJ, NP22 3HW",270,256,14
W00007736,NP2,"NP2 3EX, NP2 3RX, NP22 3BA, NP22 3HL, NP22 3HN, NP22 3JA, NP22 3RT, NP22 3RU, NP22 3RX, NP22 3SS",310,285,25
W00007735,NP2,"NP2 4JR, NP2 4JS, NP22 4HY, NP22 4HZ, NP22 4JP, NP22 4JR",242,230,12
W00007734,NP2,"NP2 3BQ, NP2 4BL, NP2 4BN, NP2 4BP, NP2 4BR, NP2 4BS, NP2 4BT, NP2 4BU, NP2 4BW, NP2 4HT, NP2 4HU, NP2 4HY, NP2 4HZ, NP2 4JA, NP2 4JB, NP2 4JP, NP2 5BQ, NP22 3BQ, NP22 4BH, NP22 4BL, NP22 4BN, NP22 4BP, NP22 4BR, NP22 4BS, NP22 4BT, NP22 4BW, NP22 5BQ",106,100,6
W00007733,NP2,"NP2 3NS, NP2 3NT, NP2 3PD, NP2 3PE, NP2 3PF, NP2 3TA, NP2 3TP, NP22 3PD, NP22 3PE, NP22 3TA, NP22 3TB, NP22 3TG",274,267,7
W00007732,NP2,"NP2 4HS, NP2 4HX, NP2 4JD, NP2 4JF, NP2 4XG, NP22 4HS, NP22 4HT, NP22 4HU",166,154,12
W00007731,NP2,"NP2 3BG, NP2 3BH, NP2 3NG, NP2 3NL, NP2 3NN, NP2 3PG, NP2 3PH, NP2 3PQ, NP2 4BH, NP22 3BH, NP22 3NL, NP22 3NN, NP22 3NP, NP22 3NR, NP22 3PG, NP22 3PH",252,234,18
W00007730,NP2,"NP2 3TD, NP2 3TE, NP2 3TF, NP2 3TL, NP22 3TD, NP22 3TE, NP22 3TF, NP22 3TJ, NP22 3TP",268,254,14
W00007729,NP2,"NP2 3NJ, NP2 3NU, NP2 3PB, NP22 3NS, NP22 3NT, NP22 3PB, NP22 3PF",212,200,12
W00007728,NP2,"NP2 3AZ, NP2 3JE, NP2 3JR, NP2 3JS, NP2 3LL, NP2 3NF, NP2 3NP, NP2 3NQ, NP2 3NR, NP2 3NW, NP2 3NX, NP2 3NY, NP2 3NZ, NP2 3PW, NP2 3PZ, NP2 3QB, NP2 3QW, NP2 3QX, NP2 3SF, NP2 3XP, NP2 4XE, NP22 3NG, NP22 3NW, NP22 3NX, NP22 3NY, NP22 3NZ, NP22 3PA, NP22 3PQ, NP22 3XP, NP22 4XE",261,233,28
W00007727,NP2,"NP2 3DF, NP2 3DG, NP2 3PA, NP2 3PU, NP2 3PX, NP2 3PY, NP2 3QA, NP2 3QG, NP2 3QH, NP22 3NJ, NP22 3NU, NP22 3PY, NP22 3PZ, NP22 3QA, NP22 3QB, NP22 3QX, NP22 3TL",301,277,24
W00007726,NP2,"NP2 3DE, NP2 3DQ, NP2 3JF, NP2 3JH, NP2 3JP, NP2 3JQ, NP2 3JU, NP2 3JW, NP2 3LN, NP2 3NA, NP2 3NB, NP2 3ND, NP2 3NE, NP2 3NH, NP2 3PR, NP2 3PS, NP2 3PT, NP2 3QD, NP2 3QE, NP2 3QF, NP2 3XA, NP2 3XB, NP2 3XD, NP2 3XL, NP2 3XN, NP2 3XR, NP2 3YA, NP2 3YD, NP2 3YF, NP2 3YL, NP2 3YQ, NP2 4HR, NP2 4LA, NP2 4LB, NP2 4XJ, NP22 3DE, NP22 3DF, NP22 3DG, NP22 3DQ, NP22 3JF, NP22 3JH, NP22 3LN, NP22 3LX, NP22 3NA, NP22 3NB, NP22 3ND, NP22 3NE, NP22 3NF, NP22 3NH, NP22 3PS, NP22 3PT, NP22 3PU, NP22 3QF, NP22 3TS, NP22 3WA, NP22 3WZ, NP22 3XA, NP22 3XN, NP22 3YE, NP22 3YF, NP22 3YG, NP22 3YH, NP22 3YL, NP22 3YY, NP22 4BG, NP22 4BU, NP22 4HR, NP22 4LB, NP22 4WR, NP22 4WU, NP22 4WW, NP22 4WX, NP22 4WY, NP22 4WZ, NP22 4YA, NP22 4YB, NP22 4YQ, NP22 5YA, NP22 5YH, NP22 9AA, NP22 9AD, NP22 9AE, NP22 9AF, NP22 9AG, NP22 9AH, NP22 9AJ, NP22 9AL, NP22 9AN, NP22 9AP, NP22 9AQ, NP24 6WY, NP24 6WZ, NP24 6XD, NP24 6YA, NP24 6YB, NP24 6YD, NP24 6YE, NP24 6YP",338,322,16
W00007725,NP2,"NP2 3EP, NP2 3EQ, NP2 3QZ, NP2 3RD, NP2 3RE, NP2 3RH, NP2 3YH, NP2 3YJ, NP22 3EP, NP22 3QT, NP22 3QY, NP22 3QZ, NP22 3RA, NP22 3RG, NP22 3RH, NP22 3RQ, NP22 3YB",269,255,14
W00007724,NP2,"NP2 3DB, NP2 3DU, NP2 3EA, NP2 4PY, NP22 3DA, NP22 3DB, NP22 3DD, NP22 3DU, NP22 3EA, NP22 3EL, NP22 3XH",164,163,1
W00007723,NP2,"NP2 3TB, NP2 3TG, NP2 3TH, NP2 3TJ, NP2 3TN, NP2 3TQ, NP2 3TW, NP22 3TH, NP22 3TN, NP22 3TQ, NP22 3TW",259,238,21
W00007722,NP2,"NP2 3ER, NP2 3ES, NP2 3HY, NP2 3QR, NP2 3RB, NP22 3ER, NP22 3QJ, NP22 3QN, NP22 3RB, NP22 3RD, NP22 3RE",261,243,18
W00007721,NP2,"NP2 3DH, NP2 3QL, NP2 3QN, NP22 3PW, NP22 3QP, NP22 3QR, NP22 3QS",125,117,8
W00007720,NP2,"NP2 3BJ, NP2 3BL, NP2 3DJ, NP2 3DL, NP2 3DN, NP2 3DW, NP2 3EJ, NP2 3QP, NP2 3QQ, NP2 3QS, NP2 3QT, NP2 3QU, NP2 3QY, NP2 3RA, NP2 3RQ, NP2 3XH, NP2 3XJ, NP2 3XS, NP2 3XT, NP2 3YB, NP2 3YE, NP2 3YG, NP2 4XQ, NP22 3BJ, NP22 3DH, NP22 3DJ, NP22 3DN, NP22 3DW, NP22 3EJ, NP22 3JE, NP22 3PL, NP22 3PX, NP22 3QD, NP22 3QE, NP22 3QG, NP22 3QH, NP22 3QL, NP22 3QQ, NP22 3QU, NP22 3QW, NP22 3RF, NP22 3RJ, NP22 3XJ, NP22 3XR, NP22 3XS, NP22 3YA, NP22 3YD, NP22 4LA",290,276,14
W00007719,NP2,"NP2 3HA, NP2 3HB, NP2 3HD, NP2 3HF, NP2 3HG, NP2 3HR, NP2 3HS, NP2 3HT, NP2 3HU, NP2 3HW, NP2 3RJ, NP2 3XE, NP2 3XU, NP22 3EX, NP22 3HA, NP22 3HB, NP22 3HF, NP22 3HG, NP22 3HQ, NP22 3HT",263,246,17
W00007709,NP2,"NP2 4NS, NP2 4NU, NP2 4QB, NP2 4QE, NP2 4QF, NP22 4NL, NP22 4NS, NP22 4NU, NP22 4PZ, NP22 4QB, NP22 4QE, NP22 4QF, NP22 4QX",378,339,39
W00007708,NP2,"NP2 4AX, NP2 4DN, NP2 4QG, NP2 4QJ, NP2 4QL, NP2 4QN, NP2 4QP, NP2 4QQ, NP2 4QR, NP2 4QS, NP2 4QT, NP2 4QU, NP2 4QW, NP2 4RE, NP2 4RF, NP2 4RG, NP2 4RJ, NP2 4RL, NP2 4RN, NP2 4RQ, NP22 4AX, NP22 4DN, NP22 4PY, NP22 4QG, NP22 4QJ, NP22 4QL, NP22 4QN, NP22 4QP, NP22 4QQ, NP22 4QR, NP22 4QS, NP22 4QT, NP22 4QU, NP22 4QW, NP22 4RE, NP22 4RF, NP22 4RG, NP22 4RJ, NP22 4RL, NP22 4RN, NP22 4RQ, NP22 4XL, NP3 3DE",248,226,22
W00007706,NP2,"NP2 4AD, NP2 4AE, NP2 4RR, NP22 4AA, NP22 4AD, NP22 4AE, NP22 4RR",248,215,33
W00007705,NP2,"NP2 4PP, NP2 4PQ, NP2 4PR, NP2 4PT, NP22 4PP, NP22 4PQ, NP22 4PR, NP22 4PT",264,252,12
W00007704,NP2,"NP2 4NY, NP2 4NZ, NP2 4PA, NP2 4PB, NP2 4PD, NP2 4PS, NP22 4NY, NP22 4NZ, NP22 4PA, NP22 4PB, NP22 4PD",197,181,16
W00007703,NP2,"NP2 4NR, NP2 4NT, NP2 4PX, NP2 4PZ, NP2 4QA, NP2 4QD, NP2 4QH, NP2 4XL, NP2 4XN, NP22 4NR, NP22 4NT, NP22 4PX, NP22 4QA, NP22 4QD, NP22 4QH",267,253,14
W00007701,NP2,"NP2 4AY, NP2 4DR, NP2 4DS, NP2 4DT, NP2 4DU, NP2 4DZ, NP2 4ED, NP2 4EG, NP2 4EH, NP2 4EJ, NP2 4QX, NP22 4AY, NP22 4BB, NP22 4DR, NP22 4DT, NP22 4DU, NP22 4DZ, NP22 4ED, NP22 4EG, NP22 4EH, NP22 4EJ",244,222,22
W00007468,NP2,"NP2 5BN, NP2 5DA, NP2 5DB, NP2 5DD, NP2 5DG, NP2 5DJ, NP2 5DS, NP2 5QS, NP22 5BX, NP22 5BY, NP22 5BZ, NP22 5DB, NP22 5DE, NP22 5DH, NP22 5DJ",306,292,14
W00007707,NP2,"NP2 4PG, NP22 4FG, NP22 4PG, NP22 4PL, NP22 4PS, NP22 4QY",227,213,14
W00008478,NP20,"NP20 3BZ, NP20 3DA, NP20 3DJ, NP9 3BZ, NP9 3YE, NPT 3BZ",294,264,30
W00008485,NP20,"NP20 3NB, NP20 3ND, NP20 3NH, NP20 3NJ, NP9 3NB, NP9 3ND, NP9 3NH, NP9 3NJ, NP9 3NL, NP9 3NN, NPT 3NB, NPT 3ND, NPT 3NH, NPT 3NJ, NPT 3NL, NPT 3NN",282,263,19
W00008484,NP20,"NP20 3ET, NP20 3GU, NP20 3GW, NP20 3GX, NP20 3NA, NP20 3NN, NP9 3EJ, NP9 3ET, NP9 3FQ, NP9 3GU, NP9 3GW, NP9 3NA, NPT 3EJ, NPT 3ET, NPT 3EU, NPT 3FQ, NPT 3GU, NPT 3GW, NPT 3NA",244,236,8
W00008483,NP20,"NP20 3DW, NP20 3DX, NP20 3DY, NP20 3DZ, NP20 3ED, NP20 3EN, NP20 3EP, NP20 3ER, NP20 3EU, NP20 3EX, NP20 3EY, NP20 4TG, NP9 3ED, NP9 3EU, NP9 4TG, NPT 3ED",249,238,11
W00008482,NP20,"NP20 3EJ, NP20 3EL, NP20 3FP, NP20 3FQ, NP20 3FZ, NP20 3HD, NP9 1AQ, NP9 1AR, NP9 3EL, NP9 3EN, NP9 3EP, NP9 3ER, NP9 3EW, NP9 3FP, NP9 3FZ, NP9 3HG, NPT 1AQ, NPT 3EL, NPT 3EN, NPT 3EP, NPT 3ER, NPT 3FP, NPT 3FZ, NPT 3HG",354,324,30
W00008481,NP20,"NP20 3EB, NP20 3EQ, NP20 3ES, NP20 3EW, NP20 4HF, NP20 4HP, NP9 3EB, NP9 3EQ, NP9 3ES, NP9 4HA, NP9 4HG, NP9 4HP, NP9 4HY, NPT 3EB, NPT 3EQ, NPT 3ES, NPT 4HA, NPT 4HF, NPT 4HG, NPT 4HP",313,290,23
W00008480,NP20,"NP20 3FT, NP20 4HD, NP20 4HE, NP20 4HN, NP20 4HQ, NP20 4HR, NP20 4HS, NP9 4HD, NP9 4HE, NP9 4HF, NP9 4HN, NP9 4HQ, NP9 4HR, NP9 4HS, NPT 4HB, NPT 4HD, NPT 4HE, NPT 4HN, NPT 4HQ, NPT 4HR",222,214,8
W00008479,NP20,"NP20 3BT, NP20 3BW, NP20 3BX, NP20 3DH, NP9 3BT, NP9 3BW, NP9 3BX, NP9 3DH, NPT 3BT, NPT 3BW, NPT 3BX, NPT 3DH",263,250,13
W00008411,NP20,"NP20 7AT, NP20 7DZ, NP20 7LQ, NP20 7TD, NP20 7TH, NP20 7TL, NP20 7TN, NP20 7TT, NP20 7YG, NP20 7YP, NP20 7YQ, NP20 7YW, NP9 6DW, NP9 6DX, NP9 6DZ, NP9 6EB, NP9 6EG, NP9 6TD, NP9 6TL, NP9 6TN, NPT 6DW, NPT 6DX, NPT 6DZ, NPT 6EB, NPT 6TN, NPT 6YG",258,235,23
W00008477,NP20,"NP20 3AS, NP20 3AU, NP20 3DL, NP20 3DP, NP9 3AJ, NP9 3DA, NP9 3DB, NP9 3DL, NP9 3DN, NP9 3DP, NPT 3AJ, NPT 3DA, NPT 3DB, NPT 3DL, NPT 3DN",271,249,22
W00008476,NP20,"NP20 3BD, NP20 3BY, NP20 3DF, NP20 3DG, NP9 3BS, NP9 3BU, NP9 3BY, NP9 3DG, NPT 3BU, NPT 3BY, NPT 3DG",415,370,45
W00008487,NP20,"NP20 3NE, NP20 3NF, NP20 3NG, NP20 3NP, NP20 3PZ, NP9 3NE, NP9 3NF, NP9 3NP, NP9 3PZ, NPT 3NE, NPT 3NF, NPT 3NP, NPT 3PZ",252,239,13
W00008475,NP20,"NP20 3BG, NP20 3BJ, NP20 3BS, NP20 3DQ, NP9 3BP",263,247,16
W00008329,NP20,"NP20 3EF, NP20 3EG, NP20 4HY, NP20 4HZ, NP20 4JG, NP9 3EE, NP9 3EF, NP9 3EG, NP9 3EH, NP9 4HZ, NP9 4JA, NP9 4JE, NP9 4JF, NP9 4JG, NP9 4JQ, NP9 4LP, NPT 3EE, NPT 3EG, NPT 3EH, NPT 4HY, NPT 4HZ, NPT 4JA, NPT 4JE, NPT 4JF, NPT 4JG, NPT 4LP",366,335,31
W00008330,NP20,"NP20 3EA, NP20 3EE, NP20 3EH, NP9 3EA, NP9 4HX, NP9 4JW, NP9 4JX, NP9 4JY, NPT 3EA, NPT 3EF, NPT 4HX, NPT 4JW, NPT 4JX, NPT 4JY",259,232,27
W00008331,NP20,"NP20 4HX, NP20 4JQ, NP20 4JW, NP20 4JX, NP20 4LN, NP9 4JU, NP9 5FP, NPT 4JH, NPT 4XA, NPT 5FP",225,206,19
W00008332,NP20,"NP20 3PR, NP20 3SE, NP20 3SF, NP20 5AF, NP20 5EL, NP20 5ES, NP9 3SF, NP9 5AF, NP9 5AG, NP9 5DN, NP9 5EL, NPT 5AF, NPT 5AG, NPT 5DN, NPT 5EL",280,261,19
W00008333,NP20,"NP20 4JA, NP20 4JB, NP20 4JE, NP20 4JF, NP20 4JH, NP20 5BL, NP9 4JD, NP9 4JH, NP9 4LQ, NP9 4LU, NPT 4JD, NPT 4LQ, NPT 4LR, NPT 4LU",273,239,34
W00008334,NP20,"NP20 4HG, NP20 4LB, NP20 4LD, NP9 4HJ, NP9 4JS, NP9 4JZ, NPT 4HJ, NPT 4JZ, NPT 4TG",184,178,6
W00008335,NP20,"NP20 3PP, NP20 3PQ, NP20 3QP, NP20 3QQ, NP20 3QR, NP20 3RG, NP20 3RH, NP20 3SA, NP20 3SD, NP20 3SG, NP9 3PP, NP9 3PQ, NP9 3PR, NP9 3QP, NP9 3QQ, NP9 3QR, NP9 3RH, NP9 3SA, NP9 4JB, NP9 5AA, NP9 5AE, NP9 5BL, NPT 3PP, NPT 3PQ, NPT 3PR, NPT 3QP, NPT 3QQ, NPT 3QR, NPT 3RH, NPT 3SA, NPT 3SD, NPT 4JB, NPT 5AA, NPT 5AE, NPT 5BL",295,274,21
W00008336,NP20,"NP20 4AF, NP20 4HA, NP20 4JT, NP20 4JU, NP20 4JY, NP20 4JZ, NP20 4LA, NP9 4LA, NP9 4LB, NP9 4LX, NPT 4LA, NPT 4LB",391,348,43
W00008337,NP20,"NP20 3PS, NP20 3PT, NP20 3SL, NP20 3SN, NP20 3SP, NP9 3PS, NP9 3PT, NP9 3SE, NP9 3SL, NP9 3SN, NP9 3SP, NPT 1WQ, NPT 3PS, NPT 3PT, NPT 3SE, NPT 3SF, NPT 3SL, NPT 3SN, NPT 3SP",303,268,35
W00008338,NP20,"NP20 3PY, NP20 3QS, NP20 3QT, NP20 3QU, NP20 3RD, NP20 3RF, NP9 3QS, NP9 3RG, NPT 3QS, NPT 3RG",299,266,33
W00008328,NP20,"NP20 5DP, NP20 5DR, NP20 5DS, NP9 5DT, NP9 5ER, NP9 5FW, NP9 5FX, NPT 5FW, NPT 5FX",263,249,14
W00008488,NP20,"NP20 3FR, NP20 3HE, NP20 3HF, NP20 3HG, NP20 3HH, NP20 3HJ, NP20 3HN, NP9 3FR, NP9 3HH, NP9 3HJ, NP9 3HL, NP9 3HN, NP9 3HW, NP9 3XA, NP9 3XD, NP9 3XE, NPT 3FR, NPT 3HH, NPT 3HJ, NPT 3HN, NPT 3HW",343,321,22
W00008489,NP20,"NP20 3FX, NP20 3GD, NP20 3GE, NP20 3GF, NP20 3HP, NP20 3HQ, NP9 1XF, NP9 3FW, NP9 3GF, NP9 3HE, NP9 3HP, NP9 3HQ, NPT 1XQ, NPT 3FW, NPT 3GF, NPT 3HE, NPT 3HL, NPT 3HP, NPT 3HQ",273,253,20
W00008490,NP20,"NP20 3NR, NP20 3NU, NP20 3NW, NP20 3NX, NP9 3NQ, NP9 3NR, NP9 3NT, NP9 3NU, NP9 3NX, NPT 3NQ, NPT 3NR, NPT 3NT, NPT 3NU, NPT 3NX",260,239,21
W00008726,NP20,"NP20 5PE, NP20 5PF, NP20 5PG, NP20 5PH, NP9 5PA, NP9 5PB, NP9 5PD, NP9 5PF, NP9 5PG, NP9 5PJ, NP9 5PL, NP9 5QZ, NP9 5RA, NP9 5RD, NPT 5PA, NPT 5PB, NPT 5PF, NPT 5PG, NPT 5PJ, NPT 5PL, NPT 5QZ, NPT 5RA, NPT 5RD, NPT 5YF",292,271,21
W00008727,NP20,"NP20 5JL, NP20 5JN, NP20 5LY, NP20 5NA, NP20 5NB, NP9 5NB, NP9 5ND, NP9 5NE, NP9 5XD, NPT 5NB, NPT 5ND, NPT 5NE, NPT 5YE, NPT 5YQ",261,242,19
W00008728,NP20,"NP20 5EZ, NP20 5FN, NP20 5FP, NP20 5FQ, NP20 5FR, NP20 5FS, NP9 5FJ, NP9 5FQ, NP9 5FR, NP9 5FS, NP9 5PE, NP9 5PH, NPT 5FJ, NPT 5FQ, NPT 5FR, NPT 5FS, NPT 5PD, NPT 5PE, NPT 5PH",288,249,39
W00008729,NP20,"NP20 5FT, NP20 5FU, NP20 5FW, NP20 5FX, NP20 5FY, NP20 5UP, NP20 5US, NP20 5YN, NP9 5FT, NP9 5FU, NP9 5FY, NP9 5UP, NP9 5UR, NP9 5US, NP9 5UT, NP9 5XF, NP9 5XY, NP9 5YB, NP9 5YD, NP9 5YE, NP9 5YF, NP9 5YJ, NP9 5YN, NP9 5YQ, NP9 5YR, NP9 5YT, NP9 5YY, NPT 5FT, NPT 5FU, NPT 5FY",256,226,30
W00008730,NP20,"NP20 5HN, NP20 5HP, NP20 5HQ, NP20 5HR, NP20 5HS, NP20 5HT, NP20 5JT, NP20 5YA, NP20 5YB, NP9 5HN, NP9 5HP, NP9 5HQ, NP9 5HR, NP9 5HS, NP9 5HT, NP9 5HW, NP9 5JG, NP9 5JT, NP9 5JW, NP9 5JX, NP9 5YA, NPT 5HN, NPT 5HP, NPT 5HQ, NPT 5HR, NPT 5HS, NPT 5HT, NPT 5HU, NPT 5HW, NPT 5HX, NPT 5JG, NPT 5JH, NPT 5JT, NPT 5JW, NPT 5JX, NPT 5YA",209,200,9
W00008731,NP20,"NP20 1JS, NP20 4DW, NP20 4DY, NP20 4EA, NP20 4ED, NP20 4EE, NP20 4EU, NP20 4EW, NP20 4EX, NP20 4SY, NP9 1JT, NP9 1JU, NP9 1UJ, NP9 4DR, NP9 4DW, NP9 4DX, NP9 4DY, NP9 4EU, NP9 4EW, NP9 4EX, NP9 4GJ, NP9 4SY, NP9 4XF, NP9 4XL, NP9 4XN, NP9 4XP, NP9 4XQ, NP9 4XR, NP9 4XU, NPT 1JT, NPT 1JU, NPT 1UJ, NPT 4DW, NPT 4DY, NPT 4EA, NPT 4EW, NPT 4EX, NPT 4GJ, NPT 4XG",379,368,11
W00008732,NP20,"NP20 1AA, NP20 1AB, NP20 1AD, NP20 1AZ, NP20 1DA, NP20 1DB, NP20 1DD, NP20 1DF, NP20 1DG, NP20 1FB, NP20 1FD, NP20 1FN, NP20 1FP, NP20 1FQ, NP20 1FR, NP20 1FS, NP20 1FU, NP20 1FW, NP20 1FX, NP20 1FY, NP20 1FZ, NP20 1GA, NP20 1GB, NP20 1GD, NP20 1GE, NP20 1GF, NP20 1GG, NP20 1GH, NP20 1GL, NP20 1GN, NP20 1GP, NP20 1GX, NP20 1GY, NP20 1HA, NP20 1JA, NP20 1JB, NP20 1JZ, NP20 1LA, NP20 1LB, NP20 1LD, NP20 1QU, NP20 1RE, NP20 1RG, NP20 1RN, NP20 1RU, NP20 1YN, NP20 4AA, NP20 4AB, NP20 4AH, NP20 4AL, NP20 4AW, NP20 4AX, NP20 4BP, NP20 4DD, NP20 4DH, NP20 4DJ, NP20 4DL, NP20 4NN, NP20 4NP, NP20 4RA, NP20 4UT, NP20 4WR, NP20 5GZ, NP9 1AA, NP9 1AB, NP9 1AL, NP9 1AW, NP9 1BZ, NP9 1DA, NP9 1DB, NP9 1DD, NP9 1DE, NP9 1DF, NP9 1DG, NP9 1DR, NP9 1FL, NP9 1FQ, NP9 1FR, NP9 1FS, NP9 1FT, NP9 1FU, NP9 1FW, NP9 1FX, NP9 1FY, NP9 1FZ, NP9 1GA, NP9 1GB, NP9 1GE, NP9 1GH, NP9 1GL, NP9 1GN, NP9 1GX, NP9 1HX, NP9 1JF, NP9 1JY, NP9 1JZ, NP9 1LA, NP9 1LB, NP9 1PF, NP9 1QU, NP9 1QZ, NP9 1RE, NP9 1RF, NP9 1RG, NP9 1RN, NP9 1RS, NP9 1RT, NP9 1RU, NP9 1RY, NP9 1TA, NP9 1TE, NP9 1WD, NP9 1WE, NP9 1WG, NP9 1WH, NP9 1WJ, NP9 1WL, NP9 1WN, NP9 1WQ, NP9 4AA, NP9 4AS, NP9 4AY, NP9 4BF, NP9 4BJ, NP9 4NP, NP9 4NU, NP9 4NW, NP9 4RA, NP9 4RB, NP9 4ST, NP9 4TN, NP9 4TX, NP9 4UJ, NP9 5HA, NP9 5XG, NP9 5XH, NP9 5XR, NP9 7YF, NP9 7YY, NPT 1AA, NPT 1AB, NPT 1AW, NPT 1AZ, NPT 1BZ, NPT 1DA, NPT 1DB, NPT 1DD, NPT 1DE, NPT 1DF, NPT 1DR, NPT 1FL, NPT 1FQ, NPT 1FS, NPT 1FT, NPT 1FU, NPT 1FW, NPT 1FX, NPT 1FZ, NPT 1GA, NPT 1GB, NPT 1GE, NPT 1GH, NPT 1GL, NPT 1GN, NPT 1JF, NPT 1JX, NPT 1JY, NPT 1JZ, NPT 1LB, NPT 1NA, NPT 1PF, NPT 1QU, NPT 1QZ, NPT 1RE, NPT 1RG, NPT 1RN, NPT 1RS, NPT 1RT, NPT 1RU, NPT 1TE, NPT 1WJ, NPT 1WL, NPT 1WN, NPT 1WP, NPT 1WR, NPT 1WS, NPT 1YN, NPT 1YP, NPT 4AA, NPT 4AS, NPT 4AY, NPT 4BQ, NPT 4NU, NPT 4NW, NPT 4RA, NPT 4ST, NPT 4TN, NPT 5HA, NPT 5XG, NPT 5XH, NPT 7YY, NPT 8YG, NPT 8YH, NPT 8YS",412,389,23
W00008734,NP20,"NP20 4BQ, NP20 4BW, NP20 4BX, NP20 4DN, NP20 4GF, NP20 4HL, NP20 4SE, NP9 4BW, NP9 4BY, NP9 4BZ, NP9 4DN, NPT 4BW, NPT 4BX, NPT 4BY, NPT 4BZ, NPT 4DN",184,170,14
W00008735,NP20,"NP20 4DA, NP20 4DB, NP20 4DE, NP20 4DF, NP9 4BN, NP9 4BP, NP9 4DA, NP9 4DB, NP9 4DD, NP9 4DE, NP9 4SB, NPT 4BN, NPT 4BP, NPT 4DA, NPT 4DB, NPT 4DD, NPT 4DE, NPT 4DJ, NPT 4DL, NPT 4SB",271,258,13
W00008736,NP20,"NP20 1TE, NP20 1UA, NP20 1YH, NP20 4AD, NP20 4AE, NP20 4AG, NP20 4AN, NP20 4AP, NP20 4AQ, NP20 4AT, NP20 4AU, NP20 4BG, NP20 4BH, NP20 4BL, NP20 4BN, NP20 4BR, NP20 4BS, NP20 4BT, NP20 4BU, NP20 4BY, NP20 4BZ, NP20 4GE, NP20 4NY, NP20 4RN, NP20 4RU, NP20 4SB, NP20 4SF, NP20 4SJ, NP20 4SR, NP20 4YS, NP20 4YX, NP9 1AZ, NP9 1GD, NP9 1TG, NP9 1TH, NP9 1TZ, NP9 1UA, NP9 4AB, NP9 4AD, NP9 4AE, NP9 4AF, NP9 4AG, NP9 4AH, NP9 4AJ, NP9 4AL, NP9 4AN, NP9 4AP, NP9 4AQ, NP9 4AR, NP9 4AT, NP9 4AU, NP9 4AW, NP9 4AX, NP9 4BD, NP9 4BG, NP9 4BH, NP9 4BL, NP9 4BQ, NP9 4BR, NP9 4BS, NP9 4BT, NP9 4BU, NP9 4BX, NP9 4GE, NP9 4NY, NP9 4NZ, NP9 4RL, NP9 4RN, NP9 4RP, NP9 4RQ, NP9 4RU, NP9 4RW, NP9 4RX, NP9 4RY, NP9 4SD, NP9 4SF, NP9 4SH, NP9 4SJ, NP9 4SN, NP9 4SP, NP9 4SR, NP9 4SW, NP9 4UY, NP9 4YN, NP9 4YX, NP9 4YY, NP9 4YZ, NP9 4ZA, NP9 4ZB, NP9 4ZZ, NPT 1GD, NPT 1TG, NPT 1TZ, NPT 1UA, NPT 4AB, NPT 4AD, NPT 4AE, NPT 4AF, NPT 4AG, NPT 4AH, NPT 4AJ, NPT 4AL, NPT 4AN, NPT 4AP, NPT 4AQ, NPT 4AR, NPT 4AT, NPT 4AU, NPT 4AW, NPT 4AX, NPT 4BG, NPT 4BH, NPT 4BJ, NPT 4BL, NPT 4BR, NPT 4BS, NPT 4BT, NPT 4BU, NPT 4GE, NPT 4NY, NPT 4NZ, NPT 4RL, NPT 4RN, NPT 4RP, NPT 4RQ, NPT 4RU, NPT 4RW, NPT 4RX, NPT 4RY, NPT 4SD, NPT 4SF, NPT 4SH, NPT 4SJ, NPT 4SN, NPT 4SP, NPT 4SR, NPT 4SW, NPT 4UY, NPT 4XB, NPT 4XF, NPT 4YX",277,253,24
W00008737,NP20,"NP20 4FX, NP20 4FY, NP20 4HB, NP20 4HH, NP20 4RB, NP20 4XL, NP20 4YE, NP20 4YL, NP20 4YP, NP20 4ZB, NP9 4FX, NP9 4GD, NP9 4GF, NP9 4HH, NP9 4RR, NP9 4TA, NP9 4XS, NP9 4XT, NP9 4XW, NP9 4XZ, NP9 4YA, NP9 4YB, NP9 4YD, NP9 4YE, NP9 4YG, NP9 4YP, NP9 4YR, NP9 4YU, NP9 4YW, NPT 4FX, NPT 4GD, NPT 4GF, NPT 4HH, NPT 4RR, NPT 4TA",311,280,31
W00008738,NP20,"NP20 4GG, NP20 4GH, NP20 4GN, NP9 4GG, NP9 4GN, NPT 4GG, NPT 4GN",271,239,32
W00008739,NP20,"NP20 1HX, NP20 1JY, NP20 4DG, NP20 4DP, NP20 4GJ, NP20 4GL, NP9 4DF, NP9 4DG, NP9 4DH, NP9 4DJ, NP9 4DL, NP9 4DP, NP9 4SX, NPT 1HX, NPT 4DF, NPT 4DG, NPT 4DH",229,216,13
W00008740,NP20,"NP20 4GA, NP20 4GB, NP20 4GD, NP20 4GP, NP20 4GQ, NP20 4TA, NP9 4GB, NP9 4GH, NP9 4GL, NP9 4GP, NP9 4GQ, NPT 4GB, NPT 4GH, NPT 4GL, NPT 4GP, NPT 4GQ",299,276,23
W00008741,NP20,"NP20 1EE, NP20 1EF, NP20 1EG, NP20 1EH, NP20 1EJ, NP20 1EL, NP20 1EN, NP20 1EP, NP20 1ET, NP20 1EW, NP20 1EY, NP20 1EZ, NP20 1HG, NP20 1LR, NP20 1LS, NP20 1LU, NP20 1NA, NP20 1UH, NP20 1WP, NP20 2AB, NP20 2AE, NP20 2AL, NP20 2BP, NP20 2ED, NP20 2FE, NP20 2PA, NP20 2TA, NP9 0US, NP9 1EE, NP9 1EF, NP9 1EH, NP9 1EJ, NP9 1EL, NP9 1EN, NP9 1EP, NP9 1EQ, NP9 1ES, NP9 1ET, NP9 1EU, NP9 1EX, NP9 1EY, NP9 1EZ, NP9 1HY, NP9 1LS, NP9 1LT, NP9 1LU, NP9 1PP, NP9 1PY, NP9 1QA, NP9 1QJ, NP9 1QN, NP9 1QP, NP9 1QS, NP9 1WP, NP9 1WR, NP9 1WS, NP9 1XZ, NP9 2AB, NP9 2AD, NP9 2AE, NP9 2AL, NP9 2PA, NP9 2TA, NP9 2WW, NP9 2XX, NPT 0US, NPT 1EB, NPT 1ED, NPT 1EE, NPT 1EF, NPT 1EH, NPT 1EJ, NPT 1EL, NPT 1EN, NPT 1EP, NPT 1EQ, NPT 1ES, NPT 1ET, NPT 1EU, NPT 1EW, NPT 1EX, NPT 1EY, NPT 1HY, NPT 1LS, NPT 1LT, NPT 1LU, NPT 1PP, NPT 1PY, NPT 1QA, NPT 1QJ, NPT 1QN, NPT 1QP, NPT 1QS, NPT 1WF, NPT 1WG, NPT 1XN, NPT 1XR, NPT 1XS, NPT 1XZ, NPT 1YA, NPT 1YT, NPT 2AB, NPT 2AD, NPT 2AE, NPT 2AL, NPT 2PA, NPT 2TA, NPT 2WW, NPT 2XX",369,359,10
W00008742,NP20,"NP20 1LL, NP20 1LT, NP20 1LW, NP20 2EA, NP20 2EB, NP20 2EZ, NP20 4DT, NP20 4DU, NP20 4EH, NP20 4EJ, NP20 4EL, NP9 1EA, NP9 1LW, NP9 1LX, NP9 1NA, NP9 1NB, NP9 2EA, NP9 2EZ, NP9 2FE, NP9 4DU, NP9 4DZ, NP9 4EJ, NP9 4EL, NP9 4EQ, NPT 1EA, NPT 1LW, NPT 1LX, NPT 1NB, NPT 2EA, NPT 2EZ, NPT 2FE, NPT 4DZ, NPT 4EJ, NPT 4EL, NPT 4EQ",517,496,21
W00008743,NP20,"NP20 4BD, NP20 4FA, NP20 4FG, NP20 4FH, NP20 4FJ, NP20 4FL, NP20 4FN, NP20 4FT, NP20 4FW, NP20 4FZ, NP20 4SZ, NP9 4FJ, NP9 4FL, NP9 4FY, NP9 4FZ, NP9 4HB, NP9 4SZ, NPT 4FJ, NPT 4FL, NPT 4FY, NPT 4FZ, NPT 4SZ",262,241,21
W00008744,NP20,"NP20 2NG, NP20 2UB, NP20 2YP, NP20 4EB, NP20 4EF, NP20 4EG, NP20 4ER, NP20 4ES, NP20 4ET, NP20 4EY, NP20 4EZ, NP9 2EE, NP9 2EF, NP9 2EG, NP9 2FD, NP9 2FF, NP9 2TY, NP9 2TZ, NP9 2UA, NP9 2UB, NP9 2UE, NP9 2XY, NP9 2YA, NP9 2YD, NP9 2YE, NP9 2YG, NP9 2YJ, NP9 2YL, NP9 2YP, NP9 2YQ, NP9 2YR, NP9 2YT, NP9 2YU, NP9 2YW, NP9 4EA, NP9 4EB, NP9 4ED, NP9 4EE, NP9 4EF, NP9 4EG, NP9 4EH, NP9 4ER, NP9 4ES, NP9 4ET, NP9 4EY, NP9 4EZ, NP9 4GA, NPT 2EE, NPT 2EF, NPT 2EG, NPT 2FD, NPT 2TY, NPT 2TZ, NPT 2UA, NPT 2UB, NPT 2XY, NPT 4EB, NPT 4ED, NPT 4EE, NPT 4EF, NPT 4EG, NPT 4EH, NPT 4ER, NPT 4ET, NPT 4EU, NPT 4EY, NPT 4EZ, NPT 4GA, NPT 4SY",310,291,19
W00008745,NP20,"NP20 2EE, NP20 2EF, NP20 2EG, NP20 2FD, NP20 2FF, NP20 2TZ, NP20 2UA, NP9 2EB, NP9 2ED, NPT 2EB, NPT 2ED",235,225,10
W00008746,NP20,"NP20 3AA, NP20 3AZ, NP20 4FB, NP20 4FD, NP20 4FE, NP20 4FF, NP20 4FP, NP9 4FA, NP9 4FB, NP9 4FD, NP9 4FE, NP9 4FF, NP9 4FG, NP9 4FH, NP9 4FN, NP9 4FP, NP9 4FT, NPT 4FA, NPT 4FB, NPT 4FD, NPT 4FE, NPT 4FF, NPT 4FG, NPT 4FH, NPT 4FN, NPT 4FP, NPT 4FT",384,342,42
W00009860,NP20,"NP20 2BQ, NP20 2BY, NP20 2BZ, NP20 2DG, NP20 2DH, NP20 2DJ, NP20 2DN, NP20 2TW, NP9 2DH, NP9 2DJ, NP9 2DN, NP9 2UT, NPT 2DH, NPT 2DJ, NPT 2DN, NPT 2UT",297,283,14
W00008492,NP20,"NP20 3GT, NP20 3GY, NP20 3HX, NP20 3HY, NP20 3HZ, NP9 3GT, NP9 3GY, NP9 3HY, NP9 3HZ",163,163,0
W00008491,NP20,"NP20 3AB, NP20 3AD, NP20 3AE, NP20 3BA, NP20 3FY, NP20 3GB, NP9 1QW, NP9 1XQ, NP9 3AB, NP9 3AD, NP9 3AE, NP9 3FX, NP9 3FY, NP9 3GB, NP9 3GD, NP9 3GE, NP9 3XF, NPT 1QW, NPT 3AB, NPT 3AD, NPT 3AE, NPT 3FX, NPT 3FY, NPT 3GB, NPT 3GD, NPT 3GE, NPT 3XU",310,289,21
W00008339,NP20,"NP20 3PX, NP20 3QW, NP20 3QX, NP20 3QY, NP20 3QZ, NP20 3RA, NP20 3RB, NP20 3RE, NP9 3PY, NP9 3QT, NP9 3QU, NP9 3QW, NP9 3QX, NP9 3QY, NP9 3QZ, NP9 3RA, NP9 3RB, NP9 3RD, NP9 3RE, NP9 3RF, NPT 3PY, NPT 3QT, NPT 3QU, NPT 3QW, NPT 3QX, NPT 3QY, NPT 3QZ, NPT 3RA, NPT 3RB, NPT 3RD, NPT 3RE, NPT 3RF",277,259,18
W00008340,NP20,"NP20 5EN, NP20 5EP, NP20 5EQ, NP20 5ER, NP20 5FZ, NP20 5GG, NP20 5XE, NP20 5XF, NP9 5EN, NP9 5EP, NP9 5EQ, NP9 5FZ, NP9 5GB, NP9 5GD, NP9 5GG, NP9 5GH, NP9 5GJ, NP9 5GL, NP9 5GN, NP9 5XE, NPT 5EN, NPT 5EP, NPT 5EQ, NPT 5ER, NPT 5FZ, NPT 5GD, NPT 5GG, NPT 5XE",398,361,37
W00008341,NP20,"NP20 5FF, NP20 5FG, NP20 5GJ, NP20 5YL, NP9 5FG, NP9 5FH, NPT 5FG, NPT 5FH",276,249,27
W00008342,NP20,"NP20 5EH, NP20 5GA, NP20 5GB, NP20 5GD, NP20 5GE, NP20 5GF, NP9 5EJ, NP9 5GA, NP9 5GE, NP9 5GF, NP9 5XJ, NPT 5EJ, NPT 5GA, NPT 5GE, NPT 5GF, NPT 5XJ",271,264,7
W00008434,NP20,"NP20 7DB, NP20 7DD, NP20 7DF, NP20 7DG, NP20 7DP, NP20 7EQ, NP20 7LP, NP9 6DD, NP9 6DF, NP9 6DG, NP9 6DP, NP9 6LY, NP9 6YA, NPT 6DD, NPT 6DF, NPT 6DG, NPT 6DP, NPT 6LX, NPT 6LY, NPT 6YA",297,279,18
W00008433,NP20,"NP20 7AU, NP20 7AW, NP20 7AX, NP20 7AY, NP20 7EP, NP20 7ST, NP9 6AQ, NP9 6AT, NP9 6AU, NP9 6AW, NP9 6AX, NP9 6AY, NPT 6AQ, NPT 6AT, NPT 6AU, NPT 6AW, NPT 6AX, NPT 6AY",501,451,50
W00008432,NP20,"NP20 7AP, NP20 7BH, NP20 7TB, NP20 7XS, NP20 7XX, NP20 7XY, NP20 7XZ, NP9 6BN, NP9 6XB, NP9 6XD, NP9 6XX, NP9 6XY, NP9 6XZ, NPT 6BN, NPT 6XB, NPT 6XD, NPT 6XX, NPT 6XY, NPT 6XZ",277,259,18
W00008431,NP20,"NP20 7DJ, NP20 7DL, NP20 7DW, NP20 7DX, NP20 7EL, NP20 7EN, NP9 6EE, NP9 6EF, NP9 6EH, NP9 6EL, NP9 6GA, NPT 6EE, NPT 6EF, NPT 6EH, NPT 6EL",296,279,17
W00008430,NP20,"NP20 7DN, NP20 7DQ, NP20 7RB, NP20 7UH, NP9 6DQ, NP9 6RA, NP9 6RB, NP9 6UH, NPT 6DQ",296,270,26
W00008429,NP20,"NP20 7XP, NP20 7XQ, NP20 7XR, NP20 7XT, NP20 7XW, NP9 6XR, NP9 6XS, NP9 6XT, NP9 6XU, NPT 6XR, NPT 6XS, NPT 6XT, NPT 6XU",267,256,11
W00008428,NP20,"NP20 7AF, NP20 7AG, NP20 7AJ, NP20 7AL, NP20 7AQ, NP20 7AR, NP9 6AF, NP9 6AG, NP9 6AH, NP9 6AJ, NP9 6AL, NP9 6AN, NP9 6AR, NPT 6AF, NPT 6AG, NPT 6AH, NPT 6AJ, NPT 6AL, NPT 6AN, NPT 6AR, NPT 6GA",291,270,21
W00008427,NP20,"NP20 7AN, NP20 7EE, NP20 7EF, NP20 7EH, NP20 7EJ, NP20 7GA, NP9 6EJ, NP9 6UJ, NP9 6UX, NP9 6UY, NPT 6EJ, NPT 6UJ",252,243,9
W00008426,NP20,"NP20 7AA, NP20 7AH, NP20 7BN, NP20 7XA, NP20 7XB, NP20 7XD, NP9 6XA, NP9 6XE, NPT 6XA, NPT 6XE",272,255,17
W00008425,NP20,"NP20 7XE, NP20 7XF, NP20 7XG, NP20 7XU, NP9 6XF, NP9 6XG, NPT 6XF, NPT 6XG",290,272,18
W00008424,NP20,"NP20 7RT, NP20 7RU, NP20 7RW, NP20 7RX, NP20 7RY, NP20 7UG, NP9 6RP, NP9 6RT, NP9 6RU, NP9 6UA, NP9 6UB, NP9 6UE, NP9 6UF, NP9 6UG, NPT 6RP, NPT 6RT, NPT 6RU, NPT 6UA, NPT 6UB, NPT 6UE, NPT 6UF, NPT 6UG",358,330,28
W00008423,NP20,"NP20 7TW, NP20 7TZ, NP20 7UA, NP20 7UB, NP20 7UF, NP20 7UP, NP9 6SQ, NP9 6TW, NP9 6TX, NP9 6TY, NP9 6TZ, NPT 6SQ, NPT 6TL, NPT 6TU, NPT 6TW, NPT 6TX, NPT 6TY, NPT 6TZ",227,211,16
W00008422,NP20,"NP20 7BX, NP20 7RP, NP20 7RQ, NP20 7RR, NP20 7RS, NP9 6BT, NP9 6BW, NP9 6BX, NP9 6TP, NP9 6UD, NP9 6YN, NP9 6YR, NP9 6YS, NP9 6YT, NP9 6YU, NPT 6BT, NPT 6BW, NPT 6BX, NPT 6TP, NPT 6UD",284,251,33
W00008421,NP20,"NP20 7LA, NP20 7SB, NP20 7SL, NP20 7SN, NP20 7SP, NP9 6SB, NPT 6SB",217,208,9
W00008420,NP20,"NP20 7BP, NP20 7BQ, NP20 7BR, NP20 7BS, NP20 7BT, NP20 7BU, NP9 6BP, NP9 6BR, NP9 6BU, NP9 6BZ, NP9 6DA, NP9 6DB, NPT 6BP, NPT 6BR, NPT 6BU, NPT 6BZ, NPT 6DA, NPT 6DB",301,293,8
W00008419,NP20,"NP20 7BY, NP20 7TQ, NP20 7TR, NP20 7UD, NP20 7UL, NP9 6BY, NP9 6ED, NP9 6TQ, NP9 6TR, NPT 6BY, NPT 6ED, NPT 6TQ, NPT 6TR",208,199,9
W00008418,NP20,"NP20 7BW, NP20 7BZ, NP20 7DA, NP20 7DE, NP20 7TP, NP9 6DE, NP9 6RD, NPT 6DE",248,227,21
W00008417,NP20,"NP20 7SU, NP20 7SY, NP20 7XJ, NP20 7XL, NP20 7XN, NP9 6SW, NP9 6SZ, NP9 6XP, NP9 6XQ, NP9 6XW, NPT 6SW, NPT 6SZ, NPT 6XP, NPT 6XQ, NPT 6XW",236,220,16
W00008416,NP20,"NP20 7SF, NP20 7SG, NP20 7SQ, NP20 7SR, NP20 7SS, NP20 7SX, NP9 6BD, NP9 6SN, NP9 6SP, NP9 6ST, NPT 6SN, NPT 6SP, NPT 6ST",239,230,9
W00008415,NP20,"NP20 7AB, NP20 7AZ, NP20 7DR, NP20 7DS, NP20 7DT, NP20 7DU, NP20 7LX, NP20 7LY, NP20 7YA, NP9 6AZ, NP9 6DR, NP9 6DS, NP9 6DT, NP9 6DU, NP9 6EU, NP9 6FU, NP9 6GB, NP9 6LX, NP9 6LZ, NP9 6YF, NP9 6YJ, NP9 6YL, NP9 6YX, NPT 6DR, NPT 6DS, NPT 6DT, NPT 6DU, NPT 6EU, NPT 6FU, NPT 6LZ, NPT 6QA, NPT 6QB, NPT 6YF, NPT 6YH",242,225,17
W00008414,NP20,"NP20 7AS, NP20 7BB, NP20 7BD, NP20 7BE, NP20 7BJ, NP20 7BL, NP9 6AS, NP9 6BL, NPT 6AS, NPT 6BL",307,286,21
W00008413,NP20,"NP20 7TS, NP20 7TU, NP20 7TX, NP20 7TY, NP20 7UE, NP20 7UN, NP9 6TS, NP9 6TT, NP9 6TU, NPT 6TS, NPT 6TT",190,181,9
W00008412,NP20,"NP20 7DH, NP20 7DY, NP20 7EA, NP20 7EB, NP20 7ED, NP20 7EG, NP20 7LN, NP9 6DH, NP9 6DJ, NP9 6DL, NP9 6DN, NP9 6DY, NP9 6EA, NP9 6EN, NPT 6DH, NPT 6DJ, NPT 6DL, NPT 6DN, NPT 6DY, NPT 6EA, NPT 6EG, NPT 6EN, NPT 6UH",267,260,7
W00008435,NP20,"NP20 7BA, NP20 7BG, NP20 7SW, NP20 7SZ, NP20 7TA, NP9 6AP, NP9 6BE, NP9 6BG, NP9 6BH, NP9 6BJ, NP9 6TA, NP9 6TB, NPT 6AP, NPT 6BD, NPT 6BE, NPT 6BG, NPT 6BH, NPT 6BJ, NPT 6TA, NPT 6TB",249,234,15
W00008725,NP20,"NP20 5AX, NP20 5JJ, NP20 5JZ, NP20 5NE, NP20 5NF, NP20 5NG, NP20 5NJ, NP20 5NQ, NP20 5RR, NP9 1PS, NP9 1RR, NP9 5JP, NP9 5LB, NP9 5NF, NP9 5NH, NP9 5NJ, NP9 5NQ, NP9 5NR, NP9 5PT, NP9 5XX, NPT 0XW, NPT 1PS, NPT 1RR, NPT 5JP, NPT 5LB, NPT 5NF, NPT 5NG, NPT 5NH, NPT 5NJ, NPT 5XX, NPT 5YB",278,241,37
W00008463,NP20,"NP20 3AQ, NP20 3AR, NP20 3JD, NP20 3JE, NP20 3LJ, NP20 3LR, NP20 3NS, NP9 3AP, NP9 3AR, NP9 3JB, NP9 3JD, NP9 3JE, NP9 3JJ, NP9 3LB, NP9 3LG, NP9 3LH, NP9 3LJ, NP9 3NG, NP9 3NS, NP9 3NW, NPT 3AP, NPT 3AR, NPT 3JB, NPT 3JD, NPT 3JE, NPT 3JJ, NPT 3LB, NPT 3LG, NPT 3LH, NPT 3LJ, NPT 3NG, NPT 3NS, NPT 3NW",360,347,13
W00008465,NP20,"NP20 3HW, NP20 3NL, NP20 3NQ, NP20 3NT, NP20 3YJ, NP9 3JA, NP9 3XX, NP9 3XY, NP9 3YJ, NPT 3JA, NPT 3XY",255,244,11
W00008343,NP20,"NP20 5DN, NP20 5DX, NP20 5EF, NP20 5EG, NP20 5ET, NP9 5EF, NP9 5EG, NP9 5EH, NP9 5XB, NPT 5EF, NPT 5EH, NPT 5GB, NPT 5XB",310,283,27
W00008344,NP20,"NP20 5HD, NP20 5HF, NP20 5HG, NP20 5HH, NP9 5FF, NP9 5HG, NPT 5FF, NPT 5HF, NPT 5HG, NPT 5XN",303,267,36
W00008346,NP20,"NP20 5DB, NP20 5DD, NP20 5EB, NP20 5ED, NP20 5EE, NP20 5EU, NP20 5EW, NP20 5EX, NP9 5DB, NP9 5EB, NP9 5ED, NP9 5EE, NPT 5DB, NPT 5EB, NPT 5ED, NPT 5EE",485,430,55
W00008347,NP20,"NP20 5DQ, NP20 5DT, NP20 5DU, NP20 5EA, NP20 5HE, NP9 5DP, NP9 5DR, NP9 5DS, NP9 5EA, NPT 5EA",264,236,28
W00008348,NP20,"NP20 4NL, NP20 5BD, NP20 5BE, NP20 5BG, NP20 5BH, NP20 5BQ, NP20 5BR, NP20 5BS, NP20 5BT, NP20 5BX, NP20 5BY, NP20 5BZ, NP9 4NL, NP9 5BB, NP9 5BD, NP9 5BE, NP9 5BS, NP9 5BT, NP9 5BU, NP9 5XA, NPT 5BB, NPT 5BD, NPT 5BE, NPT 5BT, NPT 5XA",380,350,30
W00008349,NP20,"NP20 4LY, NP20 4LZ, NP20 4NA, NP20 4NT, NP20 4NU, NP20 4NW, NP20 4PE, NP20 4PF, NP20 4PG, NP20 4PH, NP20 4PJ, NP20 4PL, NP20 4PQ, NP20 4PR, NP20 4TX, NP20 4UB, NP20 4UG, NP20 4UJ, NP20 4UL, NP20 4UR, NP20 4ZF, NP20 5DZ, NP20 5HB, NP20 5HZ, NP20 5WJ, NP20 5WS, NP20 5XH, NP20 5XQ, NP20 9GN, NP20 9SA, NP20 9SB, NP20 9ZZ, NP9 4LY, NP9 4LZ, NP9 4NB, NP9 4NS, NP9 4NT, NP9 4PE, NP9 4PF, NP9 4PG, NP9 4PJ, NP9 4PL, NP9 4PN, NP9 4TB, NP9 4TE, NP9 4TR, NP9 4TY, NP9 4TZ, NP9 4UA, NP9 4UB, NP9 4UF, NP9 4UG, NP9 4UH, NP9 4UL, NP9 4UN, NP9 4UP, NP9 4UQ, NP9 4UU, NP9 4XE, NP9 4YJ, NP9 4YL, NP9 4YT, NP9 5FD, NP9 5HB, NP9 5HD, NP9 5HE, NP9 5HL, NP9 5XN, NP9 5XQ, NP9 8WJ, NPT 1TA, NPT 4LY, NPT 4LZ, NPT 4NA, NPT 4NB, NPT 4NL, NPT 4NS, NPT 4NT, NPT 4PE, NPT 4PF, NPT 4PG, NPT 4PJ, NPT 4PL, NPT 4TB, NPT 4TR, NPT 4TT, NPT 4TX, NPT 4TY, NPT 4TZ, NPT 4UA, NPT 4UB, NPT 4UF, NPT 4UG, NPT 4UJ, NPT 4UL, NPT 4UN, NPT 4UP, NPT 4UQ, NPT 4UU, NPT 4XD, NPT 4XE, NPT 4XL, NPT 4YT, NPT 4YU, NPT 4YW, NPT 5FD, NPT 5HB, NPT 5HD, NPT 5HE, NPT 5HL, NPT 5XQ, NPT 5YN, NPT 8WJ",455,428,27
W00008350,NP20,"NP20 4NB, NP20 4ND, NP20 4NE, NP20 5BA, NP20 5BB, NP20 5BN, NP20 5BP, NP20 5BW, NP20 5DA, NP9 4NA, NP9 4ND, NP9 4PH, NP9 4UD, NP9 4UR, NP9 4UW, NP9 4XA, NP9 4XB, NP9 4XD, NP9 5BA, NP9 5BN, NP9 5BP, NP9 5DA, NP9 5DU, NP9 5DX, NPT 4ND, NPT 4PH, NPT 4TE, NPT 4UD, NPT 4UR, NPT 4UW, NPT 5BA, NPT 5BN, NPT 5BP, NPT 5DA",364,302,62
W00008351,NP20,"NP20 5AS, NP20 5AT, NP20 5AU, NP20 5AW, NP20 5AY, NP20 5AZ, NP20 5DE, NP20 5DF, NP20 5DG, NP20 5DH, NP20 5DJ, NP20 5DL, NP20 5DW, NP20 5DY, NP9 5BG, NP9 5BQ, NP9 5DD, NP9 5DE, NP9 5DF, NP9 5DL, NPT 5BG, NPT 5BQ, NPT 5BS, NPT 5DD, NPT 5DE, NPT 5DF",306,281,25
W00008352,NP20,"NP20 5AB, NP20 5AD, NP20 5AG, NP20 5AH, NP20 5AL, NP20 5AR, NP9 5AB, NP9 5AD, NP9 5AL, NP9 5DH, NP9 5DJ, NP9 5DQ, NPT 5AB, NPT 5AD, NPT 5AL, NPT 5DH, NPT 5DJ, NPT 5DL",429,383,46
W00008353,NP20,"NP20 4JD, NP20 4LQ, NP20 4LR, NP20 4LU, NP20 4NH, NP20 5AJ, NP20 5BJ, NP20 5BU, NP9 4NH, NP9 5AJ, NP9 5BH, NP9 5BJ, NP9 5BR, NP9 5DG, NPT 4NH, NPT 5AJ, NPT 5BH, NPT 5BJ, NPT 5DG",263,235,28
W00008354,NP20,"NP20 4LP, NP20 4LS, NP20 4LT, NP20 4LW, NP20 4LX, NP20 4NF, NP20 4NG, NP20 4NJ, NP20 4TL, NP9 4JT, NP9 4LN, NP9 4LR, NP9 4LS, NP9 4LT, NP9 4LW, NP9 4NE, NP9 4NF, NP9 4NG, NP9 4NJ, NP9 4TL, NPT 1AR, NPT 4JT, NPT 4JU, NPT 4LN, NPT 4LS, NPT 4LT, NPT 4LW, NPT 4LX, NPT 4NE, NPT 4NF, NPT 4NG, NPT 4NJ, NPT 4TL, NPT 5EG",338,293,45
W00008355,NP20,"NP20 4HJ, NP20 4JR, NP20 4JS, NP20 4NX, NP20 4NZ, NP20 4PA, NP20 4PB, NP20 4PD, NP20 4PN, NP20 4TS, NP20 4TU, NP20 4TW, NP20 4US, NP9 1SE, NP9 4HL, NP9 4JR, NP9 4LD, NP9 4NX, NP9 4PA, NP9 4PB, NP9 4PD, NP9 4RZ, NP9 4SL, NP9 4TF, NP9 4TH, NP9 4TS, NP9 4TT, NP9 4TU, NP9 4TW, NP9 4UE, NP9 4US, NP9 4UX, NP9 4YF, NP9 4YH, NPT 1SE, NPT 1WD, NPT 4HL, NPT 4JR, NPT 4JS, NPT 4LD, NPT 4NX, NPT 4PA, NPT 4PB, NPT 4PD, NPT 4PN, NPT 4RZ, NPT 4SL, NPT 4TH, NPT 4TS, NPT 4TU, NPT 4TW, NPT 4UE, NPT 4US, NPT 4UX",359,332,27
W00008356,NP20,"NP20 3SB, NP20 5AA, NP20 5AE, NP20 5AN, NP20 5AP, NP20 5AQ, NP9 3SB, NP9 3SD, NP9 5AH, NP9 5AN, NP9 5AP, NP9 5AQ, NP9 5AR, NPT 3SB, NPT 5AH, NPT 5AN, NPT 5AP, NPT 5AQ, NPT 5AR",305,280,25
W00010650,NP20,"NP20 2QP, NP20 2QQ, NP20 2QR, NP20 2QT",269,247,22
W00008474,NP20,"NP20 3AT, NP20 3DB, NP20 3DD, NP20 3DE, NP20 3DN, NP9 3AG, NP9 3AT, NP9 3BR, NP9 3DD, NP9 3DE, NP9 3DF, NP9 3YA, NPT 3AG, NPT 3AT, NPT 3BR, NPT 3DD, NPT 3DE, NPT 3DF, NPT 3YD",297,271,26
W00008473,NP20,"NP20 3BH, NP20 3BP, NP20 3BQ, NP20 3BR, NP20 3BU, NP20 3XT, NP20 3YF, NP9 3BH, NP9 3BJ, NP9 3BL, NP9 3BN, NP9 3XG, NP9 3XH, NP9 3XT, NPT 3BJ, NPT 3BN, NPT 3BS, NPT 3XT",251,240,11
W00008472,NP20,"NP20 3AH, NP20 3AJ, NP20 3AP, NP20 3AX, NP20 3AY, NP9 3AN, NP9 3AW, NP9 3AX, NP9 3AY, NP9 3AZ, NPT 3AN, NPT 3AW, NPT 3AX, NPT 3YB",268,252,16
W00008471,NP20,"NP20 3AF, NP20 3AG, NP20 3AL, NP20 3AN, NP20 3AW, NP9 3AF, NP9 3AL, NP9 3BA, NP9 3BB, NP9 3BD, NP9 3BG, NP9 3BQ, NPT 3AF, NPT 3AL, NPT 3BP, NPT 3BQ",310,286,24
W00008470,NP20,"NP20 3BB, NP20 3BL, NP20 3BN, NP20 3DR, NP20 3DS, NPT 3BL",431,407,24
W00008469,NP20,"NP20 3HR, NP20 3HS, NP20 3HT, NP9 3HR, NP9 3HS, NP9 3HT, NPT 3HR, NPT 3HS, NPT 3HT",289,274,15
W00008468,NP20,"NP20 3GA, NP20 3GL, NP20 3GN, NP20 3GQ, NP20 3GR, NP20 3GZ, NP20 3HA, NP20 3HB, NP20 3YA, NP9 3GA, NP9 3HA, NP9 3HB, NP9 3HD, NP9 3HF, NP9 3HX, NP9 3YB, NP9 3YD, NP9 3YF, NP9 3YG, NP9 3YH, NP9 3YQ, NPT 3GA, NPT 3HA, NPT 3HB, NPT 3HD, NPT 3HF, NPT 3XX",187,181,6
W00008467,NP20,"NP20 3JF, NP20 3JG, NP20 3JH, NP20 3JR, NP20 3JS, NP20 3JT, NP20 3JU, NP20 3JW, NP20 3JX, NP20 3LA, NP9 3JF, NP9 3JG, NP9 3JH, NP9 3JQ, NP9 3JR, NP9 3JS, NP9 3JT, NP9 3JU, NP9 3JW, NP9 3JX, NP9 3JY, NP9 3LA, NPT 3JF, NPT 3JG, NPT 3JH, NPT 3JQ, NPT 3JR, NPT 3JS, NPT 3JT, NPT 3JU, NPT 3JW, NPT 3JX, NPT 3JY, NPT 3LA",343,331,12
W00008466,NP20,"NP20 3JP, NP20 3JQ, NP20 3JY, NP20 3JZ, NP20 3LB, NP20 3LD, NP20 3LE, NP20 3LF, NP20 3LG, NP20 3LH, NP20 3LL, NP20 3LN, NP20 3LP, NP20 3LQ, NP20 3LZ, NP9 3JN, NP9 3JP, NP9 3JZ, NP9 3LD, NP9 3LE, NP9 3LF, NP9 3LL, NP9 3LN, NP9 3LP, NP9 3LQ, NP9 3LR, NPT 3JN, NPT 3JP, NPT 3JZ, NPT 3LD, NPT 3LE, NPT 3LF, NPT 3LL, NPT 3LN, NPT 3LP, NPT 3LQ, NPT 3YA",355,322,33
W00008464,NP20,"NP20 3JA, NP20 3JB, NP20 3JJ, NP20 3JL, NP20 3JN, NP20 3XU, NP9 3GX, NP9 3GZ, NP9 3JL, NP9 3XU, NP9 3YW, NPT 3GX, NPT 3GY, NPT 3GZ, NPT 3HX, NPT 3HY, NPT 3HZ, NPT 3JL",308,287,21
W00008724,NP20,"NP20 5LX, NP20 5PJ, NP20 5QZ, NP20 5RA, NP20 5RZ, NP9 5LU, NP9 5LX, NP9 5QY, NPT 5LU, NPT 5LX, NPT 5QY",279,253,26
W00008409,NP20,"NP20 6NX, NP20 7AE, NP20 7RA, NP20 7RD, NP20 7UJ, NP9 6AE, NP9 6NX, NPT 6AE, NPT 6NX",329,308,21
W00008722,NP20,"NP20 5LR, NP20 5LS, NP20 5LT, NP20 5LU, NP20 5LW, NP9 5LR, NP9 5LS, NP9 5LT, NPT 5LR, NPT 5LS, NPT 5LT",241,224,17
W00008613,NP20,"NP20 2GY, NP20 2HU, NP20 2JB, NP20 2JD, NP20 2JN, NP20 2JW, NP20 2LA, NP9 2GN, NP9 2UU, NP9 2XP, NPT 2UU",342,327,15
W00008612,NP20,"NP20 2HA, NP20 2HB, NP20 2JZ, NP20 2LU, NP20 2LZ, NP20 2NX, NP9 2GZ, NP9 2HA, NP9 2JZ, NP9 2LA, NP9 2LT, NP9 2LU, NP9 2LX, NP9 2LZ, NPT 2GN, NPT 2GZ, NPT 2HA, NPT 2LA, NPT 2LQ, NPT 2LT, NPT 2LU, NPT 2LX, NPT 2LY",219,210,9
W00008611,NP20,"NP20 2AD, NP20 2GH, NP20 2GZ, NP20 2LD, NP20 2LQ, NP20 2LS, NP20 2LT, NP20 2LW, NP20 2NA, NP20 2NB, NP9 2LB, NP9 2LH, NP9 2LL, NP9 2LQ, NP9 2LR, NP9 2NA, NPT 2JZ, NPT 2LB, NPT 2LH, NPT 2LL, NPT 2LR, NPT 2LS, NPT 2LZ, NPT 2NA",349,326,23
W00008610,NP20,"NP20 2EX, NP20 2FG, NP20 2FS, NP20 2GJ, NP20 2GN, NP20 2GQ, NP20 2NL, NP20 2NT, NP20 2PH, NP20 2QF, NP20 2WQ, NP20 2YD, NP20 2YE, NP20 2YG, NP20 2YN, NP20 2YT, NP20 2YW, NP9 2DB, NP9 2EU, NP9 2FS, NP9 2FT, NP9 2GH, NP9 2GJ, NP9 2GL, NP9 2GW, NP9 2GX, NP9 2JA, NP9 2LD, NP9 2LF, NP9 2NE, NP9 2PG, NP9 2PH, NP9 2PJ, NP9 2WN, NP9 2XL, NP9 2XW, NP9 2YB, NP9 2YF, NP9 2YH, NP9 2YN, NPT 2DB, NPT 2FS, NPT 2FT, NPT 2GH, NPT 2GJ, NPT 2GL, NPT 2GW, NPT 2GX, NPT 2JA, NPT 2LD, NPT 2LF, NPT 2NE, NPT 2PG, NPT 2PH, NPT 2PJ, NPT 2QF, NPT 2WN, NPT 2XW",520,500,20
W00008608,NP20,"NP20 2HP, NP20 2HX, NP20 2HY, NP20 2JF, NP20 2JG, NP20 2JH, NP20 2JS, NP20 2JT, NP20 2JU, NP20 2NP, NP20 2NQ, NP20 2NR, NP20 2NW, NP20 2PQ, NP20 2RZ, NP20 2SS, NP20 2UW, NP20 2UX, NP20 2UY, NP20 2WA, NP20 2WB, NP20 2WD, NP20 2WE, NP20 2WF, NP20 2WH, NP20 2WZ, NP9 1PU, NP9 1TX, NP9 2HG, NP9 2HP, NP9 2HY, NP9 2HZ, NP9 2JF, NP9 2JG, NP9 2JH, NP9 2JL, NP9 2JP, NP9 2JR, NP9 2JS, NP9 2JT, NP9 2JU, NP9 2JY, NP9 2NN, NP9 2NP, NP9 2NR, NP9 2NT, NP9 2SS, NP9 2TL, NP9 2UH, NP9 2UQ, NP9 2UR, NP9 2US, NP9 2UW, NP9 2UX, NP9 2UY, NP9 2UZ, NP9 2WA, NP9 2WB, NP9 2WD, NP9 2WE, NP9 2WX, NP9 2WZ, NP9 2XB, NP9 2XF, NP9 2XN, NP9 2XR, NPT 0XL, NPT 1TX, NPT 2HG, NPT 2HJ, NPT 2HP, NPT 2JF, NPT 2JG, NPT 2JH, NPT 2JL, NPT 2JP, NPT 2JS, NPT 2JT, NPT 2JU, NPT 2NH, NPT 2NP, NPT 2NQ, NPT 2NR, NPT 2NS, NPT 2NT, NPT 2UD, NPT 2UQ, NPT 2UR, NPT 2US, NPT 2UW, NPT 2UX, NPT 2UY, NPT 2UZ, NPT 2WA, NPT 2WB, NPT 2WE, NPT 2WZ, NPT 2XF, NPT 2XH, NPT 2XL, NPT 2XN, NPT 2XR, NPT 5YG",336,309,27
W00009866,NP20,"NP20 2BT, NP20 2FH, NP20 2FN, NP20 2FP, NP20 2GA, NP20 2GF, NP20 2GR, NP9 2BT, NP9 2BU, NP9 2TT, NP9 2XG, NPT 2TT, NPT 2XG",324,298,26
W00008595,NP20,"NP20 6JB, NP20 6JJ, NP20 6NA, NP20 6NB, NP20 6WH, NP20 6WR, NP9 6JA, NP9 6JB, NP9 6JD, NP9 6JE, NP9 6JF, NP9 6JG, NP9 6JJ, NP9 6NB, NP9 6WQ, NPT 6JA, NPT 6JB, NPT 6JD, NPT 6JE, NPT 6JF, NPT 6JG, NPT 6JJ, NPT 6NB, NPT 6WQ",299,270,29
W00008594,NP20,"NP20 6JN, NP20 6JP, NP20 6LH, NP20 6LJ, NP9 6JN, NP9 6JP, NP9 6LH, NP9 6LJ, NPT 6JN, NPT 6JP, NPT 6LH, NPT 6LJ",217,197,20
W00008593,NP20,"NP20 6LG, NP20 6LQ, NP20 6LW, NP20 6PL, NP9 6LG, NP9 6LQ, NP9 6PL, NPT 6LG, NPT 6LQ, NPT 6LT, NPT 6LU, NPT 6LW, NPT 6PL",293,279,14
W00008592,NP20,"NP20 6JD, NP20 6JE, NP20 6JF, NP20 6JG, NP20 6JS, NP20 6JZ, NP9 6JL, NP9 6JS, NP9 6JZ, NPT 6JL, NPT 6JS, NPT 6JZ",264,242,22
W00008591,NP20,"NP20 6NG, NP20 6NL, NP20 6NN, NP20 6NQ, NP20 6NR, NP20 6PG, NP9 6NF, NP9 6NG, NP9 6NR, NP9 6PG, NPT 6NF, NPT 6NG, NPT 6NR, NPT 6PG",153,145,8
W00008590,NP20,"NP20 6AD, NP20 6NP, NP20 6NS, NP20 6NT, NP20 6NU, NP20 6NW, NP20 6NY, NP20 6PF, NP9 6FW, NP9 6NL, NP9 6NN, NP9 6NP, NP9 6NQ, NP9 6NT, NP9 6NU, NP9 6NW, NP9 6NY, NP9 6NZ, NP9 6PE, NP9 6PF, NPT 6FW, NPT 6NL, NPT 6NN, NPT 6NP, NPT 6NQ, NPT 6NS, NPT 6NT, NPT 6NU, NPT 6NW, NPT 6NY, NPT 6NZ, NPT 6PE, NPT 6PF",318,300,18
W00008589,NP20,"NP20 6JR, NP20 6JT, NP20 6LA, NP20 6LD, NP20 6LE, NP20 6LX, NP20 6NF, NP20 6QS, NP20 6QU, NP20 6ZE, NP9 6JT, NP9 6JU, NP9 6JY, NP9 6LA, NP9 6LE, NP9 6PS, NP9 6PT, NPT 6JT, NPT 6JU, NPT 6JY, NPT 6LA, NPT 6LE, NPT 6ZE",281,267,14
W00008588,NP20,"NP20 6JQ, NP20 6JU, NP20 6JX, NP20 6JY, NP20 6PJ, NP9 6JQ, NP9 6JR, NP9 6JW, NP9 6JX, NP9 6PJ, NP9 6ZE, NPT 6JQ, NPT 6JR, NPT 6JW, NPT 6JX, NPT 6PJ",266,247,19
W00008587,NP20,"NP20 6QA, NP20 6QB, NP20 6QD, NP20 6QN, NP20 6QR, NP20 6QT, NP20 6QW, NP20 6QX, NP20 6QY, NP20 6QZ, NP9 6QA, NP9 6QB, NP9 6QD, NP9 6QE, NP9 6QF, NP9 6QH, NP9 6QL, NP9 6QN, NP9 6QP, NP9 6QR, NP9 6QS, NP9 6QT, NP9 6QU, NP9 6QW, NP9 6QX, NPT 6QD, NPT 6QE, NPT 6QF, NPT 6QH, NPT 6QL, NPT 6QN, NPT 6QP, NPT 6QR, NPT 6QS, NPT 6QT, NPT 6QU, NPT 6QW, NPT 6QX",247,232,15
W00008614,NP20,"NP20 2FY, NP20 2GU, NP20 2HD, NP20 2HQ, NP20 2HS, NP20 2JE, NP20 2JJ, NP20 2JL, NP20 2JP, NP20 2JQ, NP20 2JR, NP20 2JY, NP20 2UL, NP20 2US, NP9 1AN, NP9 2BX, NP9 2BY, NP9 2GU, NP9 2GY, NP9 2HB, NP9 2HD, NP9 2HQ, NP9 2HS, NP9 2HU, NP9 2JB, NP9 2JD, NP9 2JE, NP9 2JJ, NP9 2JN, NP9 2JQ, NP9 2JW, NP9 2TH, NP9 2TW, NP9 2UF, NP9 2UL, NP9 2WH, NPT 1AN, NPT 2BX, NPT 2BY, NPT 2GU, NPT 2GY, NPT 2HB, NPT 2HD, NPT 2HQ, NPT 2HU, NPT 2JB, NPT 2JD, NPT 2JE, NPT 2JJ, NPT 2JN, NPT 2JQ, NPT 2JR, NPT 2JW, NPT 2TH, NPT 2TW, NPT 2UF, NPT 2UH, NPT 2WH, NPT 2XP, NPT 2XQ",462,433,29
W00008615,NP20,"NP20 2AA, NP20 2AN, NP20 2AR, NP20 2AS, NP20 2AU, NP20 2AW, NP20 2AY, NP20 2BA, NP20 2BD, NP20 2BE, NP20 2BG, NP20 2PB, NP20 2PD, NP20 2PS, NP20 2PT, NP20 2TN, NP9 2AG, NP9 2AP, NP9 2AS, NP9 2AT, NP9 2AW, NP9 2AY, NP9 2AZ, NP9 2BG, NP9 2BH, NP9 2TE, NP9 2TG, NP9 2UN, NPT 2AG, NPT 2AP, NPT 2AQ, NPT 2AS, NPT 2AT, NPT 2AW, NPT 2AY, NPT 2AZ, NPT 2BG, NPT 2TE, NPT 2TG, NPT 2UN",528,498,30
W00008616,NP20,"NP20 2BJ, NP20 2HW, NP20 2PN, NP20 2PP, NP9 1YF, NP9 2BA, NP9 2BB, NP9 2BE, NP9 2FA, NP9 2FB, NP9 2PB, NP9 2PD, NP9 2PN, NP9 2TF, NP9 2TN, NPT 2BA, NPT 2BB, NPT 2BE, NPT 2FA, NPT 2FB, NPT 2PB, NPT 2PD, NPT 2PN, NPT 2TF, NPT 2TL, NPT 2TN, NPT 2WQ",177,169,8
W00008619,NP20,"NP20 2PL, NP20 2RB, NP20 2RD, NP20 2RE, NP20 2RF, NP20 2RH, NP20 2RJ, NP20 2RL, NP20 2RN, NP20 2RQ, NP20 2RR, NP20 2RU, NP9 2PE, NP9 2QE, NP9 2RB, NP9 2RD, NP9 2RE, NP9 2RF, NP9 2RG, NP9 2RH, NP9 2WP, NPT 2PE, NPT 2PL, NPT 2QE, NPT 2WP, NPT 7XB",523,470,53
W00010520,NP20,"NP20 7ER, NP20 7GH, NP20 7GN, NP20 7GU, NP9 6AB, NPT 6AB, NPT 6YX",286,259,27
W00009873,NP20,"NP20 2AF, NP20 2AG, NP20 2AH, NP20 2AJ, NP20 2AP, NP20 2AQ, NP20 2AT, NP20 2AX, NP20 2AZ, NP20 2BB, NP20 2BH, NP20 2BL, NP20 2DW, NP20 2DX, NP20 2DY, NP20 2GD, NP20 2GE, NP20 2TJ, NP20 2UP, NP9 1EG, NP9 1QD, NP9 2AA, NP9 2AF, NP9 2AH, NP9 2AJ, NP9 2AQ, NP9 2AX, NP9 2BD, NP9 2BR, NP9 2TB, NP9 2TD, NP9 2TP, NP9 2XA, NPT 1EG, NPT 1QD, NPT 2AA, NPT 2AF, NPT 2AH, NPT 2AX, NPT 2BD, NPT 2TB, NPT 2TD, NPT 2TR, NPT 2XA",356,347,9
W00010533,NP20,"NP20 2PX, NP20 2QA, NP20 2QD, NP20 2QE, NP20 2QY, NP20 2QZ, NP20 2RW",268,251,17
W00010545,NP20,"NP20 2FQ, NP20 2FU, NP20 2QU, NP20 2QW, NP20 2QX, NP9 3AA, NPT 3AA",274,240,34
W00009879,NP20,"NP20 2BU, NP20 2BW, NP20 2BX, NP20 2DF, NP20 2DL, NP20 2DQ, NP20 2DU, NP20 2FJ, NP20 2FL, NP20 2FR, NP20 2GS, NP20 2GT, NP20 2HZ, NP20 2JA, NP20 2JX, NP20 2LG, NP20 2LH, NP20 2LJ, NP20 2TT, NP20 2TX, NP9 2BW, NP9 2SZ, NP9 2TU, NP9 2XQ, NPT 2BU, NPT 2BW, NPT 2SZ, NPT 2TU",328,304,24
W00010547,NP20,"NP20 1AE, NP20 1AG, NP20 1DH, NP20 1DJ, NP20 1DL, NP20 1DP, NP20 1DQ, NP20 1DR, NP20 1DS, NP20 1DT, NP20 1DU, NP20 1DW, NP20 1DX, NP20 1DY, NP20 1DZ, NP20 1EA, NP20 1EB, NP20 1ED, NP20 1EQ, NP20 1ER, NP20 1ES, NP20 1EU, NP20 1EX, NP20 1FA, NP20 1HB, NP20 1HD, NP20 1HE, NP20 1HF, NP20 1HJ, NP20 1HL, NP20 1HP, NP20 1HR, NP20 1HS, NP20 1HY, NP20 1HZ, NP20 1JD, NP20 1JE, NP20 1JF, NP20 1JJ, NP20 1JL, NP20 1JN, NP20 1JP, NP20 1JQ, NP20 1JR, NP20 1JT, NP20 1JU, NP20 1LE, NP20 1LF, NP20 1LN, NP20 1LP, NP20 1LQ, NP20 1LY, NP20 1PA, NP20 1PQ, NP20 1PW, NP20 1PX, NP20 1QY, NP20 1RL, NP20 1SJ, NP20 1SN, NP20 1SS, NP20 1SU, NP20 1TD, NP20 1TL, NP20 1TN, NP20 1TP, NP20 1TS, NP20 1UE, NP20 1UL, NP20 1UQ, NP20 1WD, NP20 1WG, NP20 1WJ, NP20 1WN, NP20 1WR, NP20 1WX, NP20 1XA, NP20 1YA, NP20 1YD, NP20 1YT, NP20 4RS, NP9 1AH, NP9 1DH, NP9 1DJ, NP9 1DL, NP9 1DN, NP9 1DP, NP9 1DQ, NP9 1DS, NP9 1DT, NP9 1DU, NP9 1DW, NP9 1DX, NP9 1DY, NP9 1ED, NP9 1ER, NP9 1GF, NP9 1GG, NP9 1GJ, NP9 1GY, NP9 1GZ, NP9 1HA, NP9 1HB, NP9 1HD, NP9 1HE, NP9 1HF, NP9 1HG, NP9 1HJ, NP9 1HL, NP9 1HN, NP9 1HP, NP9 1HQ, NP9 1HR, NP9 1HS, NP9 1HT, NP9 1HZ, NP9 1JA, NP9 1JB, NP9 1JD, NP9 1JE, NP9 1JJ, NP9 1JL, NP9 1JN, NP9 1JP, NP9 1JQ, NP9 1JR, NP9 1JW, NP9 1LL, NP9 1LN, NP9 1LP, NP9 1PA, NP9 1PB, NP9 1PG, NP9 1PJ, NP9 1PL, NP9 1PQ, NP9 1PW, NP9 1PX, NP9 1QE, NP9 1QH, NP9 1QY, NP9 1RH, NP9 1RJ, NP9 1RL, NP9 1RP, NP9 1RQ, NP9 1RW, NP9 1RZ, NP9 1SA, NP9 1SH, NP9 1SJ, NP9 1SL, NP9 1SN, NP9 1SP, NP9 1SR, NP9 1SS, NP9 1ST, NP9 1SU, NP9 1SX, NP9 1SY, NP9 1TD, NP9 1TJ, NP9 1TL, NP9 1TN, NP9 1TP, NP9 1TS, NP9 1TT, NP9 1TU, NP9 1TY, NP9 1UB, NP9 1UD, NP9 1UE, NP9 1UF, NP9 1UG, NP9 1UH, NP9 1UL, NP9 1UN, NP9 1US, NP9 1UW, NP9 1UY, NP9 1WA, NP9 1WF, NP9 1WT, NP9 1WW, NP9 1WX, NP9 1WY, NP9 1XA, NP9 1XB, NP9 1XD, NP9 1XE, NP9 1XH, NP9 1XJ, NP9 1XL, NP9 1XN, NP9 1XP, NP9 1XR, NP9 1XS, NP9 1XT, NP9 1XY, NP9 1YA, NP9 1YB, NP9 1YD, NP9 1YE, NP9 1YG, NP9 1YH, NP9 1YL, NP9 1YN, NP9 1YP, NP9 1YT, NP9 1YU, NP9 2TR, NP9 2TS, NP9 4RD, NP9 4RE, NP9 4RG, NP9 4RS, NP9 4SE, NP9 4SS, NP9 4UT, NP9 4XG, NP9 4XX, NP9 4XY, NP9 7XA, NP9 8WT, NPT 1AH, NPT 1DG, NPT 1DH, NPT 1DJ, NPT 1DL, NPT 1DN, NPT 1DP, NPT 1DQ, NPT 1DS, NPT 1DT, NPT 1DU, NPT 1DW, NPT 1DX, NPT 1DY, NPT 1ER, NPT 1GF, NPT 1GJ, NPT 1GX, NPT 1GY, NPT 1GZ, NPT 1HA, NPT 1HB, NPT 1HD, NPT 1HE, NPT 1HF, NPT 1HG, NPT 1HJ, NPT 1HL, NPT 1HN, NPT 1HP, NPT 1HQ, NPT 1HR, NPT 1HS, NPT 1HT, NPT 1HZ, NPT 1JA, NPT 1JB, NPT 1JJ, NPT 1JL, NPT 1JN, NPT 1JP, NPT 1JQ, NPT 1JR, NPT 1JW, NPT 1LA, NPT 1LN, NPT 1LQ, NPT 1PA, NPT 1PB, NPT 1PG, NPT 1PJ, NPT 1PL, NPT 1PQ, NPT 1PR, NPT 1PW, NPT 1PX, NPT 1QH, NPT 1QY, NPT 1RJ, NPT 1RL, NPT 1RP, NPT 1RQ, NPT 1RY, NPT 1RZ, NPT 1SA, NPT 1SH, NPT 1SJ, NPT 1SL, NPT 1SN, NPT 1SP, NPT 1SR, NPT 1SS, NPT 1ST, NPT 1SU, NPT 1SX, NPT 1SY, NPT 1TD, NPT 1TH, NPT 1TP, NPT 1TT, NPT 1TU, NPT 1TY, NPT 1UB, NPT 1UD, NPT 1UE, NPT 1UF, NPT 1UG, NPT 1UL, NPT 1UW, NPT 1UY, NPT 1WA, NPT 1WH, NPT 1WT, NPT 1WW, NPT 1WX, NPT 1WY, NPT 1XA, NPT 1XB, NPT 1XE, NPT 1XH, NPT 1XJ, NPT 1XL, NPT 1XP, NPT 1XT, NPT 1XY, NPT 1YD, NPT 1YE, NPT 1YF, NPT 1YG, NPT 1YH, NPT 1YL, NPT 2TP, NPT 2TS, NPT 4RE, NPT 4RG, NPT 4RS, NPT 4SE, NPT 4SS, NPT 4UT, NPT 7XA, NPT 8WT",245,234,11
W00010553,NP20,"NP20 2BR, NP20 2BS, NP20 2DZ, NP20 2FW, NP20 2FX, NP20 2HG, NP20 2HJ, NP9 2BS",510,472,38
W00008586,NP20,"NP20 6JW, NP20 6PN, NP20 6PQ, NP20 6PR, NP9 6PN, NP9 6PP, NP9 6PR, NPT 6PN, NPT 6PP, NPT 6PR",279,261,18
W00008723,NP20,"NP20 5GH, NP20 5LZ, NP20 5ND, NP20 5NH, NP20 5NN, NP20 5NP, NP20 5NR, NP20 5NS, NP20 5WA, NP20 5WQ, NP20 5XW, NP20 5ZQ, NP20 5ZR, NP20 5ZU, NP9 0WQ, NP9 5LW, NP9 5NN, NP9 5NP, NP9 5NS, NP9 5NT, NP9 5XP, NP9 5YS, NP9 5YU, NPT 0WQ, NPT 5LW, NPT 5NN, NPT 5NP, NPT 5XP, NPT 5XY, NPT 5YS",254,230,24
W00010507,NP20,"NP20 2QB, NP20 2QJ, NP20 2QL, NP20 2QN, NP20 2QS",292,266,26
W00010496,NP20,"NP20 2DS, NP20 2HE, NP20 2HF, NP20 2HL, NP20 2HR, NP20 2HT, NP20 2LY, NP20 2NN, NP20 2NS, NP20 2NY, NP20 2NZ, NP20 2RX, NP20 2SA, NP20 2XB, NP20 2XE, NP20 2XF, NP20 2XQ, NP9 2HE, NP9 2HF, NP9 2HJ, NP9 2HL, NP9 2HR, NP9 2HT, NP9 2HX, NP9 2LW, NP9 2NS, NP9 2TQ, NP9 2XD, NP9 2XE, NPT 2HE, NPT 2HF, NPT 2HL, NPT 2HR, NPT 2HS, NPT 2HT, NPT 2LW, NPT 2NN, NPT 2TQ, NPT 2XD, NPT 2XE",351,313,38
W00008624,NP20,"NP20 2HH, NP20 2LB, NP20 2LE, NP20 2LP, NP20 2ND, NP20 2NE, NP20 2NH, NP20 2NJ, NP9 2HH, NP9 2LG, NP9 2LJ, NP9 2LN, NP9 2LP, NP9 2LS, NP9 2LY, NP9 2NB, NP9 2ND, NP9 2NJ, NP9 2NL, NPT 2HH, NPT 2LG, NPT 2LJ, NPT 2LN, NPT 2LP, NPT 2NB, NPT 2ND, NPT 2NJ, NPT 2NL, NPT 2WX",334,319,15
W00008623,NP20,"NP20 2BN, NP20 2DA, NP20 2DB, NP20 2DD, NP20 2DE, NP20 2GL, NP20 2GW, NP20 2GX, NP20 2WT, NP9 2BZ, NP9 2DA, NP9 2DD, NP9 2DE, NP9 2DF, NP9 2DG, NP9 2DL, NP9 2DP, NP9 2TX, NP9 2WS, NP9 2WT, NPT 2BZ, NPT 2DA, NPT 2DD, NPT 2DE, NPT 2DF, NPT 2DG, NPT 2DL, NPT 2DP, NPT 2TX, NPT 2WS, NPT 2WT",398,380,18
W00008622,NP20,"NP20 2EN, NP20 2EP, NP20 2EQ, NP20 2ET, NP20 2EU, NP20 2FT, NP20 2NF, NP20 2NU, NP20 2PW, NP20 2PY, NP20 2PZ, NP9 2EJ, NP9 2EL, NP9 2EN, NP9 2EP, NP9 2EQ, NP9 2ER, NP9 2ES, NP9 2ET, NP9 2EX, NP9 2LE, NP9 2NF, NP9 2NG, NP9 2NH, NP9 2NQ, NP9 2QA, NP9 2RA, NP9 2UD, NPT 0XN, NPT 2EL, NPT 2EN, NPT 2EP, NPT 2EQ, NPT 2ER, NPT 2ET, NPT 2EU, NPT 2EW, NPT 2LE, NPT 2NF, NPT 2NG, NPT 2QA",500,456,44
W00008621,NP20,"NP20 1ZY, NP20 2ER, NP20 2EW, NP20 2QG, NP20 2RP, NP9 1ZA, NP9 1ZB, NP9 1ZY, NP9 2EW, NP9 2GE, NP9 2QB, NP9 2QD, NP9 2QF, NP9 2QG, NP9 2RJ, NP9 2RL, NP9 2RN, NP9 2RP, NP9 2RQ, NP9 2RR, NP9 2RS, NP9 2RT, NP9 2RU, NPT 2ES, NPT 2GE, NPT 2QB, NPT 2QD, NPT 2QG",199,173,26
W00008620,NP20,"NP20 2DP, NP20 2DR, NP20 2DT, NP20 2GB, NP20 2GG, NP20 2LF, NP20 2PE, NP20 2PF, NP20 2PG, NP20 2PJ, NP20 2RG, NP20 2RS, NP20 2RT, NP20 2XJ, NP9 0UP, NP9 2AN, NP9 2AR, NP9 2AU, NP9 2DQ, NP9 2DR, NP9 2DS, NP9 2DU, NP9 2PF, NP9 2PL, NP9 2TJ, NP9 2XH, NP9 2XJ, NPT 0UP, NPT 2AN, NPT 2AR, NPT 2AU, NPT 2DQ, NPT 2DR, NPT 2PF, NPT 2TJ, NPT 2UL, NPT 2XJ",374,353,21
W00010518,NP20,"NP20 5PZ, NP20 7GB, NP20 7GG, NP20 7GL, NP20 7YB, NP9 5PZ, NP9 5QE, NP9 5XL, NP9 6AA, NPT 5PZ, NPT 5XL, NPT 6AA, NPT 6AZ",246,222,24
W00008585,NP20,"NP20 6PP, NP20 6QG, NP20 6QP, NP20 6QQ, NP9 6PQ, NP9 6QQ, NPT 6PQ, NPT 6QQ",311,286,25
W00008618,NP20,"NP20 2EH, NP20 2EJ, NP20 2EL, NP20 2ES, NP20 2EY, NP20 2FA, NP20 2FB, NP20 2QH, NP20 2RA, NP20 3QN, NP9 2EH, NP9 2EY, NP9 2HW, NP9 2PP, NP9 2QH, NPT 2EH, NPT 2EJ, NPT 2EX, NPT 2EY, NPT 2HW, NPT 2PP, NPT 2QH",228,219,9
W00008583,NP20,"NP20 6QE, NP20 6QF, NP20 6QH, NP20 6QJ, NP20 6QL, NP9 6QG, NP9 6QJ, NPT 6QG, NPT 6QJ",282,262,20
W00008570,NP20,"NP20 6LL, NP20 6LN, NP20 6LP, NP20 6LR, NP9 6LN, NP9 6LP, NPT 6LN, NPT 6LP, NPT 6LR, NPT 6LS",287,274,13
W00008712,NP20,"NP20 5FJ, NP20 5FL, NP20 5GL, NP20 5GN, NP20 5HU, NP20 5JG, NP20 5JH, NP20 5PA, NP20 5PB, NP20 5PD, NP9 5FL, NP9 5FN, NP9 5HU, NP9 5HX, NP9 5JH, NP9 5JJ, NP9 5JL, NP9 5JN, NP9 5JQ, NP9 5JR, NP9 5JS, NP9 5JY, NP9 5LY, NP9 5LZ, NP9 5NA, NP9 5NG, NP9 5XS, NP9 5YP, NP9 5ZF, NPT 5FL, NPT 5FN, NPT 5JJ, NPT 5JL, NPT 5JN, NPT 5JQ, NPT 5JR, NPT 5JS, NPT 5JY, NPT 5LY, NPT 5LZ, NPT 5NA, NPT 5XD, NPT 5XS, NPT 5YP",217,203,14
W00008713,NP20,"NP20 5HW, NP20 5HX, NP20 5JU, NP20 5LA, NP20 5LB, NP20 5LD, NP20 5YR, NP9 5JU, NP9 5JZ, NP9 5LA, NP9 5LD, NPT 5JU, NPT 5JZ, NPT 5LA, NPT 5LD, NPT 5YD",321,296,25
W00008715,NP20,"NP20 5PU, NP20 5PX, NP20 6GQ, NP9 5PU, NP9 6GQ, NP9 6GR, NP9 6WA, NPT 5PT, NPT 5PU, NPT 6GQ, NPT 6GR, NPT 6WA",179,174,5
W00008716,NP20,"NP20 5QH, NP20 5QJ, NP20 5QN, NP20 5QQ, NP9 5QH, NP9 5QJ, NP9 5QN, NP9 5UU, NP9 5UW, NP9 5UX, NP9 5UZ, NPT 5QH, NPT 5QJ, NPT 5QL, NPT 5QN, NPT 5UX, NPT 5UZ",382,364,18
W00008717,NP20,"NP20 5LP, NP20 5LQ, NP20 5NL, NP20 5NT, NP20 5QF, NP20 5QG, NP20 5QW, NP20 5YF, NP20 5YH, NP9 5LP, NP9 5LQ, NP9 5NL, NP9 5QW, NP9 5XW, NP9 5XZ, NPT 5LP, NPT 5LQ, NPT 5NL, NPT 5QW, NPT 5XW, NPT 5XZ, NPT 5YH, NPT 5YR",285,257,28
W00008571,NP20,"NP20 6FL, NP20 6FP, NP20 6FQ, NP20 6FR, NP20 6NH, NP20 6NJ, NP20 6PH, NP9 6FJ, NP9 6FN, NP9 6FP, NP9 6NE, NP9 6NJ, NP9 6PH, NPT 6FJ, NPT 6FN, NPT 6FP, NPT 6NE, NPT 6NJ, NPT 6PH, NPT 6ZD",298,283,15
W00008721,NP20,"NP20 5PL, NP20 5PN, NP20 5PQ, NP20 5QD, NP20 5RD, NP20 5RE, NP9 5PN, NP9 5PQ, NP9 5PR, NP9 5QD, NP9 5RB, NP9 5RE, NPT 5PN, NPT 5PP, NPT 5PQ, NPT 5PR, NPT 5QD, NPT 5RB, NPT 5RE",250,233,17
W00008719,NP20,"NP20 5PP, NP20 5QL, NP20 5QR, NP20 6GP, NP20 6YB, NP20 6YN, NP20 6YU, NP9 1PN, NP9 5PP, NP9 5QL, NP9 5QQ, NP9 5QR, NP9 6GP, NP9 6HH, NP9 6YB, NPT 1PN, NPT 5QQ, NPT 5QR, NPT 6GP, NPT 6HH, NPT 6YB, NPT 6YD",275,251,24
W00008718,NP20,"NP20 5PS, NP20 5PW, NP20 5PY, NP20 5QA, NP20 5QB, NP20 5QE, NP9 5PS, NP9 5PW, NP9 5PX, NP9 5PY, NP9 5QA, NP9 5QB, NPT 5PS, NPT 5PW, NPT 5PX, NPT 5PY, NPT 5QA, NPT 5QB",254,236,18
W00010608,NP20,"NP20 5EJ, NP20 7AD, NP20 7HL, NP20 7RZ, NP20 7SA, NP20 7SD, NP20 7SE, NP20 7SH, NP20 7SJ, NP20 7XH, NP9 6AD, NP9 6BA, NP9 6BB, NP9 6BQ, NP9 6BS, NP9 6HL, NP9 6RQ, NP9 6RR, NP9 6RS, NP9 6RW, NP9 6RX, NP9 6RY, NP9 6RZ, NP9 6SA, NP9 6SD, NP9 6SG, NP9 6SL, NP9 6SR, NP9 6SS, NP9 6SU, NP9 6SX, NP9 6SY, NP9 6XH, NP9 6XJ, NP9 6XL, NP9 6XN, NPT 6AD, NPT 6BA, NPT 6BB, NPT 6BQ, NPT 6BS, NPT 6HL, NPT 6RQ, NPT 6RR, NPT 6RS, NPT 6RW, NPT 6RX, NPT 6RY, NPT 6RZ, NPT 6SA, NPT 6SD, NPT 6SG, NPT 6SJ, NPT 6SL, NPT 6SR, NPT 6SS, NPT 6SU, NPT 6SX, NPT 6SY, NPT 6XH, NPT 6XJ, NPT 6XL, NPT 6XN",231,218,13
W00010604,NP20,"NP20 2FZ, NP20 2HN, NP20 2LN, NP20 2LR, NP9 2BP, NPT 2BS, NPT 2BT",129,115,14
W00010593,NP20,"NP20 1JG, NP20 1JH, NP20 1JW, NP20 1JX, NP20 1LX, NP20 1LZ, NP20 4DX, NP20 4DZ, NP20 4EN, NP20 4EP, NP20 4EQ, NP9 1EB, NP9 1EW, NP9 1JG, NP9 1JH, NP9 1JS, NP9 1JX, NP9 1LD, NP9 1LQ, NP9 1LR, NP9 1LY, NP9 1LZ, NP9 1SQ, NP9 1TF, NP9 1TR, NP9 1UQ, NP9 1UR, NP9 1UT, NP9 1UU, NP9 1WB, NP9 4EN, NP9 4EP, NP9 4RT, NPT 1JD, NPT 1JE, NPT 1JG, NPT 1JH, NPT 1JS, NPT 1LP, NPT 1LR, NPT 1LY, NPT 1LZ, NPT 1SQ, NPT 1TF, NPT 1TL, NPT 1TN, NPT 1TR, NPT 1UH, NPT 1UN, NPT 1UQ, NPT 1UR, NPT 1UT, NPT 1UU, NPT 1WB, NPT 1WE, NPT 4DP, NPT 4DX, NPT 4EN, NPT 4EP, NPT 4RT",221,203,18
W00008584,NP20,"NP20 6NZ, NP20 6PA, NP20 6PB, NP20 6PD, NP20 6PE, NP9 6NS, NP9 6PA, NP9 6PB, NP9 6PD, NPT 6PA, NPT 6PB, NPT 6PD",171,165,6
W00008720,NP20,"NP20 5PR, NP20 5QX, NP20 5QY, NP20 5RB, NP20 5RY, NP9 5QX, NPT 5QX",277,258,19
W00008572,NP20,"NP20 6FB, NP20 6FD, NP20 6FS, NP20 6FT, NP20 6FU, NP20 6FW, NP20 6FX, NP20 6FY, NP20 6FZ, NP20 6GB, NP9 6FB, NP9 6FD, NP9 6FF, NP9 6FH, NP9 6FL, NP9 6FQ, NP9 6FR, NP9 6FS, NP9 6FT, NP9 6FX, NP9 6FY, NP9 6FZ, NP9 6NH, NPT 6FB, NPT 6FD, NPT 6FF, NPT 6FH, NPT 6FL, NPT 6FQ, NPT 6FR, NPT 6FS, NPT 6FT, NPT 6FX, NPT 6FY, NPT 6FZ, NPT 6HJ, NPT 6NH",297,287,10
W00008714,NP20,"NP20 5QP, NP20 5QS, NP20 5QT, NP20 5QU, NP9 5QP, NP9 5QS, NP9 5QT, NP9 5QU, NP9 6WJ, NP9 6WL, NPT 5QP, NPT 5QS, NPT 5QT, NPT 5QU, NPT 6WG, NPT 6WJ, NPT 6WL",263,249,14
W00008574,NP20,"NP20 6FF, NP20 6FH, NP20 6FJ, NP20 6FN, NP20 6JA, NP20 6LB, NP20 6LY, NP20 6ND, NP20 6NE, NP20 6PS, NP20 6PT, NP9 6LB, NP9 6LD, NP9 6ND, NP9 6ZD, NPT 6LB, NPT 6LD, NPT 6ND",356,344,12
W00008582,NP20,"NP20 6AA, NP20 6GR, NP20 6HF, NP20 6HH, NP20 6WA, NP9 6HF, NP9 6HJ, NPT 6HF",278,259,19
W00008581,NP20,"NP20 6EP, NP20 6EQ, NP20 6ER, NP20 6EU, NP20 6GS, NP20 6HE, NP20 6HJ, NP9 6EP, NP9 6EQ, NP9 6ER, NP9 6ES, NP9 6ET, NP9 6GS, NP9 6GU, NP9 6HE, NPT 6EP, NPT 6EQ, NPT 6ER, NPT 6ES, NPT 6ET, NPT 6GS, NPT 6GU, NPT 6HE",301,285,16
W00008580,NP20,"NP20 6ES, NP20 6ET, NP20 6EW, NP20 6GA, NP20 6GT, NP20 6GU, NP20 6WB, NP9 6EW, NP9 6FA, NP9 6GT, NP9 6HB, NP9 6WB, NP9 6WD, NPT 6EW, NPT 6FA, NPT 6GT, NPT 6HB, NPT 6WB, NPT 6WD",336,312,24
W00008573,NP20,"NP20 6LS, NP20 6LT, NP20 6LU, NP20 6WP, NP9 6LF, NP9 6LR, NP9 6LS, NP9 6LW, NPT 6LF, NPT 6LL",285,275,10
W00008578,NP20,"NP20 6GY, NP20 6GZ, NP20 6HA, NP20 6WE, NP20 6WF, NP20 6WG, NP9 6GZ, NP9 6WE, NP9 6WF, NP9 6WG, NP9 6WP, NP9 6WR, NP9 6WS, NPT 6GZ, NPT 6WE, NPT 6WF, NPT 6WP, NPT 6WR, NPT 6WS",373,348,25
W00008577,NP20,"NP20 6LF, NP20 6WJ, NP20 6WL, NP20 6WN, NP20 6YD, NP20 6YE, NP20 6YG, NP6 1QZ, NP9 6LT, NP9 6WN, NP9 6YD, NP9 6YE, NP9 6YG, NP9 6YH, NP9 6YP, NP9 6YQ, NP9 6YW, NPT 6WN, NPT 6YE",277,251,26
W00008579,NP20,"NP20 6GW, NP20 6GX, NP20 6HB, NP20 6HD, NP20 6HG, NP9 6GW, NP9 6GX, NP9 6GY, NP9 6HA, NP9 6HD, NP9 6HG, NPT 6GW, NPT 6GX, NPT 6GY, NPT 6HA, NPT 6HD, NPT 6HG",300,275,25
W00008575,NP20,"NP20 6JH, NP20 6JL, NP20 6WQ, NP20 6WS, NP20 6WT, NP20 6WU, NP9 6JH, NP9 6LL, NP9 6LU, NP9 6WT, NP9 6WU, NPT 6JH, NPT 6WT, NPT 6WU",294,278,16
W00008576,NP20,"NP20 6EX, NP20 6EY, NP20 6EZ, NP20 6FA, NP20 6FE, NP20 6FG, NP20 6PW, NP20 6WD, NP9 6EX, NP9 6EY, NP9 6EZ, NP9 6FE, NP9 6FG, NP9 6NA, NP9 6WH, NPT 6EX, NPT 6EY, NPT 6EZ, NPT 6FE, NPT 6FG, NPT 6NA, NPT 6WH",319,299,20
W00007534,NP23,"NP23 5DH, NP23 5DZ, NP23 5EA, NP23 5EE, NP23 5ES, NP23 5ET, NP23 5EU, NP23 5EX, NP23 5EY, NP23 5HA, NP3 5DZ, NP3 5EA, NP3 5EE, NP3 5EF, NP3 5EU, NP3 5EX, NP3 5EY, NP3 5HA, NP3 5HB",298,291,7
W00007535,NP23,"NP23 5NY, NP23 5QB, NP23 5QN, NP23 5QR, NP23 5QW, NP23 5RA, NP23 5RB, NP23 5RD, NP23 5RE, NP23 5TB, NP3 5QN, NP3 5QP, NP3 5QR, NP3 5QW, NP3 5RB, NP3 5RD, NP3 5RE, NP3 5RF",280,258,22
W00007536,NP23,"NP23 5DJ, NP23 5DL, NP23 5DS, NP23 5DT, NP23 5DU, NP3 5DH, NP3 5DJ, NP3 5DL, NP3 5DN, NP3 5DS, NP3 5DU, NP3 5DX, NP3 5LY",277,260,17
W00007524,NP23,"NP23 5LS, NP23 5LT, NP23 5LU, NP23 5LW, NP23 5LX, NP23 5NN, NP3 5AZ, NP3 5LQ, NP3 5LW, NP3 5NN, NP3 5NP",286,266,20
W00007537,NP23,"NP23 5JZ, NP23 5QD, NP23 5RH, NP23 5RJ, NP23 5RY, NP3 5QB, NP3 5RH, NP3 5RJ, NP3 5RY, NP3 5RZ",240,226,14
W00007538,NP23,"NP23 5BN, NP23 5DG, NP23 5DN, NP23 5DQ, NP23 5HS, NP23 5HT, NP23 5HU, NP23 5HX, NP23 5JF, NP23 5JJ, NP23 5JL, NP23 5JN, NP23 5JP, NP23 5JQ, NP23 5JW, NP23 5QH, NP23 5RU, NP3 5DQ, NP3 5HS, NP3 5HX, NP3 5JJ, NP3 5QH, NP3 5RP, NP3 5RS, NP3 5RU",254,236,18
W00007539,NP23,"NP23 5HH, NP23 5HJ, NP23 5HP, NP23 5HR, NP23 5HW, NP23 5HZ, NP23 5JA, NP23 5JB, NP23 5JD, NP23 5JE, NP23 5JH, NP23 5LB, NP23 5NU, NP23 5XW, NP23 5YB, NP3 5HP, NP3 5HR, NP3 5HW, NP3 5HY, NP3 5HZ, NP3 5JA, NP3 5JB, NP3 5JD, NP3 5JG, NP3 5JH, NP3 5JN, NP3 5JY, NP3 5JZ, NP3 5LB, NP3 5NX, NP3 5YG, NP3 5YH, NP3 5YL, NP3 5YQ",235,223,12
W00010316,NP23,"NP23 5AB, NP23 5AD, NP23 5AG, NP23 5AN, NP23 5AY, NP23 5AZ, NP23 5BD, NP23 5FA, NP23 5FE, NP23 5FF, NP23 5FG, NP23 5FH, NP23 5FJ, NP23 5FL, NP23 6EH, NP23 6EJ, NP23 6EU, NP23 6YN, NP23 6YY, NP23 6ZR, NP3 5AB, NP3 5AG, NP3 5AN, NP3 5AQ, NP3 5AR, NP3 5AS, NP3 5AU, NP3 5AY, NP3 5BE, NP3 5FA, NP3 5FB, NP3 5FD, NP3 5FE, NP3 5FF, NP3 5FG, NP3 5FH, NP3 5FJ, NP3 5FL, NP3 5YP, NP3 5YR, NP3 6EH, NP3 6EJ",390,360,30
W00007631,NP23,"NP23 4WZ, NP23 4YB, NP23 4YR, NP23 4ZQ, NP23 4ZW, NP23 5YG, NP23 5YH, NP23 5YN, NP23 6AD, NP23 6AY, NP23 6AZ, NP23 6HT, NP23 6HU, NP23 6HY, NP23 6HZ, NP23 6JF, NP23 6YE, NP23 6YF, NP23 6YL, NP23 6YU, NP23 6ZQ, NP23 7YF, NP23 8XW, NP23 9AA, NP23 9AB, NP23 9AD, NP23 9AE, NP23 9AF, NP23 9BB, NP23 9BD, NP23 9BE, NP23 9BF, NP23 9BG, NP23 9BH, NP23 9BJ, NP23 9BL, NP23 9BN, NP23 9BP, NP23 9BQ, NP23 9BR, NP23 9BS, NP23 9BT, NP23 9BU, NP23 9BW, NP23 9BX, NP3 6AZ, NP3 6HY, NP3 6XR",308,278,30
W00007632,NP23,"NP23 6BE, NP23 6BG, NP23 6DP, NP23 6DW, NP23 6JE, NP23 6UG, NP23 6UJ, NP23 6XD, NP3 6HT, NP3 6JE, NP3 6JF, NP3 6XN",250,238,12
W00007634,NP23,"NP23 5AE, NP23 5BA, NP23 5BB, NP23 6AB, NP23 6AE, NP23 6AF, NP23 6AG, NP23 6AH, NP23 6AQ, NP23 6EE, NP23 6EP, NP3 5BA, NP3 5BB, NP3 5BD, NP3 6AG",463,429,34
W00007562,NP23,"NP23 4SZ, NP23 4TB, NP23 4TG, NP23 4TQ, NP23 4TU, NP3 4TA, NP3 4TD, NP3 4TQ, NP3 4TU",237,224,13
W00007561,NP23,"NP23 4BR, NP23 4BT, NP23 4BX, NP23 4DP, NP23 4DT, NP23 4DU, NP23 4DX, NP23 4EA, NP23 4EB, NP23 4ED, NP23 4EF, NP23 4FA, NP23 4NA, NP23 4PT, NP23 4XG, NP23 4XN, NP23 4YD, NP3 4BT, NP3 4BU, NP3 4BX, NP3 4DS, NP3 4DT, NP3 4DU, NP3 4DX, NP3 4DY, NP3 4ED, NP3 4EF, NP3 4EJ, NP3 4EL, NP3 4XJ, NP3 4XL, NP3 4XW, NP3 4XY, NP3 4YH",265,248,17
W00007563,NP23,"NP23 4HE, NP23 4HF, NP23 4HG, NP23 4HP, NP23 4HX, NP23 4JA, NP3 4HE, NP3 4HL, NP3 4TR",254,242,12
W00007556,NP23,"NP23 4DG, NP23 4DJ, NP23 4DY, NP23 4DZ, NP23 4FB, NP23 4SD, NP23 4SH, NP23 4XB, NP3 4DG, NP3 4DJ, NP3 4DZ, NP3 4RE, NP3 4SJ, NP3 4XB",380,353,27
W00007557,NP23,"NP23 4DA, NP23 4DB, NP23 4DD, NP23 4DF, NP23 4DL, NP23 4DN, NP23 4DW, NP23 4ES, NP23 4YG, NP23 4YH, NP23 4YQ, NP3 4DA, NP3 4DB, NP3 4DW, NP3 4RF, NP3 4RH, NP3 4SL, NP3 4XP, NP3 4YG, NP3 4YJ, NP3 4YQ, NP3 4YR",204,194,10
W00007558,NP23,"NP23 4JB, NP23 4SU, NP23 4TL, NP23 4TS, NP23 4TX, NP23 4TZ, NP23 5RT, NP3 4SU, NP3 4TE, NP3 4TF, NP3 4TS, NP3 4TZ",291,271,20
W00007559,NP23,"NP23 4AH, NP23 4AS, NP23 4EP, NP23 4EU, NP23 4EW, NP23 4EX, NP23 4EZ, NP23 4HA, NP23 4SY, NP23 4TP, NP3 4AS, NP3 4AT, NP3 4AU, NP3 4ER, NP3 4EU, NP3 4JR, NP3 4JY, NP3 4JZ, NP3 4TP",260,243,17
W00007560,NP23,"NP23 4QA, NP23 4RD, NP23 4RN, NP23 4RZ, NP23 4SG, NP3 4QN, NP3 4RB, NP3 4RP, NP3 4RW, NP3 4RZ",213,188,25
W00007635,NP23,"NP23 6BS, NP23 6BW, NP23 6DR, NP23 6DS, NP23 6DT, NP23 6DU, NP23 6DX, NP23 6DY, NP23 6DZ, NP23 6EA, NP23 6GZ, NP23 6HX, NP23 6UL, NP23 6UQ, NP3 6BH, NP3 6DX, NP3 6HU, NP3 6HX, NP3 6HZ, NP3 6UL, NP3 6UU",233,222,11
W00007633,NP23,"NP23 5YA, NP23 6BH, NP23 6BJ, NP23 6BL, NP23 6BQ, NP23 6DE, NP23 6DH, NP23 6DJ, NP23 6DQ, NP23 6PW, NP3 6BE, NP3 6BG, NP3 6BQ, NP3 6DH, NP3 6DJ, NP3 6DN, NP3 6DP, NP3 6DQ, NP3 6DW, NP3 6PN, NP3 6UG, NP3 6UJ, NP3 6XH, NP3 6XP",232,227,5
W00007533,NP23,"NP23 5EB, NP23 5EH, NP23 5EJ, NP23 5EL, NP23 5EN, NP23 5EP, NP23 5EQ, NP23 5ER, NP23 5EW, NP3 5EH, NP3 5EJ, NP3 5EL, NP3 5EN, NP3 5EP, NP3 5ES, NP3 5ET, NP3 5EW",264,250,14
W00007682,NP23,"NP23 5AJ, NP23 5SS, NP23 5ST, NP23 5SU, NP23 5XD, NP23 5XE, NP23 5XF, NP23 5XG, NP23 5XH, NP23 5XJ, NP23 5XL, NP23 5XN, NP3 5SR, NP3 5SS, NP3 5TS, NP3 5TT, NP3 5TU, NP3 5XA, NP3 5XB, NP3 5XD, NP3 5XE, NP3 5XF, NP3 5XG, NP3 5XJ, NP3 5XL, NP3 5XN, NP3 5XQ",364,354,10
W00007531,NP23,"NP23 5RP, NP23 5RR, NP23 5RS, NP23 5RZ, NP3 5QF, NP3 5QG, NP3 5QJ, NP3 5QQ, NP3 5RR, NP3 5RT, NP3 5RX",236,227,9
W00007674,NP23,"NP23 4JT, NP23 4JU, NP23 4LA, NP23 4LB, NP23 4LD, NP23 4QB, NP23 4QD, NP23 4QE, NP23 4QF, NP23 4QL, NP23 4QR, NP23 4QS, NP23 4QW, NP3 3BT, NP3 3YB, NP3 4JD, NP3 4JN, NP3 4JT, NP3 4JU, NP3 4JX, NP3 4LA, NP3 4LB, NP3 4LD, NP3 4LE, NP3 4LF, NP3 4LG, NP3 4LH, NP3 4LN, NP3 4LP, NP3 4QE, NP3 4QF, NP3 4QG, NP3 4QL, NP3 4QR, NP3 4QS, NP3 4QT, NP3 4QW, NP3 4QX, NP3 4QY, NP3 4UA",257,239,18
W00007673,NP23,"NP23 4BD, NP23 4BH, NP23 4BY, NP23 4BZ, NP23 4QU, NP3 4BD, NP3 4BH, NP3 4BJ, NP3 4BY, NP3 4BZ, NP3 4QP, NP3 4QU",288,270,18
W00007672,NP23,"NP23 4AZ, NP23 4LU, NP23 4ND, NP23 4NE, NP23 4NG, NP23 4NT, NP23 4YF, NP23 4YN, NP3 4AX, NP3 4AY, NP3 4AZ, NP3 4NQ, NP3 4WU, NP3 4WW, NP3 4YD, NP3 4YE, NP3 4YF, NP3 4YL, NP3 4YN, NP3 4YP, NP3 4YY",184,175,9
W00007670,NP23,"NP23 4UJ, NP23 4UY, NP23 4UZ, NP23 4WB, NP23 4WE, NP23 4WF, NP3 4UZ, NP3 4WF",290,270,20
W00007667,NP23,"NP23 4PH, NP23 4UL, NP23 4UT, NP23 4UU, NP23 4WA, NP23 4WD, NP23 4WH, NP3 4UU, NP3 4WA, NP3 4WD, NP3 4WH",324,308,16
W00007666,NP23,"NP23 4AY, NP23 4BJ, NP23 4QP, NP23 4QX, NP23 4QY, NP3 4JS, NP3 4QA, NP3 4QB, NP3 4QD, NP3 4WX",324,299,25
W00007665,NP23,"NP23 4BU, NP23 4JS, NP23 4NB, NP23 4NF, NP23 4NH, NP23 4NJ, NP23 4NL, NP23 4NN, NP23 4NR, NP23 4NS, NP23 4PG, NP23 4PQ, NP23 4PU, NP23 4WJ, NP3 2AA, NP3 4JH, NP3 4NB, NP3 4ND, NP3 4NE, NP3 4NF, NP3 4NH, NP3 4NJ, NP3 4NL, NP3 4NN, NP3 4NS, NP3 4NW, NP3 4NY, NP3 4PU, NP3 4WZ, NP3 4YX",300,285,15
W00007630,NP23,"NP23 6BP, NP23 6BR, NP23 6BX, NP23 6BY, NP23 6BZ, NP23 6DA, NP23 6DB, NP23 6DD, NP23 6DF, NP3 5YA, NP3 6BJ, NP3 6BL, NP3 6BN, NP3 6BS, NP3 6BW, NP3 6BY, NP3 6DA, NP3 6DB, NP3 6DD, NP3 6DE, NP3 6DF, NP3 6DG, NP3 6DR, NP3 6DS, NP3 6DT, NP3 6EB, NP3 6ED, NP3 6PL",259,246,13
W00007526,NP23,"NP23 5TY, NP23 5TZ, NP23 6HE, NP3 5LZ, NP3 5NA, NP3 5TZ, NP3 5UA, NP3 5UD",268,256,12
W00007525,NP23,"NP23 5LL, NP23 5NA, NP23 5NH, NP23 5UD, NP3 5JU, NP3 5LN, NP3 5LS, NP3 5LT, NP3 5LU",305,280,25
W00007675,NP23,"NP23 4PB, NP23 4PD, NP23 4PJ, NP23 4PR, NP3 4PB, NP3 4PD",253,231,22
W00007676,NP23,"NP23 4JN, NP23 4JX, NP23 4LE, NP23 4LF, NP23 4NP, NP23 4NZ, NP23 4PA, NP23 4PE, NP23 4PF, NP3 4NP, NP3 4NR, NP3 4NT, NP3 4NX, NP3 4PE, NP3 4PR",248,236,12
W00007527,NP23,"NP23 5HY, NP23 5JG, NP23 5JR, NP23 5JS, NP23 5JT, NP23 5JU, NP23 5JX, NP23 5JY, NP23 5LA, NP23 5NX, NP23 5NZ, NP23 5PA, NP23 5PB, NP23 5PE, NP23 5PF, NP23 5PQ, NP23 5PX, NP23 5YE, NP3 5HT, NP3 5HU, NP3 5JF, NP3 5JL, NP3 5JP, NP3 5JQ, NP3 5JR, NP3 5JS, NP3 5JT, NP3 5JW, NP3 5JX, NP3 5LA, NP3 5NY, NP3 5NZ, NP3 5PE, NP3 5YE, NP3 5YN",305,274,31
W00007528,NP23,"NP23 5DX, NP23 5DY, NP23 5ED, NP23 5EF, NP23 5EG, NP3 5DT, NP3 5DY, NP3 5EB, NP3 5ED, NP3 5EG, NP3 5EQ, NP3 5ER",276,266,10
W00007677,NP23,"NP23 4JW, NP23 4LG, NP23 4LH, NP23 4LJ, NP23 4LL, NP23 4NU, NP23 4NX, NP23 4NY, NP23 4PL, NP23 4PP, NP3 4JW, NP3 4LJ, NP3 4LL, NP3 4NU, NP3 4NZ, NP3 4PA, NP3 4PF, NP3 4PJ, NP3 4PL, NP3 4PP",242,225,17
W00007678,NP23,"NP23 4LN, NP23 4LP, NP23 4LW, NP23 4QJ, NP23 4QZ, NP3 4LU, NP3 4LW, NP3 4LX, NP3 4LY, NP3 4LZ, NP3 4PH, NP3 4QJ, NP3 4UT",283,260,23
W00007679,NP23,"NP23 5SJ, NP23 5SL, NP23 5SN, NP23 5SP, NP23 5TP, NP3 5DD, NP3 5SD, NP3 5SN, NP3 5SP, NP3 5SW",279,260,19
W00007680,NP23,"NP23 5SA, NP23 5SB, NP23 5TH, NP23 5TJ, NP23 5TN, NP23 5TQ, NP23 5TR, NP3 5SA, NP3 5SB, NP3 5TN, NP3 5UP, NP3 5UT",251,243,8
W00007529,NP23,"NP23 5QG, NP23 5QJ, NP23 5QL, NP23 5QP, NP23 5QQ, NP23 5RF, NP23 5RG, NP23 5RQ, NP3 5RG, NP3 5RQ",275,255,20
W00007530,NP23,"NP23 5HL, NP23 5HN, NP23 5RL, NP23 5RN, NP23 5RW, NP3 5HJ, NP3 5HL, NP3 5HN, NP3 5QD, NP3 5QE, NP3 5QL, NP3 5RL, NP3 5RN, NP3 5RW",275,260,15
W00007683,NP23,"NP23 5PH, NP23 5PL, NP23 5PN, NP23 5PP, NP23 5PR, NP23 5PY, NP23 5PZ, NP23 5QA, NP3 5PF, NP3 5PH, NP3 5PJ, NP3 5PL, NP3 5TF",286,271,15
W00007684,NP23,"NP23 5AH, NP23 5BL, NP23 5BR, NP23 5BW, NP23 5QF, NP23 5SE, NP23 5SF, NP23 5SG, NP23 5SQ, NP3 5BR, NP3 5BW, NP3 5PY, NP3 5SF, NP3 5SQ, NP3 5TP",268,257,11
W00007685,NP23,"NP23 5BE, NP23 5BH, NP23 5BJ, NP23 5PS, NP23 5PT, NP23 5PU, NP23 5SH, NP3 5BH, NP3 5PR, NP3 5PS, NP3 5PT, NP3 5PU, NP3 5PX, NP3 5PZ, NP3 5QA, NP3 5SH",229,213,16
W00007686,NP23,"NP23 5DF, NP23 5DP, NP23 5DW, NP23 5TS, NP23 5TT, NP23 5TU, NP23 5UP, NP23 5UR, NP23 5US, NP23 5UT, NP3 5DF, NP3 5DP, NP3 5DW, NP3 5TH, NP3 5UR, NP3 5US",280,267,13
W00007687,NP23,"NP23 5TW, NP23 5XA, NP23 5XB, NP3 5TR, NP3 5TW",233,223,10
W00007688,NP23,"NP23 5SR, NP23 5SW, NP23 5SX, NP23 5SY, NP23 5SZ, NP23 5TA, NP23 5XP, NP3 5SL, NP3 5ST, NP3 5SU, NP3 5SX, NP3 5SY, NP3 5SZ, NP3 5TA, NP3 5TB, NP3 5TE, NP3 5TJ, NP3 5XH, NP3 5XP",246,240,6
W00007689,NP23,"NP23 5DE, NP23 5PG, NP23 5PJ, NP23 5QE, NP23 5TD, NP23 5TE, NP23 5TF, NP23 5TG, NP23 5TL, NP3 5DE, NP3 5PG, NP3 5PQ, NP3 5TD, NP3 5TG, NP3 5TL, NP3 5TQ",204,198,6
W00007532,NP23,"NP23 4JD, NP23 5QS, NP23 5QT, NP23 5QU, NP23 5QX, NP23 5QY, NP23 5QZ, NP23 5RX, NP3 4JB, NP3 5QS, NP3 5QT, NP3 5QU, NP3 5QX, NP3 5QY, NP3 5QZ, NP3 5RA",273,245,28
W00007629,NP23,"NP23 6NT, NP23 6NU, NP23 6NX, NP23 6NY, NP23 6PB, NP23 6PE, NP3 6NY, NP3 6NZ, NP3 6PU",339,324,15
W00007589,NP23,"NP23 7RE, NP23 7RF, NP23 7RG, NP23 7RH, NP23 7RQ, NP3 6RE, NP3 6RF",291,276,15
W00007627,NP23,"NP23 6BA, NP23 6BB, NP23 6BD, NP23 6BN, NP23 6DL, NP23 6EF, NP23 6HG, NP23 6HL, NP23 6HN, NP23 6HW, NP23 6LL, NP23 6UW, NP23 6XA, NP23 6XY, NP23 6YG, NP23 6YH, NP23 6YX, NP23 8UW, NP3 6AY, NP3 6EE, NP3 6EF, NP3 6HG, NP3 6HL, NP3 6HQ, NP3 6HR, NP3 6XB, NP3 6XG, NP3 6XL, NP3 6XQ, NP3 6YB, NP3 6YG, NP3 6YH, NP3 6YJ, NP3 6YN, NP3 6YQ, NP3 6YR",187,181,6
W00007583,NP23,"NP23 6TN, NP23 6TU, NP23 6TW, NP23 6TX, NP23 6UD, NP3 6TN, NP3 6TP, NP3 6TT, NP3 6TX, NP3 6UD",254,240,14
W00007628,NP23,"NP23 6DG, NP23 6LG, NP23 6LQ, NP23 6PN, NP23 6PP, NP23 6XW, NP23 6YA, NP23 6YD, NP23 6YJ, NP23 6YR, NP23 6YW, NP3 6BA, NP3 6BB, NP3 6BD, NP3 6HN, NP3 6LG, NP3 6LQ, NP3 6PP, NP3 6PR, NP3 6PW, NP3 6XA, NP3 6XJ, NP3 6XY, NP3 6XZ, NP3 6YE",248,221,27
W00007581,NP23,"NP23 6FA, NP23 6TP, NP23 6TR, NP23 6TT, NP23 6TY, NP3 6TY",293,276,17
W00007580,NP23,"NP23 7SG, NP23 7SQ, NP23 7TA, NP3 6SF, NP3 6SG, NP3 6TA, NP3 6TB",242,230,12
W00007579,NP23,"NP23 7SY, NP23 7SZ, NP23 7TE, NP23 7TF, NP23 7TG, NP3 6SQ, NP3 6SY, NP3 6SZ, NP3 6TG",253,231,22
W00007578,NP23,"NP23 7SJ, NP23 7SL, NP23 7SN, NP23 7SP, NP23 7SR, NP23 7SU, NP23 7SW, NP3 6RR, NP3 6SE, NP3 6SJ",228,216,12
W00007577,NP23,"NP23 7QZ, NP23 7RA, NP23 7RB, NP23 7RN, NP23 7SB, NP3 6QX, NP3 6RA, NP3 6RB, NP3 6SD, NP3 6UE",291,275,16
W00007576,NP23,"NP23 7RJ, NP23 7RL, NP23 7RP, NP23 7RW, NP23 7SS, NP23 7ST, NP23 7TH, NP23 7TJ, NP3 6QZ, NP3 6RH, NP3 6RJ, NP3 6RN, NP3 6SB, NP3 6SP, NP3 6SR",315,300,15
W00007575,NP23,"NP23 4DE, NP23 4DH, NP23 4DQ, NP23 4FD, NP23 4RA, NP23 4RB, NP23 4RF, NP23 4RH, NP23 4SA, NP3 4AA, NP3 4DE, NP3 4DQ, NP3 4RA, NP3 4RQ, NP3 4SA, NP3 4SD, NP3 4SP, NP3 4SR",240,225,15
W00007574,NP23,"NP23 4TE, NP23 4TF, NP23 4TH, NP23 4TJ, NP23 4TN, NP23 4TT, NP3 4SB, NP3 4TG, NP3 4TT",306,287,19
W00007573,NP23,"NP23 4QN, NP23 4RE, NP23 4RU, NP23 4SE, NP23 4SF, NP23 4SJ, NP3 4RD, NP3 4XS",218,203,15
W00007572,NP23,"NP23 4RJ, NP23 4RX, NP23 4RY, NP23 4SB, NP23 4SX, NP23 4TA, NP23 4TD, NP3 4RJ, NP3 4RL, NP3 4RX, NP3 4RY",237,224,13
W00007571,NP23,"NP23 4GA, NP23 4GU, NP23 4RP, NP23 4RR, NP23 4RS, NP23 4RT, NP23 4RW, NP23 4SN, NP23 4SP, NP23 4SR, NP23 4XT, NP3 4RR, NP3 4RS, NP3 4RT, NP3 4RU, NP3 4SF, NP3 4SG, NP3 4XT, NP3 4XX",296,276,20
W00007570,NP23,"NP23 4HN, NP23 4HQ, NP23 4HW, NP23 4HY, NP3 4HF, NP3 4HG, NP3 4HN, NP3 4HQ, NP3 4HR, NP3 4HW, NP3 4HX, NP3 4HY, NP3 4JA",285,271,14
W00007569,NP23,"NP23 4EQ, NP23 4ER, NP23 4ET, NP23 4EY, NP23 4RQ, NP23 4SS, NP3 4ET, NP3 4SS",120,120,0
W00007568,NP23,"NP23 4HJ, NP23 4HS, NP23 4HT, NP23 4HU, NP23 4HZ, NP23 4TY, NP3 4HJ, NP3 4HS, NP3 4HU, NP3 4TY",290,263,27
W00007565,NP23,"NP23 4AA, NP23 4AB, NP23 4AE, NP23 4AF, NP23 4AG, NP23 4AQ, NP23 4AW, NP23 4JP, NP23 4JY, NP23 4JZ, NP23 4RG, NP23 4RL, NP23 4XD, NP23 4XE, NP23 4XR, NP23 4XX, NP3 4AB, NP3 4AD, NP3 4AE, NP3 4AF, NP3 4AG, NP3 4AQ, NP3 4DF, NP3 4DH, NP3 4EW, NP3 4JP, NP3 4RG, NP3 4RN, NP3 4SE, NP3 4XA, NP3 4XD, NP3 4XE, NP3 4XR",229,217,12
W00007566,NP23,"NP23 4AD, NP23 4AJ, NP23 4AN, NP23 4AP, NP23 4EH, NP23 4EJ, NP23 4EL, NP23 4FE, NP23 4PS, NP23 4XJ, NP3 4AJ, NP3 4AN, NP3 4DD, NP3 4DL, NP3 4DN, NP3 4DP, NP3 4EA, NP3 4EB, NP3 4EH, NP3 4EQ, NP3 4ES, NP3 4XF, NP3 4XG, NP3 4XQ",191,179,12
W00007567,NP23,"NP23 4AR, NP23 4HB, NP23 4HD, NP23 4HH, NP23 4HL, NP23 4HR, NP23 4ST, NP23 4TR, NP23 4TW, NP3 4AH, NP3 4AR, NP3 4EX, NP3 4EY, NP3 4EZ, NP3 4HA, NP3 4HB, NP3 4HD, NP3 4HH, NP3 4ST, NP3 4SX, NP3 4SY, NP3 4SZ, NP3 4TB, NP3 4TH, NP3 4TJ, NP3 4TL, NP3 4TN, NP3 4TW, NP3 4XU",265,246,19
W00008146,NP23,"NP23 4YA, NP3 4YA, NP7 0AF, NP7 0AL, NP7 0AP, NP7 0AS, NP7 0AT, NP7 0AU, NP7 0BW, NP7 0DU",204,189,15
W00007523,NP23,"NP23 5LD, NP23 5LP, NP23 5LQ, NP23 5LR, NP23 5UE, NP23 5UF, NP23 5UG, NP23 5UL, NP23 5UQ, NP23 5UW, NP23 5WU, NP3 5HG, NP3 5LP, NP3 5LR, NP3 5NR, NP3 5NS, NP3 5UF, NP3 5UL, NP3 5UQ, NP3 5UW",273,246,27
W00007522,NP23,"NP23 5ND, NP23 5NE, NP23 5NL, NP23 5NP, NP23 5NR, NP23 5NW, NP3 5ND, NP3 5NE, NP3 5NW",272,259,13
W00007521,NP23,"NP23 5AA, NP23 5FP, NP23 5FR, NP23 5LH, NP23 5LN, NP23 5NG, NP23 5NJ, NP3 5AA, NP3 5FP, NP3 5LH, NP3 5NJ, NP3 5NL",395,370,25
W00007520,NP23,"NP23 5HF, NP23 5HG, NP23 5HQ, NP23 5NS, NP23 5NT, NP23 5PD, NP23 5UJ, NP3 5HF, NP3 5HH, NP3 5HQ, NP3 5JE, NP3 5NU, NP3 5PA, NP3 5PB, NP3 5PD",202,191,11
W00007519,NP23,"NP23 5AL, NP23 5BZ, NP23 5PW, NP23 5UA, NP23 5UB, NP23 5UH, NP23 5UN, NP23 5WS, NP23 5YD, NP23 6GT, NP23 6HA, NP23 6LD, NP3 5BJ, NP3 5BL, NP3 5BZ, NP3 5DR, NP3 5PN, NP3 5PP, NP3 5PW, NP3 5SE, NP3 5SG, NP3 5UB, NP3 5UE, NP3 5UG, NP3 5UH, NP3 5UJ, NP3 5UN, NP3 5YD",469,448,21
W00007518,NP23,"NP23 5LY, NP23 5LZ, NP23 5NB, NP3 5LL, NP3 5LX, NP3 5NH, NP3 5YJ",304,288,16
W00007517,NP23,"NP23 5TX, NP23 6HD, NP23 6JA, NP23 6JB, NP23 6JD, NP3 5NB, NP3 5TX, NP3 5TY, NP3 6HA, NP3 6HB, NP3 6HD, NP3 6HE, NP3 6JA, NP3 6JD",227,218,9
W00007584,NP23,"NP23 6FP, NP23 6NF, NP23 6WQ, NP23 8AT, NP23 8DN, NP23 8WQ, NP23 8WR, NP3 6FP, NP3 6TR, NP3 6TS",291,276,15
W00007585,NP23,"NP23 6AU, NP23 6ED, NP23 6WP, NP23 8AR, NP23 8AS, NP23 8AU, NP23 8AX, NP23 8ED, NP23 8FP, NP23 8WP, NP23 8YW, NP3 6AU",306,279,27
W00007582,NP23,"NP23 6AP, NP23 6AR, NP23 6AS, NP23 6TZ, NP23 6UA, NP23 6UB, NP23 6WR, NP23 8AP, NP23 8AW, NP23 8BR, NP3 6AP, NP3 6AR, NP3 6AS, NP3 6AT, NP3 6AW, NP3 6TU, NP3 6TW, NP3 6UA, NP3 6UB",254,231,23
W00007587,NP23,"NP23 7PY, NP23 7QY, NP23 7RD, NP23 7RX, NP23 7RY, NP23 7RZ, NP23 7SF, NP23 7UE, NP3 6PY, NP3 6QY, NP3 6RD, NP3 6RG, NP3 6RQ, NP3 6RZ",279,269,10
W00007626,NP23,"NP23 6LP, NP23 6LR, NP23 6LS, NP23 6LT, NP23 6LW, NP23 6PT, NP3 6EN, NP3 6JH, NP3 6LL, NP3 6LP, NP3 6LR, NP3 6LS",294,276,18
W00007625,NP23,"NP23 6HQ, NP23 6HS, NP23 6LN, NP23 6PR, NP23 6PS, NP23 6UY, NP23 6XX, NP3 6HH, NP3 6HP, NP3 6HS, NP3 6HW, NP3 6LN, NP3 6LU, NP3 6LW, NP3 6LX, NP3 6PS, NP3 6PT, NP3 6UX, NP3 6UY, NP3 6XS, NP3 6XT, NP3 6XW, NP3 6XX, NP3 6YT",303,290,13
W00007624,NP23,"NP23 6AA, NP23 6EG, NP23 6EQ, NP23 6FB, NP23 6GH, NP23 6HH, NP23 6HJ, NP23 6HP, NP23 6HR, NP23 6JG, NP23 6LU, NP23 6LX, NP3 6EG, NP3 6EQ, NP3 6HJ, NP3 6JG, NP3 6JQ, NP3 6LT, NP3 6NS, NP3 6XF, NP3 6XU",156,145,11
W00007623,NP23,"NP23 6AJ, NP23 6AL, NP23 6AT, NP23 6AX, NP23 6BT, NP23 6BU, NP23 6DN, NP23 6EB, NP23 6ER, NP23 6EX, NP23 6GL, NP23 6GR, NP23 6UF, NP23 6UN, NP23 6UP, NP23 6UR, NP23 6US, NP23 6UT, NP23 6XF, NP23 6XS, NP23 8AN, NP23 8AY, NP23 8ER, NP23 8EX, NP23 8UF, NP23 8UP, NP23 8US, NP23 8UT, NP23 8XA, NP23 8XE, NP23 8XF, NP23 8XS, NP3 6AA, NP3 6AB, NP3 6AD, NP3 6AE, NP3 6AF, NP3 6AH, NP3 6AJ, NP3 6AL, NP3 6AN, NP3 6AQ, NP3 6AX, NP3 6BP, NP3 6BR, NP3 6BT, NP3 6BU, NP3 6BX, NP3 6BZ, NP3 6DU, NP3 6DY, NP3 6DZ, NP3 6EA, NP3 6TZ, NP3 6UF, NP3 6UH, NP3 6UN, NP3 6UP, NP3 6UQ, NP3 6UR, NP3 6US, NP3 6UT, NP3 6UW, NP3 6XD, NP3 6YA, NP3 6YD, NP3 6YF",474,435,39
W00007622,NP23,"NP23 6NZ, NP23 6PA, NP23 6PD, NP23 6PF, NP23 6PG, NP23 6PJ, NP23 6PU, NP3 6NB, NP3 6NT, NP3 6NU, NP3 6NX, NP3 6PA, NP3 6PB, NP3 6PD, NP3 6PE, NP3 6PF, NP3 6PG, NP3 6PH, NP3 6PJ",322,307,15
W00007621,NP23,"NP23 6PL, NP23 6QH, NP23 6QJ, NP23 6QL, NP23 6QN, NP23 6QQ, NP23 6QW, NP23 6RA, NP23 6WE, NP23 6ZU, NP3 6LD, NP3 6QW, NP3 6WE, NP3 6YL, NP3 6YP, NP3 6YU, NP3 6YW, NP3 6YX, NP3 6YZ, NP3 6ZA, NP3 6ZB, NP3 6ZU",312,304,8
W00007620,NP23,"NP23 6NA, NP23 6NB, NP23 6NH, NP23 6NR, NP23 6PX, NP3 6LZ, NP3 6NA, NP3 6NR",194,189,5
W00007619,NP23,"NP23 6QU, NP23 6WA, NP23 6WB, NP23 6WD, NP23 6WG, NP23 6WH, NP3 6WA, NP3 6WB, NP3 6WD, NP3 6WF, NP3 6WG, NP3 6WH, NP3 6WQ",286,275,11
W00007586,NP23,"NP23 7SH, NP23 7SX, NP23 7TB, NP23 7TD, NP23 7TL, NP23 7TQ, NP23 7WJ, NP23 7WL, NP3 2ER, NP3 2NQ, NP3 6RL, NP3 6RP, NP3 6RW, NP3 6SH, NP3 6SL, NP3 6SN, NP3 6SS, NP3 6ST, NP3 6SU, NP3 6SW, NP3 6SX, NP3 6TD, NP3 6TE, NP3 6TF, NP3 6TH, NP3 6TJ, NP3 6TL, NP3 6TQ, NP3 6WJ, NP3 6WL, NP3 6WN, NP3 6WP, NP3 6WR",220,201,19
W00007616,NP23,"NP23 6EN, NP23 6ES, NP23 6ET, NP23 6EY, NP23 6EZ, NP23 6HF, NP23 6JQ, NP23 6XB, NP23 6XE, NP23 6XG, NP23 6XJ, NP23 6XR, NP23 6YB, NP23 6ZA, NP23 9BA, NP23 9SA, NP23 9ZF, NP23 9ZG, NP23 9ZH, NP23 9ZJ, NP23 9ZL, NP23 9ZN, NP23 9ZP, NP23 9ZQ, NP23 9ZR, NP23 9ZS, NP23 9ZT, NP23 9ZU, NP23 9ZW, NP23 9ZX, NP23 9ZY, NP23 9ZZ, NP3 6ER, NP3 6ES, NP3 6ET, NP3 6EU, NP3 6EX, NP3 6EY, NP3 6EZ, NP3 6HF, NP3 6YY",208,197,11
W00007615,NP23,"NP23 6EL, NP23 6EW, NP23 6JH, NP23 6JJ",282,273,9
W00007614,NP23,"NP23 5AF, NP23 5FB, NP23 5FD, NP23 5FN, NP23 5FQ, NP23 6AW, NP3 5AD, NP3 5AE, NP3 5AF, NP3 5FN, NP3 5FQ, NP3 5FR",338,322,16
W00007618,NP23,"NP23 6HB, NP23 6JY, NP23 6JZ, NP23 6LY, NP23 6LZ, NP23 6NJ, NP23 6NS, NP3 6EL, NP3 6JJ, NP3 6JY, NP3 6LY, NP3 6NJ, NP3 6NQ",278,269,9
W00007612,NP23,"NP23 6JN, NP23 6JS, NP23 6JT, NP23 6LB, NP3 6JN, NP3 6JT, NP3 6JW",257,245,12
W00007588,NP23,"NP23 6PZ, NP23 7QX, NP23 7RR, NP23 7RS, NP23 7RT, NP23 7RU, NP23 7SA, NP23 7SD, NP23 7SE, NP3 6PZ, NP3 6RS, NP3 6RT, NP3 6RU, NP3 6RX, NP3 6RY, NP3 6SA",316,300,16
W00007564,NP23,"NP23 4AT, NP23 4AU, NP23 4AX, NP23 4BP, NP23 4BS, NP23 4DR, NP23 4DS, NP23 4GB, NP3 4BP, NP3 4BR, NP3 4BS, NP3 4DR, NP3 4SH, NP3 4XH",301,270,31
W00009796,NP23,"NP23 4AL, NP23 4BL, NP23 4EE, NP23 4EG, NP23 4EN, NP23 4PW, NP23 4SL, NP23 4WX, NP3 4AP, NP3 4AW, NP3 4BL, NP3 4HT, NP3 4HZ, NP3 4NA, NP3 4NG, NP3 4PS, NP3 4PT, NP3 4XN",468,413,55
W00007613,NP23,"NP23 6GA, NP23 6GB, NP23 6GD, NP23 6GF, NP23 6GG, NP23 6WF, NP23 6WS, NP23 6WT, NP23 6WU, NP3 5YB, NP3 6GE, NP3 6GF, NP3 6GG, NP3 6GH, NP3 6GZ, NP3 6JR, NP3 6LA, NP3 6LB, NP3 6NL",463,436,27
W00009795,NP23,"NP23 4BA, NP23 4BB, NP23 4BE, NP23 4BG, NP23 4BN, NP23 4BQ, NP23 4BW, NP23 4QT, NP3 4BA, NP3 4BB, NP3 4BE, NP3 4BG, NP3 4BN, NP3 4BQ, NP3 4BW",262,249,13
W00007607,NP23,"NP23 6FD, NP23 6FE, NP23 6FG, NP23 6GE, NP23 6JP, NP23 6JR, NP23 6JW, NP23 6LE, NP23 6LF, NP23 6LH, NP23 6PY, NP23 6TS, NP23 6UZ, NP23 6WJ, NP23 6WN, NP23 6XQ, NP23 6YQ, NP3 6JB, NP3 6LE, NP3 6LF, NP3 6LH, NP3 6UZ, NP3 6YS",523,487,36
W00007609,NP23,"NP23 6JL, NP23 6JU, NP23 6JX, NP23 6LJ, NP3 6EP, NP3 6EW, NP3 6JL, NP3 6LJ, NP3 6XE",248,231,17
W00007610,NP23,"NP23 6ND, NP23 6NE, NP23 6PH, NP23 6QA, NP23 6QB, NP23 6QD, NP23 6QE, NP3 6GA, NP3 6GB, NP3 6GD, NP3 6JP, NP3 6ND, NP3 6NE, NP3 6NF, NP3 6NH, NP3 6NN, NP3 6NW, NP3 6PX, NP3 6QA, NP3 6QB, NP3 6QD",235,227,8
W00007611,NP23,"NP23 6LA, NP23 6NG, NP23 6NL, NP23 6NN, NP23 6NP, NP23 6NQ, NP23 6NW, NP3 6JS, NP3 6JU, NP3 6JX, NP3 6JZ, NP3 6NG, NP3 6NP",268,253,15
W00007606,NP23,"NP23 6PQ, NP23 6QF, NP23 6QG, NP23 6QP, NP23 6QR, NP3 6PQ, NP3 6QE, NP3 6QF, NP3 6QG, NP3 6QH, NP3 6QJ, NP3 6QL, NP3 6QN, NP3 6QP, NP3 6QQ, NP3 6QR, NP3 6QU",228,223,5
W00010337,NP25,NP25 5UT,151,136,15
W00008170,NP25,"NP25 4DJ, NP25 5HB, NP25 5HD, NP25 5HE, NP25 5HF, NP25 5HG, NP25 5HH, NP25 5HJ, NP25 5HQ, NP25 5HT, NP25 5NF, NP25 5NG, NP25 5NJ, NP25 5NL, NP25 5NN, NP25 5NP, NP25 5NQ, NP25 5NS, NP25 5NW, NP25 5PY, NP25 5PZ, NP25 5SU, NP25 5SY, NP5 3PY, NP5 4EU, NP5 4HA, NP5 4HB, NP5 4HD, NP5 4HG, NP5 4HH, NP5 4HQ, NP5 4HR, NP5 4NF, NP5 4NG, NP5 4NJ, NP5 4NL, NP5 4NN, NP5 4NQ, NP5 4NS, NP5 4NT, NP5 4NW, NP7 8UL",339,306,33
W00010348,NP25,"NP25 4EE, NP25 5UP, NP25 5UW, NP25 5UY, NP25 5UZ",383,359,24
W00010353,NP25,"NP25 5DW, NP25 5DY, NP25 5DZ, NP25 5ED, NP5 3AT, NP5 4FD",304,268,36
W00009811,NP25,"NP25 5DT, NP5 3AX",161,141,20
W00009813,NP25,"NP25 5BS, NP25 5BT, NP25 5BU, NP25 5BX, NP25 5DJ, NP25 5YB, NP25 5YE",258,238,20
W00009804,NP25,"NP25 5BY, NP25 5BZ, NP25 5DR, NP25 5DS, NP25 5GB, NP25 5GD, NP25 5YF, NP25 5YJ",446,405,41
W00010328,NP25,"NP25 5UQ, NP25 5UR, NP25 5US, NP25 5WA",259,236,23
W00009805,NP25,"NP25 5AT, NP25 5DN, NP25 5DP, NP25 5EA, NP25 5EB, NP25 5EW",248,218,30
W00009808,NP25,"NP25 5BA, NP25 5BB, NP25 5GE, NP25 5GF, NP25 5HS, NP25 5SR, NP25 5SS, NP25 5ST, NP5 3AU, NP5 3BB, NP5 3PN, NP5 3PT, NP5 4AY, NP5 4AZ, NP5 4EJ, NP5 4ER, NP5 4ES, NP5 4ET, NP5 4EY, NP5 4HS",307,290,17
W00008169,NP25,"NP25 5NH, NP25 5NR, NP25 5NT, NP25 5NU, NP25 5NX, NP25 5NY, NP25 5PW, NP25 5PX, NP25 5QA, NP25 5QB, NP25 5QD, NP25 5QE, NP25 5QF, NP25 5QG, NP25 5QH, NP25 5QQ, NP25 5SW, NP25 5SX, NP25 5SZ, NP5 3PU, NP5 3PW, NP5 3PX, NP5 3PZ, NP5 3QA, NP5 3QB, NP5 3QD, NP5 3QE, NP5 3QF, NP5 3QG, NP5 3QH, NP5 3QQ, NP5 4EL, NP5 4EN, NP5 4EW, NP5 4EX, NP5 4EZ, NP5 4HE, NP5 4HF, NP5 4NH, NP5 4NP, NP5 4NR, NP5 4NU, NP5 4NX, NP5 4NY",347,314,33
W00008097,NP25,"NP25 3AE, NP25 3DJ, NP25 3DN, NP25 3DP, NP25 3DR, NP25 3DS, NP25 3DT, NP25 3DW, NP25 3LR, NP25 3LW, NP25 3PX, NP25 3SH, NP25 3SL, NP25 3SN, NP25 3SP, NP25 3SW, NP25 3SY, NP25 3XR, NP25 3XZ, NP25 3YH, NP5 3DW, NP5 3SJ, NP5 3SL, NP5 3SN, NP5 3SP, NP5 3SW",240,232,8
W00008327,NP25,"NP25 3AD, NP25 3AF, NP25 3LN, NP25 3LQ, NP25 3LS, NP25 3LT, NP25 3LY, NP25 3LZ, NP25 3NG, NP25 3NQ, NP25 3QG, NP25 3SA, NP25 3TD, NP25 3TE, NP25 3TG, NP25 3TN, NP25 3YD, NP25 4LE, NP5 3DG, NP5 3DQ, NP5 3JP, NP5 3JT, NP5 3LH, NP5 3LS, NP5 3LT, NP5 3LX, NP5 3LY, NP5 3LZ, NP5 3NA, NP5 3NB, NP5 3NQ, NP5 3SA, NP5 3TG, NP5 3TQ, NP5 3YD, NP5 3YR, NP5 3ZY",267,243,24
W00008091,NP25,"NP25 3AU, NP25 3HS, NP25 3HW, NP25 3HZ, NP25 3JE, NP25 3NR, NP25 3NS, NP25 3NU, NP25 3NW, NP25 3PU, NP25 4BA, NP25 5DL, NP5 3HA, NP5 3HB, NP5 3HN, NP5 3HS, NP5 3HW, NP5 3NU, NP5 3NW, NP5 4AR, NP5 4AS, NP5 4AT, NP5 4AU, NP5 4BB, NP5 4DA",315,294,21
W00008092,NP25,"NP25 3GA, NP25 3GB, NP25 3GD, NP25 3GE, NP25 3HB, NP25 3HH, NP25 3HL, NP25 3HN, NP25 3HP, NP25 3HQ, NP25 3JF, NP25 3NT, NP25 3SZ, NP5 3HH, NP5 3HL, NP5 3HP, NP5 3JF, NP5 3JG, NP5 3JQ, NP5 4JZ",326,305,21
W00008093,NP25,"NP25 5LB, NP25 5LD, NP25 5LE, NP25 5LF, NP25 5QX, NP25 5QY, NP25 5QZ, NP25 5RA, NP25 5RB, NP25 5RE, NP25 5RF, NP25 5RZ, NP5 3QX, NP5 3QY, NP5 3QZ, NP5 3RA, NP5 3RB, NP5 3RD, NP5 3RE, NP5 3RF, NP5 3RZ, NP5 4LA, NP5 4LB, NP5 4LD, NP5 4LE, NP5 4LF",207,197,10
W00008207,NP25,"NP25 5AH, NP25 5BJ, NP25 5DQ, NP25 5DX, NP25 5ET, NP25 5EU, NP5 3AF, NP5 3AJ, NP5 3BQ",296,273,23
W00008206,NP25,"NP25 5AP, NP25 5AQ, NP25 5DA, NP25 5DB, NP25 5EJ, NP25 5EX, NP25 5EZ, NP25 5FB, NP25 5FL, NP25 5FP, NP25 5UH, NP5 3AP, NP5 3AQ, NP5 3EX, NP5 3EY, NP5 3EZ, NP5 3GZ, NP5 4AA, NP5 4FJ, NP5 4LG, NP5 4YW",340,303,37
W00008205,NP25,"NP25 5AG, NP25 5BG, NP25 5BN, NP25 5HA, NP5 3AL, NP5 3BG",168,156,12
W00008302,NP25,"NP25 4SQ, NP25 4SR, NP25 4TB, NP25 4TF, NP25 4TP, NP25 4TQ, NP25 4TR, NP25 4TW, NP5 4SG, NP5 4SQ, NP5 4SR, NP5 4SZ, NP5 4TA, NP5 4TB, NP5 4TD, NP5 4TE, NP5 4TF, NP5 4TG, NP5 4TH, NP5 4TJ, NP5 4TL, NP5 4TP, NP5 4TQ",225,203,22
W00008204,NP25,"NP25 4XR, NP25 5UA, NP25 5UD, NP25 5UE, NP25 5UF, NP25 5UG, NP25 5UJ, NP5 4UA, NP5 4UB, NP5 4UD, NP5 4UE, NP5 4UF, NP5 4UG, NP5 4UH, NP5 4UJ, NP5 4XE, NP5 4XN, NP5 4XQ, NP5 4XR, NP5 4XZ",264,241,23
W00008100,NP25,"NP25 5AW, NP25 5AX, NP25 5AY, NP25 5AZ, NP25 5BD, NP25 5BE, NP25 5EQ, NP25 5SD, NP5 3AY, NP5 3AZ",312,284,28
W00008304,NP25,"NP25 4AE, NP25 4AF, NP25 4AH, NP25 4AN, NP25 4AP, NP25 4AQ, NP25 4AR, NP25 4AU, NP25 4AW, NP25 4RN, NP25 4RP, NP25 4SA, NP25 4SB, NP25 4SE, NP25 4SF, NP25 4SP, NP5 4AE, NP5 4AF, NP5 4AH, NP5 4AL, NP5 4AN, NP5 4AP, NP5 4AQ, NP5 4AW, NP5 4RN, NP5 4RP, NP5 4RX, NP5 4RZ, NP5 4SB, NP5 4SE, NP5 4SF, NP5 4SP",374,346,28
W00008305,NP25,"NP25 4AG, NP25 4AJ, NP25 4AL, NP25 4RA, NP25 4RE, NP25 4RX, NP25 4RY, NP25 4RZ, NP25 4TH, NP25 4TS, NP25 4TT, NP25 4TU, NP25 4TX, NP25 4TY, NP25 4TZ, NP5 4AG, NP5 4AJ, NP5 4QB, NP5 4RY, NP5 4SA, NP5 4TS, NP5 4TT, NP5 4TU, NP5 4TX, NP5 4TY, NP5 4TZ, NP5 4XW, NP5 4YE",300,279,21
W00008306,NP25,"NP25 4AX, NP25 4AY, NP25 4NY, NP25 4NZ, NP25 4PA, NP25 4PB, NP25 4PD, NP25 4PE, NP25 4PF, NP25 4PG, NP25 4PH, NP25 4PQ, NP25 4PR, NP25 4PS, NP25 4PU, NP25 4PX, NP25 4PZ, NP25 4QB, NP25 4QF, NP25 4RB, NP25 4SD, NP25 4UA, NP25 4WP, NP5 4NZ, NP5 4PA, NP5 4PB, NP5 4PD, NP5 4PE, NP5 4PF, NP5 4PG, NP5 4PH, NP5 4PJ, NP5 4PP, NP5 4PQ, NP5 4PR, NP5 4PS, NP5 4PU, NP5 4PW, NP5 4PX, NP5 4PY, NP5 4PZ, NP5 4QD, NP5 4QE",395,360,35
W00008099,NP25,"NP25 3HE, NP25 3PF, NP25 3PG, NP25 3PH, NP25 3PL, NP25 3PP, NP25 3PQ, NP25 3PR, NP25 3SG, NP25 3SJ, NP25 3SQ, NP25 3YT, NP5 3HE, NP5 3PG, NP5 3PP, NP5 3PQ, NP5 3PR, NP5 3SG, NP5 3SH, NP5 3SQ",290,264,26
W00008203,NP25,"NP25 4BL, NP25 4DN, NP25 4DW, NP25 4HU, NP25 4HZ, NP25 4JB, NP25 4JD, NP25 4JE, NP25 4JF, NP25 4JG, NP25 4JH, NP25 4JN, NP25 4JR, NP5 4BL, NP5 4BT, NP5 4DH, NP5 4DN, NP5 4DW, NP5 4HT, NP5 4HU, NP5 4HX, NP5 4HY, NP5 4HZ, NP5 4JB, NP5 4JD, NP5 4JE, NP5 4JF, NP5 4JG, NP5 4JH, NP5 4JN, NP5 4JR",282,264,18
W00008096,NP25,"NP25 3AX, NP25 3AY, NP25 3AZ, NP25 3BS, NP25 3DX, NP25 3DY, NP25 3EH, NP25 3EX, NP25 3HF, NP25 3HG, NP25 3HJ, NP25 3NX, NP25 3NZ, NP25 3PA, NP25 3PB, NP25 3PD, NP25 3PE, NP25 3PJ, NP25 3PY, NP25 3TA, NP25 3UH, NP25 3UQ, NP25 3WQ, NP25 3WS, NP25 3WT, NP25 3WU, NP25 3WW, NP25 3WY, NP25 3WZ, NP25 3XA, NP25 3XB, NP25 3XD, NP25 3XU, NP25 3XW, NP25 3YA, NP25 3YB, NP25 3YE, NP25 3YF, NP25 3YG, NP25 3YJ, NP25 3YL, NP25 3YN, NP25 3YP, NP25 3YQ, NP25 3YS, NP25 3YU, NP25 3YW, NP25 3YX, NP25 3YY, NP25 4WA, NP25 4WR, NP25 4WU, NP25 4WW, NP25 4WX, NP25 4WY, NP25 4WZ, NP25 4XD, NP25 4XG, NP25 4XL, NP25 4XN, NP25 4XQ, NP25 4XU, NP25 4YD, NP25 4YE, NP25 4YF, NP25 4YH, NP25 4YP, NP25 4YQ, NP25 4YS, NP25 4YT, NP25 4YU, NP25 4YZ, NP25 4ZB, NP25 4ZL, NP25 5UL, NP25 5UN, NP25 5WJ, NP25 5WL, NP25 5WN, NP25 5WP, NP25 5WQ, NP25 5WR, NP25 5WS, NP25 5WT, NP25 5WU, NP25 5WW, NP25 5WX, NP25 5WY, NP25 5XA, NP25 5XL, NP25 5XP, NP25 5XR, NP25 5XT, NP25 5XZ, NP25 5YD, NP25 5YG, NP25 5YH, NP25 5YL, NP25 5YN, NP25 5YP, NP25 5YQ, NP25 5YR, NP25 5YS, NP25 5YU, NP25 5YX, NP25 5ZR, NP25 9AA, NP25 9AX, NP25 9AY, NP25 9BB, NP25 9BE, NP5 3BN, NP5 3BP, NP5 3BR, NP5 3BS, NP5 3BW, NP5 3HF, NP5 3HG, NP5 3HJ, NP5 3HQ, NP5 3HY, NP5 3HZ, NP5 3JE, NP5 3NR, NP5 3NS, NP5 3NT, NP5 3NX, NP5 3PA, NP5 3PB, NP5 3PD, NP5 3PE, NP5 3PF, NP5 3PH, NP5 3PJ, NP5 3PL, NP5 3TA, NP5 3XA, NP5 3XT, NP5 3YA, NP5 4AX, NP5 4BA, NP5 4JY, NP5 4YL",476,442,34
W00008094,NP25,"NP25 3AB, NP25 3AR, NP25 3AS, NP25 3AT, NP25 3BD, NP25 3BE, NP25 3BF, NP25 3BG, NP25 3DQ, NP25 3DU, NP25 3HD, NP25 3JG, NP25 3JJ, NP5 3HU, NP5 3HX, NP5 3JJ, NP5 4BZ, NP5 4DB, NP5 4JX",312,277,35
W00008201,NP25,"NP25 4AB, NP25 4AD, NP25 4BD, NP25 4BG, NP25 4BQ, NP25 4BR, NP25 4HT, NP25 4HX, NP25 4JJ, NP25 4JP, NP25 4JS, NP25 4PJ, NP25 4PL, NP25 4PP, NP25 4QA, NP25 4RH, NP25 4RJ, NP25 4RL, NP5 4AB, NP5 4AD, NP5 4BD, NP5 4BQ, NP5 4BU, NP5 4BX, NP5 4JJ, NP5 4JP, NP5 4JS, NP5 4PL, NP5 4QA, NP5 4RJ, NP5 4RL, NP5 4XB, NP5 4XD, NP5 4XF, NP5 4XG, NP5 4XH, NP5 4XJ, NP5 4XL, NP5 4XP, NP5 4YB, NP5 4YD, NP5 4YG, NP5 4YH, NP5 4YP, NP5 4YQ, NP5 4YR, NP5 4YS, NP5 4YT, NP5 4YU, NP5 4YX, NP5 4YY, NP5 4YZ",336,300,36
W00008200,NP25,"NP25 4AZ, NP25 4BE, NP25 4BH, NP25 4BJ, NP25 4BP, NP25 4BX, NP25 4BY, NP25 4BZ, NP25 4DP, NP25 4JL, NP25 4JQ, NP25 4JT, NP25 4YA, NP25 4YG, NP25 4YY, NP5 4BE, NP5 4BH, NP5 4BJ, NP5 4BP, NP5 4BY, NP5 4DP, NP5 4JL, NP5 4JQ, NP5 4YA, NP5 4YF, NP5 4YJ, NP5 4YN",288,261,27
W00008208,NP25,"NP25 5AR, NP25 5TN, NP25 5TR, NP25 5UB, NP5 3AR, NP5 3BJ, NP5 3DX, NP5 3ET, NP5 3EU",265,245,20
W00008104,NP25,"NP25 3BQ, NP25 3BR, NP25 3BT, NP25 3BU, NP25 3BX, NP25 3DG, NP25 3DZ, NP25 3EA, NP25 3EE, NP25 3EF, NP25 3EJ, NP25 3EN, NP25 3EQ, NP25 3ER, NP25 3EW, NP25 3NY, NP25 3PS, NP25 3TY, NP25 3UA, NP25 3UW, NP25 3UZ, NP25 3WR, NP25 3WX, NP25 3XE, NP25 3XF, NP25 3XH, NP25 3XJ, NP25 3XP, NP25 3XQ, NP25 3YR, NP25 3ZW, NP25 3ZY, NP25 4XA, NP25 4XB, NP25 4XJ, NP25 4YB, NP25 4ZW, NP25 5YA, NP25 5YZ, NP25 5ZG, NP25 9AD, NP25 9AN, NP25 9AQ, NP25 9AR, NP25 9AS, NP25 9BD, NP25 9BF, NP25 9BG, NP25 9BH, NP25 9BJ, NP25 9BL, NP25 9BN, NP25 9BP, NP25 9BQ, NP25 9BR, NP25 9BS, NP25 9BT, NP25 9BU, NP25 9BW, NP25 9BX, NP25 9BY, NP25 9BZ, NP25 9DA, NP5 3BT, NP5 3BU, NP5 3BX, NP5 3DB, NP5 3DY, NP5 3DZ, NP5 3EE, NP5 3EF, NP5 3EH, NP5 3EJ, NP5 3EL, NP5 3EN, NP5 3EP, NP5 3EW, NP5 3LR, NP5 3NY, NP5 3NZ, NP5 3UA, NP5 3UH, NP5 3UP, NP5 3UQ, NP5 3US, NP5 3UW, NP5 3XB, NP5 3XD, NP5 3XE, NP5 3XF, NP5 3XL, NP5 3XU, NP5 3XY, NP5 3YE, NP5 3YF, NP5 3YG, NP5 3YH, NP5 3YJ, NP5 3YN, NP5 3YP, NP5 3YQ, NP5 3YS, NP5 3YT, NP5 3YU, NP5 3YW",257,239,18
W00008326,NP25,"NP25 3TB, NP25 3TF, NP25 3TH, NP25 3TJ, NP25 3TL, NP5 3TH, NP5 3TJ",252,225,27
W00008212,NP25,"NP25 4DQ, NP25 4HY, NP25 5BW, NP25 5DD, NP25 5DG, NP25 5DH, NP25 5EE, NP25 5EH, NP25 5JA, NP25 5JB, NP25 5TQ, NP25 5TW, NP25 5UX, NP25 5WZ, NP5 3AH, NP5 3TN, NP5 3TP, NP5 3TR, NP5 3TS, NP5 3TY, NP5 3TZ, NP5 3XX, NP5 4DG, NP5 4DQ",348,316,32
W00008211,NP25,"NP25 5BH, NP25 5BP, NP25 5BQ, NP25 5DF, NP25 5DU, NP25 5FA, NP25 5FN, NP5 3BH, NP5 3DU, NP5 3UL, NP5 3UN, NP5 3UR, NP5 3UT, NP5 3UU, NP5 3UX, NP5 4DF",200,184,16
W00008103,NP25,"NP25 5AN, NP25 5DE, NP25 5FD, NP25 5FF, NP25 5GA, NP25 5SA, NP25 5SB, NP5 3AN, NP5 3AW, NP5 3BD, NP5 3BE, NP5 4DE, NP5 4FA, NP5 4FB, NP5 4FF, NP5 4FG, NP5 4FH",275,258,17
W00008102,NP25,"NP25 3EB, NP25 3ED, NP25 3EG, NP25 3EL, NP25 3PT, NP25 5AS, NP25 5AU, NP25 5BL, NP25 5BR, NP25 5FE, NP25 5FG, NP25 5FH, NP25 5FJ, NP5 3AS, NP5 3BA, NP5 3EQ, NP5 3PS, NP5 3XG, NP5 3XH, NP5 3XJ, NP5 3XQ, NP5 3YL, NP5 4FE",313,297,16
W00008210,NP25,"NP25 5AA, NP25 5AB, NP25 5AD, NP25 5AE, NP25 5AF, NP25 5AJ, NP25 5AL, NP25 5ER, NP25 5ES, NP25 5EY, NP5 3AA, NP5 3AB, NP5 3AD, NP5 3AE, NP5 3AG, NP5 3BL, NP5 3EG, NP5 3ER, NP5 3ES",216,205,11
W00008101,NP25,"NP25 3BW, NP25 3BY, NP25 3BZ, NP25 3DA, NP25 3DB, NP25 3DD, NP25 3DE, NP25 3DF, NP25 3DH, NP25 3DL, NP25 3UY, NP5 3BY, NP5 3BZ, NP5 3DA, NP5 3DD, NP5 3DE, NP5 3DF, NP5 3DH, NP5 3DJ, NP5 3DL, NP5 3DN, NP5 3DP, NP5 3DR, NP5 3DS, NP5 3DT, NP5 3EA, NP5 3EB, NP5 3ED, NP5 3UY, NP5 3UZ, NP5 3XN, NP5 3XP, NP5 3XR, NP5 3XS, NP5 3XW, NP5 3XZ, NP5 3YB",245,229,16
W00008209,NP25,"NP25 5EF, NP25 5EG, NP25 5EL, NP25 5TS, NP5 4DD, NP5 4EE, NP5 4EF, NP5 4EG, NP5 4EH",201,189,12
W00008324,NP25,"NP25 3JH, NP25 3JQ, NP25 3JS, NP25 3JU, NP25 3LE, NP25 3LL, NP25 3LU, NP25 4LG, NP5 3JS, NP5 3JU, NP5 3LL",235,219,16
W00008322,NP25,"NP25 3JN, NP25 3JR, NP25 3JW, NP25 3LD, NP25 3NN, NP5 3JN, NP5 3JW, NP5 3LB, NP5 3LD, NP5 3LF, NP5 3NF, NP5 3NN",283,260,23
W00008323,NP25,"NP25 3JY, NP25 3JZ, NP25 3LA, NP25 3LB, NP25 3LF, NP25 3LG, NP5 3JY, NP5 3JZ, NP5 3LA, NP5 3LE, NP5 3LG, NP5 3LU, NP5 3TL",287,263,24
W00008090,NP25,"NP25 3HR, NP25 3HT, NP25 3HU, NP25 3HX, NP25 3HY, NP25 3JD, NP25 3JL, NP5 3HD, NP5 3HR, NP5 3HT, NP5 3JA, NP5 3JB, NP5 3JD, NP5 3JH, NP5 3JL, NP5 3SZ",325,294,31
W00008320,NP25,"NP25 3JP, NP25 3JT, NP25 3JX, NP25 3LH, NP25 3LJ, NP25 3LP, NP25 3LX, NP25 3NA, NP25 3PW, NP25 3TP, NP5 3JX, NP5 3LJ, NP5 3LN, NP5 3LP, NP5 3LQ, NP5 3LW, NP5 3NG, NP5 3TB, NP5 3TD, NP5 3TE, NP5 3TF",339,310,29
W00008321,NP25,"NP25 3GZ, NP25 3NB, NP25 3ND, NP25 3NE, NP25 3NF, NP25 3NP, NP25 3PN, NP5 3JR, NP5 3ND, NP5 3NE, NP5 3NP",254,238,16
W00008300,NP25,"NP25 4AT, NP25 4SY, NP25 4SZ, NP25 4TA, NP25 4TD, NP25 4TE, NP25 4TG, NP25 4TJ, NP25 4TL, NP5 4TR, NP5 4TW",233,219,14
W00008301,NP25,"NP25 4QG, NP25 4QH, NP25 4QJ, NP25 4QL, NP25 4QN, NP25 4QP, NP25 4QQ, NP25 4QR, NP25 4QS, NP25 4QT, NP25 4QU, NP25 4QW, NP25 4QY, NP25 4QZ, NP5 4QG, NP5 4QH, NP5 4QL, NP5 4QN, NP5 4QP, NP5 4QQ, NP5 4QR, NP5 4QS, NP5 4QT, NP5 4QU, NP5 4QW, NP5 4QY, NP5 4QZ, NP5 4RA, NP5 4RB, NP5 4RE, NP5 4RF",355,333,22
W00008240,NP26,"NP26 3SE, NP26 3SG, NP26 3SH, NP26 3SJ, NP26 3SL, NP26 3SN, NP26 3UD, NP26 3UT, NP6 3SE, NP6 3SF, NP6 3SG, NP6 3SJ, NP6 3SL, NP6 3SS, NP6 3SW",298,273,25
W00008217,NP26,"NP26 5PS, NP26 5PU, NP26 5PX, NP26 5PY, NP26 5SN, NP26 5SP, NP26 5SW, NP26 5UD, NP26 5YB, NP6 4RZ, NP6 4SH, NP6 4SN, NP6 4SP, NP6 4SW, NP6 4UD, NP6 4YD, NP6 4YH, NP6 4YP, NP6 4YW",218,205,13
W00008236,NP26,"NP26 3FN, NP26 3SA, NP26 3SB, NP26 3SD, NP26 3TB, NP26 3TG, NP26 3UA, NP26 3UE, NP26 3UF, NP26 3UQ, NP26 3WA, NP26 3WF, NP6 3SA, NP6 3SB, NP6 3SH, NP6 3SN, NP6 3TB, NP6 3TD, NP6 3TE, NP6 3TF, NP6 3UA, NP6 3UB, NP6 3UE, NP6 3UQ",363,333,30
W00008237,NP26,"NP26 3UG, NP26 3UL, NP26 3UU, NP26 3UX, NP26 3UZ, NP26 3WB, NP26 3WR, NP6 3UF, NP6 3UT, NP6 3XA",341,310,31
W00008238,NP26,"NP26 3FS, NP26 3SF, NP26 3SP, NP26 3SR, NP26 3SS, NP26 3SW, NP26 3SY, NP26 3TA, NP6 3SD, NP6 3SP, NP6 3SR, NP6 3SX, NP6 3SY, NP6 3TA, NP6 3UL",328,301,27
W00008239,NP26,"NP26 3JG, NP26 3SQ, NP26 3ST, NP26 3SU, NP26 3SX, NP26 3SZ, NP26 3TF, NP26 3TH, NP26 3TJ, NP26 3TL, NP26 3TU, NP26 3TZ, NP26 3UB, NP26 3UH, NP26 3UN, NP26 3UP, NP26 3UR, NP26 3US, NP26 3UW, NP26 3UY, NP26 3YE, NP6 3JG, NP6 3ST, NP6 3SU, NP6 3SZ, NP6 3UD, NP6 3UH, NP6 3UJ, NP6 3UN, NP6 3UP, NP6 3UR, NP6 3US, NP6 3YD, NP6 3YE, NP6 3YG, NP6 3YL, NP6 3YN, NP6 3YP, NP6 3YQ, NP6 3YS, NP6 3YT, NP6 3YU, NP6 3YW, NP6 3YX, NP6 3YY, NP6 4LD, NP6 4LE, NP6 4LF, NP6 4LL",400,346,54
W00008267,NP26,"NP26 4BG, NP26 4BQ, NP26 4BW, NP26 4HX, NP26 4HY, NP26 4HZ, NP26 4JE, NP26 4LY, NP26 4PJ, NP26 4PL, NP26 4QL, NP6 4BQ, NP6 4GZ, NP6 4HR, NP6 4HX, NP6 4HY, NP6 4HZ, NP6 4QL",271,248,23
W00008089,NP26,"NP26 4DR, NP26 4DS, NP26 4DT, NP26 4DU, NP26 4DW, NP26 4DY, NP26 4EP, NP6 4DR, NP6 4DS, NP6 4DT, NP6 4ED, NP6 4GU, NP6 4QF",273,251,22
W00008219,NP26,"NP26 5TR, NP26 5TS, NP26 5TT, NP26 5TU, NP26 5TX, NP26 5TY, NP26 5TZ, NP26 5UA, NP26 5UN, NP26 5UP, NP26 5US, NP26 5UU, NP26 5XP, NP6 4TS, NP6 4TT, NP6 4TU, NP6 4TX, NP6 4TY, NP6 4TZ, NP6 4UA, NP6 4UF, NP6 4UH, NP6 4UN, NP6 4UP, NP6 4US, NP6 4UT, NP6 4XP, NP6 4XR",230,210,20
W00008087,NP26,"NP26 4DQ, NP26 4EL, NP26 4NF, NP26 4NG, NP6 4EL, NP6 4NG, NP6 4NR, NP6 4ZD, NP6 4ZF, NP6 4ZG, NP6 4ZH",285,264,21
W00008270,NP26,"NP26 4BN, NP26 4HP, NP26 4JA, NP26 5AB, NP26 5DD, NP26 5DL, NP26 5ER, NP26 5JG, NP26 5QX, NP26 5XA, NP26 5XY, NP6 4DL, NP6 4HP, NP6 4JA, NP6 4JD, NP6 4JG, NP6 4XA",291,258,33
W00008271,NP26,"NP26 5ET, NP26 5RE, NP26 5RJ, NP26 5RL, NP26 5RN, NP6 4ET, NP6 4LS, NP6 4QJ",227,214,13
W00008272,NP26,"NP26 5BY, NP26 5BZ, NP26 5DA, NP26 5DB, NP6 4BY, NP6 4BZ, NP6 4DA, NP6 4DD",288,260,28
W00008273,NP26,"NP26 5DF, NP26 5DJ, NP26 5DN, NP26 5EP, NP26 5ES, NP26 5FA, NP26 5FB, NP6 4DF, NP6 4DJ, NP6 4DN, NP6 4EP, NP6 4ER, NP6 4ES, NP6 4FA, NP6 4FB, NP6 4FD",236,223,13
W00008274,NP26,"NP26 5GA, NP26 5GB, NP26 5GE, NP26 5JH, NP26 5LS, NP6 4GA, NP6 4GB, NP6 4JE, NP6 4JH, NP6 4LT, NP6 4XU",281,258,23
W00008275,NP26,"NP26 5BW, NP26 5BX, NP26 5DE, NP26 5RA, NP6 4BX, NP6 4DE, NP6 4RA",263,243,20
W00008276,NP26,"NP26 5GD, NP26 5JE, NP26 5JF, NP26 5JP, NP26 5JQ, NP26 5PT, NP26 5PW, NP26 5RB, NP26 5RD, NP26 5RF, NP26 5RG, NP26 5RH, NP26 5XE, NP26 5XG, NP26 5YA, NP26 5YE, NP26 5YN, NP6 4RB, NP6 4RD, NP6 4RE, NP6 4RF, NP6 4RG, NP6 4RH, NP6 4RJ, NP6 4RL, NP6 4RN, NP6 4RQ, NP6 4TH, NP6 4XE, NP6 4XF, NP6 4XG",275,257,18
W00008277,NP26,"NP26 4GZ, NP26 4HR, NP26 4HS, NP26 4JL, NP6 4HS, NP6 4PJ",292,267,25
W00008115,NP26,"NP26 4DP, NP26 4EN, NP26 4EW, NP26 4EZ, NP26 4HA, NP26 4HH, NP26 4YA, NP26 4YE, NP26 4YS, NP26 4ZP, NP6 4DP, NP6 4EE, NP6 4EN, NP6 4EU, NP6 4EW, NP6 4HA, NP6 4HH, NP6 4JP, NP6 4ND, NP6 4NE, NP6 4NF, NP6 4NL, NP6 4NP",293,273,20
W00008114,NP26,"NP26 4EU, NP26 4EX, NP26 4EY, NP26 4NB, NP6 4BS, NP6 4EY, NP6 4NB",267,242,25
W00008284,NP26,"NP26 3EN, NP26 3EW, NP26 3FE, NP26 3HE, NP26 3HF, NP26 3HH, NP26 3HJ, NP26 3JZ, NP26 3NR, NP26 3PR, NP26 3PY, NP26 3PZ, NP6 3EW, NP6 3HF, NP6 3HG, NP6 3HH, NP6 3JQ",400,362,38
W00008285,NP26,"NP26 3AX, NP26 3EL, NP26 3FB, NP26 3FD, NP26 3FG, NP26 3FJ, NP26 3FQ, NP26 3FR, NP26 3FT, NP26 3FW, NP26 3FX, NP26 3QD, NP6 3BP",482,419,63
W00008286,NP26,"NP26 3EF, NP26 3HD, NP26 3PE, NP26 3PF, NP26 3PL, NP26 3PN, NP26 3PP, NP26 3PQ, NP6 3PL",312,273,39
W00010335,NP26,"NP26 5AL, NP26 5AQ, NP26 5AS, NP26 5AW, NP26 5AX, NP26 5AY, NP26 5BA, NP26 5JJ, NP6 4AQ, NP6 4AR, NP6 4AS, NP6 4AT, NP6 4AU, NP6 4AX, NP6 4AY, NP6 4BA, NP6 4NZ",191,177,14
W00008045,NP26,"NP26 4QQ, NP26 4QS, NP26 4QT, NP26 4QU, NP26 4QW, NP26 5BJ, NP6 4AP, NP6 4BJ",314,285,29
W00008047,NP26,"NP26 5AN, NP26 5AP, NP26 5AR, NP26 5AU, NP26 5AZ, NP26 5BH, NP26 5BR, NP26 5FG, NP26 5FN, NP26 5NN, NP26 5NW, NP26 5NZ, NP26 5QZ, NP26 5UQ, NP26 5UW, NP26 5UX, NP26 5WB, NP26 5XH, NP26 5XU, NP6 4AN, NP6 4AZ, NP6 4NN, NP6 4NS, NP6 4NT, NP6 4NW, NP6 4UQ, NP6 4UW, NP6 6LT",402,368,34
W00008049,NP26,"NP26 4GW, NP26 4HT, NP26 4HU, NP26 4HW, NP26 4LU, NP26 4PX, NP26 4PY, NP26 5JB, NP26 5YF, NP26 5YH, NP26 5YJ, NP26 5YL, NP26 5YS, NP26 5ZN, NP6 4HT, NP6 4HU, NP6 4HW, NP6 4JB, NP6 4PX, NP6 4PY, NP6 4PZ",365,332,33
W00008050,NP26,"NP26 4NL, NP26 4NP, NP26 4PN, NP26 4PP, NP26 5BF, NP6 4BF, NP6 4GY, NP6 4PN",191,182,9
W00008051,NP26,"NP26 4PU, NP26 4PZ, NP26 4QA, NP26 4QB, NP6 4QA, NP6 4QB",287,257,30
W00008052,NP26,"NP26 4GX, NP26 4NH, NP26 4NX, NP26 4PW, NP26 4QP, NP6 4GX, NP6 4JR, NP6 4PU, NP6 4PW, NP6 4QN, NP6 4QP, NP6 4QW",289,254,35
W00008053,NP26,"NP26 4BP, NP26 4GS, NP26 4GT, NP26 4GY, NP26 4HN, NP26 4LZ, NP26 4NA, NP26 4ND, NP26 4NE, NP26 4QN, NP6 4BP, NP6 4GW, NP6 4HN, NP6 4LU, NP6 4LX, NP6 4LY, NP6 4LZ, NP6 4NA, NP6 4PL, NP6 4PP, NP6 4XD, NP6 4XQ, NP6 4XW, NP6 4XY, NP6 4YB, NP6 4YJ, NP6 4YQ",265,247,18
W00008269,NP26,"NP26 4BR, NP26 4BS, NP26 4BT, NP26 4DH, NP26 4EQ, NP26 4FD, NP26 4FE, NP26 4FF, NP26 4QR, NP26 4RQ, NP26 4UX, NP26 4WA, NP26 4XB, NP26 4XF, NP6 4BG, NP6 4BR, NP6 4BT, NP6 4EQ, NP6 4FE, NP6 4FF, NP6 4FG, NP6 4FH, NP6 4FJ, NP6 4FL, NP6 4FN, NP6 4QR, NP6 4QS, NP6 4QT, NP6 4QU, NP6 4QX, NP6 4QY, NP6 4QZ, NP6 4XB, NP6 4YE, NP6 4YF, NP6 4YG, NP6 4YL, NP6 4YN, NP6 4YR",268,252,16
W00008055,NP26,"NP26 4PR, NP26 4QG, NP26 4QH, NP6 4BE, NP6 4QG, NP6 4QH, NP6 4QQ",284,255,29
W00008056,NP26,"NP26 4JR, NP26 4NJ, NP26 4NN, NP26 4NQ, NP26 4NR, NP6 4NH, NP6 4NQ, NP6 4NX",208,176,32
W00008287,NP26,"NP26 3FH, NP26 3PA, NP26 3PD, NP26 3PG, NP26 3PH, NP26 3PJ, NP26 3PU, NP26 3TD, NP26 3TE, NP6 3EL",339,305,34
W00008085,NP26,"NP26 4DG, NP26 4EE, NP26 4EF, NP26 4EG, NP26 4EH, NP6 4DG, NP6 4DQ, NP6 4EF, NP6 4EG",251,229,22
W00008216,NP26,"NP26 5RP, NP26 5RY, NP26 5SE, NP26 5SF, NP26 5TJ, NP26 5TL, NP26 5UE, NP6 4RP, NP6 4RS, NP6 4RT, NP6 4RU, NP6 4RW, NP6 4RX, NP6 4RY, NP6 4SB, NP6 4SD, NP6 4SE, NP6 4SF, NP6 4TL, NP6 6RS, NP6 6RT, NP6 6RU, NP6 6RX",358,327,31
W00008086,NP26,"NP26 4AG, NP26 4DX, NP26 4EJ, NP26 4HL, NP26 4JP, NP26 4QD, NP26 4QE, NP6 4DU, NP6 4DW, NP6 4DX, NP6 4DY, NP6 4EJ, NP6 4GT, NP6 4QE",296,275,21
W00008044,NP26,"NP26 3AR, NP26 3AS, NP26 3AT, NP26 3AU, NP26 3BD, NP26 3BP, NP26 5AH, NP26 5AJ, NP26 5BB, NP26 5BD, NP26 5BQ, NP26 5PB, NP26 5PE, NP26 5PF, NP26 5PG, NP26 5PH, NP26 5PJ, NP26 5PQ, NP6 3AB, NP6 3AR, NP6 3AS, NP6 3AT, NP6 3AU, NP6 4AH, NP6 4AJ, NP6 4AL, NP6 4AW, NP6 4BB, NP6 4BD, NP6 4EB, NP6 4JJ, NP6 4PB, NP6 4PD, NP6 4PE, NP6 4PF, NP6 4PG, NP6 4PH, NP6 4PQ",292,271,21
W00008088,NP26,"NP26 4AL, NP26 4DZ, NP26 4EA, NP26 4EB, NP26 4ED, NP6 4DZ, NP6 4EA, NP6 4NJ",299,277,22
W00008215,NP26,"NP26 5AA, NP26 5AD, NP26 5PR, NP26 5RT, NP26 5SB, NP26 5SD, NP26 5SQ, NP26 5UR, NP26 5YG, NP26 5YR, NP26 5YT, NP26 5YW, NP6 4SL, NP6 4SQ",298,279,19
W00010340,NP26,"NP26 5AF, NP26 5AG, NP26 5AT, NP26 5BL, NP26 5BN, NP26 5BP, NP26 5NU, NP26 5NX, NP26 5NY, NP26 5XL, NP6 4NU, NP6 4NY, NP6 4XH, NP6 4XJ, NP6 4XL",461,403,58
W00008213,NP26,"NP26 5RU, NP26 5RW, NP26 5RX, NP26 5SZ, NP26 5TN, NP26 5TP, NP26 5TW, NP26 5UB, NP26 5UF, NP26 5UG, NP26 5UH, NP26 5UJ, NP6 4SZ, NP6 4TA, NP6 4TN, NP6 4TP, NP6 4TR, NP6 4TW, NP6 4UB, NP6 4UG, NP6 4UJ, NP6 4UU, NP6 4UX, NP6 4UY, NP6 4UZ",304,282,22
W00008523,NP26,"NP26 3AA, NP26 3AB, NP26 3AE, NP26 3AF, NP26 3AH, NP26 3AJ, NP26 3BT, NP26 3GB, NP26 3JS, NP6 2AF, NP6 3AA, NP6 3AE, NP6 3AF, NP6 3AG, NP6 3AH, NP6 3AJ, NP6 3BD",241,222,19
W00008113,NP26,"NP26 4HB, NP26 4HD, NP26 4HE, NP26 4HF, NP26 4HG, NP26 4HJ, NP26 4HQ, NP6 4EX, NP6 4EZ, NP6 4HD, NP6 4HF, NP6 4HG, NP6 4HQ",291,268,23
W00008185,NP26,"NP26 3BW, NP26 3DL, NP26 3DQ, NP26 3EJ, NP26 3EX, NP26 3FA, NP26 3HA, NP26 3HB, NP26 3HR, NP26 3LZ, NP26 3UJ, NP6 3BW, NP6 3DJ, NP6 3DQ, NP6 3EJ, NP6 3EN, NP6 3EX, NP6 3HA, NP6 3HB, NP6 3LY, NP6 3LZ",275,241,34
W00008186,NP26,"NP26 3NB, NP26 3NE, NP26 3NF, NP26 3NG, NP26 3NY, NP26 3NZ, NP6 3HP, NP6 3JB, NP6 3NA, NP6 3NB, NP6 3NE, NP6 3NF",295,265,30
W00008187,NP26,"NP26 3EH, NP26 3EY, NP26 3FL, NP26 3JN, NP26 3LS, NP26 3LT, NP26 3PB, NP6 3EF, NP6 3EH, NP6 3EY, NP6 3HD, NP6 3HE, NP6 3HQ, NP6 3JH, NP6 3LS, NP6 3LT, NP6 3PA, NP6 3PB, NP6 3PD, NP6 3PE, NP6 3PF, NP6 3PG, NP6 3PH, NP6 3PJ, NP6 3PN, NP6 3PP, NP6 3PQ, NP6 3PR, NP6 3PS, NP6 3PT, NP6 3PU, NP6 3PW, NP6 3PZ, NP6 3QA, NP6 3QB, NP6 3QD, NP6 3QE, NP6 3QF",309,283,26
W00008214,NP26,"NP26 5RS, NP26 5RZ, NP26 5SA, NP26 5SG, NP26 5SH, NP26 5SJ, NP26 5SL, NP26 5TH, NP26 5TQ, NP26 5UL, NP6 4SA, NP6 4SG, NP6 4SJ, NP6 4TJ, NP6 4TQ, NP6 4UE, NP6 4UL, NP6 4UR",419,371,48
W00008191,NP26,"NP26 3EG, NP26 3EQ, NP26 3ER, NP26 3ES, NP26 3ET, NP26 3EZ, NP26 3HQ, NP26 3JH, NP26 3LY, NP6 3DH, NP6 3EG, NP6 3EP, NP6 3ER, NP6 3ES, NP6 3ET, NP6 3EZ, NP6 3FA, NP6 3FB, NP6 3FD, NP6 3FE, NP6 3HL, NP6 3HR, NP6 3JJ, NP6 3JN",297,264,33
W00008188,NP26,"NP26 3AL, NP26 3AP, NP26 3BB, NP26 3DB, NP26 3DD, NP26 3DG, NP26 3DH, NP26 3DJ, NP26 3DN, NP26 3DP, NP26 3DR, NP26 3DW, NP26 3EB, NP26 3ED, NP26 3EE, NP26 3QP, NP26 3RA, NP26 3YL, NP26 3YN, NP26 3YS, NP6 3AL, NP6 3AP, NP6 3BB, NP6 3DB, NP6 3DL, NP6 3DN, NP6 3DP, NP6 3DW, NP6 3EB, NP6 3ED, NP6 3EE, NP6 3EQ, NP6 3HJ, NP6 3HT, NP6 3JA, NP6 3JZ",205,189,16
W00008193,NP26,"NP26 3JJ, NP26 3JW, NP26 3LU, NP26 3LW, NP26 3NW, NP6 3LQ, NP6 3LR, NP6 3LU, NP6 3LW, NP6 3LX, NP6 3NS, NP6 3NT",257,233,24
W00008192,NP26,"NP26 3JP, NP26 3LE, NP26 3LF, NP26 3LX, NP6 3HX, NP6 3JL, NP6 3JP, NP6 3LF, NP6 3NG",306,274,32
W00010319,NP26,"NP26 5SR, NP26 5SS, NP26 5ST, NP26 5SU, NP26 5SX, NP26 5SY, NP26 5TA, NP26 5TE, NP26 5TF, NP26 5TG, NP6 4SR, NP6 4SY, NP6 4TB",308,280,28
W00010320,NP26,"NP26 5TB, NP26 5TD, NP26 5UY, NP26 5UZ, NP26 5WA, NP26 5WE, NP26 5XT, NP6 4SS, NP6 4ST, NP6 4SU, NP6 4SX, NP6 4TD, NP6 4TE, NP6 4TF, NP6 4TG, NP6 4XS, NP6 4XT, NP6 4XX, NP6 4XZ",291,267,24
W00008189,NP26,"NP26 3BX, NP26 3HG, NP26 3JL, NP26 3JT, NP26 3LL, NP26 3LQ, NP26 3YP, NP26 3YR, NP26 3YT, NP26 3YW, NP26 3YX, NP26 3ZB, NP26 3ZD, NP6 3BX, NP6 3BY, NP6 3DG, NP6 3JT, NP6 3JW, NP6 3JX, NP6 3LL, NP6 3LN, NP6 3YB, NP6 3YF, NP6 3YH, NP6 3YJ, NP6 3YR",226,209,17
W00010324,NP26,"NP26 4JB, NP26 4JD, NP26 4PF, NP26 4PG, NP26 4PH, NP26 4PQ, NP26 4PS, NP26 4PT, NP26 4QZ, NP26 4RA, NP26 4RB, NP26 4RD, NP6 4JS, NP6 4PR, NP6 4PS, NP6 4PT",558,486,72
W00008569,NP26,"NP26 3DE, NP26 3DF, NP26 3DS, NP26 3DT, NP26 3DU, NP26 3DX, NP26 3DY, NP26 3DZ, NP26 3EA, NP26 3TS, NP26 3WN, NP6 3DD, NP6 3DE, NP6 3DF, NP6 3DR, NP6 3DS, NP6 3DT, NP6 3DU, NP6 3DX, NP6 3DY, NP6 3DZ, NP6 3EA",208,198,10
W00008195,NP26,"NP26 3EP, NP26 3EU, NP26 3GU, NP26 3HN, NP26 3HS, NP26 3HU, NP26 3HY, NP26 3LB, NP26 3LD, NP26 3LN, NP26 3LP, NP6 3EU, NP6 3HN, NP6 3HU, NP6 3HY, NP6 3LB, NP6 3LD, NP6 3LE, NP6 3LP",210,197,13
W00008194,NP26,"NP26 3PS, NP26 3PT, NP26 3PW, NP26 3QA, NP26 3QB, NP26 3QE, NP26 3QF",304,267,37
W00008197,NP26,"NP26 3BY, NP26 3BZ, NP26 3HP, NP26 3HW, NP26 3HX, NP26 3JB, NP26 3JD, NP26 3JE, NP26 3LG, NP26 3NX, NP6 3BZ, NP6 3HW, NP6 3JD, NP6 3JE, NP6 3LG",276,259,17
W00008268,NP26,"NP26 4JS, NP26 4RS, NP26 5JD, NP26 5LT, NP26 5LX, NP26 5QJ, NP6 4GD, NP6 4JF, NP6 4JL, NP6 4JQ",269,235,34
W00008319,NP26,"NP26 4AE, NP26 4LD, NP26 4LE, NP26 4LJ, NP26 4LL, NP26 4LN, NP6 4AE, NP6 4AF, NP6 4EH",315,288,27
W00008520,NP26,"NP26 3AY, NP26 3AZ, NP26 3BA, NP26 3BE, NP26 3BG, NP26 3BH, NP26 3BJ, NP26 3BL, NP26 3BN, NP26 3BQ, NP26 3BR, NP26 3BS, NP26 3FF, NP26 3YD, NP6 3AX, NP6 3AY, NP6 3BA, NP6 3BE, NP6 3BG, NP6 3BJ, NP6 3BL, NP6 3BN, NP6 3BQ, NP6 3BR, NP6 3BS, NP6 3YA",376,352,24
W00010327,NP26,"NP26 5NS, NP26 5NT",113,109,4
W00008521,NP26,"NP26 3AD, NP26 3AG, NP26 3JF, NP6 3AD, NP6 3BT, NP6 3JF",274,259,15
W00008318,NP26,"NP26 4AF, NP26 4LF, NP26 4LH, NP26 4LQ, NP26 4LR, NP26 4QY, NP26 5LG, NP6 4AG, NP6 4HL, NP6 4LG, NP6 4LH, NP6 4LQ, NP6 4LR, NP6 4QD",337,304,33
W00008317,NP26,"NP26 4JY, NP26 4JZ, NP26 4LA, NP26 4LB, NP26 4LG, NP26 4LP, NP26 4LW, NP6 4AD, NP6 4JZ, NP6 4LA, NP6 4LB, NP6 4LJ, NP6 4LN, NP6 4LP, NP6 4LW",265,246,19
W00008196,NP26,"NP26 3HL, NP26 3HT, NP26 3HZ, NP26 3JA, NP26 3LA, NP26 3LH, NP26 3LJ, NP26 3NH, NP26 3NJ, NP26 3PX, NP6 3HS, NP6 3HZ, NP6 3LA, NP6 3LH, NP6 3LJ",340,312,28
W00008190,NP26,"NP26 3BU, NP26 3FP, NP26 3GF, NP26 3GG, NP26 3GH, NP26 3NA, NP26 3ND, NP26 3QG, NP26 3QH, NP6 3BU, NP6 3ND",458,415,43
W00008316,NP26,"NP26 3WD, NP26 3WJ, NP26 3WL, NP26 3WP, NP26 3WQ, NP26 3WS, NP26 3WT, NP26 3WU, NP26 3WW, NP26 3WX, NP26 3WY, NP26 3WZ, NP26 3YA, NP26 3YB, NP26 3YF, NP26 3YG, NP26 3YH, NP26 3YJ, NP26 3YQ, NP26 3YU, NP26 3YY, NP26 3YZ, NP26 3ZA, NP26 3ZE, NP26 3ZF, NP26 3ZG, NP26 3ZH, NP26 3ZJ, NP26 3ZL, NP26 3ZR, NP26 3ZW, NP26 3ZX, NP26 4AA, NP26 4AB, NP26 4AD, NP26 4AH, NP26 4AJ, NP26 4BH, NP26 4BU, NP26 4JX, NP26 4QF, NP26 4WB, NP26 4WR, NP26 4WX, NP26 4WY, NP26 4WZ, NP26 4XW, NP26 4YB, NP26 4YD, NP26 4YF, NP26 4YG, NP26 4YH, NP26 4YJ, NP26 4YL, NP26 4YN, NP26 4YP, NP26 4YQ, NP26 4YR, NP26 4YY, NP26 4ZB, NP26 4ZJ, NP26 4ZU, NP26 4ZX, NP26 5AE, NP26 5BG, NP26 5FH, NP26 5WD, NP26 5WS, NP26 5WT, NP26 5WU, NP26 5WW, NP26 5WX, NP26 5WY, NP26 5WZ, NP26 5XJ, NP26 5XQ, NP26 5XR, NP26 5YD, NP26 5YP, NP26 5YQ, NP26 5YU, NP26 5YX, NP26 5YY, NP26 5YZ, NP26 5ZA, NP26 5ZB, NP26 5ZE, NP26 5ZG, NP26 5ZH, NP26 5ZJ, NP26 5ZQ, NP26 5ZU, NP26 9AB, NP26 9AG, NP26 9AH, NP26 9AJ, NP26 9AL, NP26 9AN, NP26 9AP, NP26 9AQ, NP26 9AR, NP26 9AS, NP26 9AT, NP26 9AU, NP26 9AW, NP26 9AX, NP26 9AY, NP26 9AZ, NP26 9BA, NP26 9BB, NP26 9BD, NP26 9BE, NP26 9BF, NP26 9BG, NP26 9BH, NP26 9BJ, NP26 9BL, NP26 9BN, NP26 9BP, NP26 9BQ, NP26 9BR, NP26 9BS, NP26 9BT, NP26 9BU, NP26 9BW, NP26 9BY, NP26 9BZ, NP26 9DB, NP26 9DD, NP26 9DE, NP26 9DF, NP6 4AA, NP6 4AB, NP6 4BH, NP6 4DB, NP6 4DH, NP6 4HB, NP6 4HE, NP6 4HJ, NP6 4JX, NP6 4JY, NP6 4XN, NP6 4YA, NP6 4YS, NP6 4YT, NP6 4YU, NP6 4YX, NP6 4YY, NP6 4ZA, NP6 4ZB, NP6 4ZE, NP6 4ZJ, NP6 4ZN",386,341,45
W00008522,NP26,"NP26 3AN, NP26 3AQ, NP26 3AW, NP26 3JQ, NP26 3JR, NP6 3AN, NP6 3AQ, NP6 3AW, NP6 3JR, NP6 3JS",198,183,15
W00008315,NP26,"NP26 4FJ, NP26 4FL, NP26 4GU, NP26 4JN, NP26 4JT, NP26 4JU, NP26 4JW, NP6 4BL, NP6 4BN, NP6 4BU, NP6 4BW, NP6 4JN, NP6 4JT, NP6 4JU, NP6 4JW",305,291,14
W00008199,NP26,"NP26 3JX, NP26 3LR, NP26 3NQ, NP26 3NT, NP26 3NU, NP6 3NU, NP6 3NX, NP6 3NY",268,245,23
W00008198,NP26,"NP26 3JU, NP26 3JY, NP26 3NL, NP26 3NN, NP26 3NP, NP26 3NS, NP6 3JU, NP6 3JY, NP6 3NH, NP6 3NJ, NP6 3NL, NP6 3NN, NP6 3NP, NP6 3NQ, NP6 3NR, NP6 3NW",220,202,18
W00010352,NP26,"NP26 4QJ, NP26 4RE, NP26 4RF, NP26 4RL, NP26 5BE",245,218,27
W00008137,NP3,"NP3 4YB, NP7 0AQ, NP7 0BQ, NP7 0BR, NP7 0EF, NP7 0HN, NP7 0HP, NP7 0HR, NP7 0HS, NP7 0HT, NP7 0HU, NP7 0HY, NP7 0LA, NP7 0LB, NP7 0LF, NP7 0LG, NP7 0LH, NP7 0LL, NP7 0LN, NP7 0LP, NP7 0NG, NP7 0NL, NP7 0NT, NP7 0RB, NP7 0RD, NP7 0RR",344,312,32
W00007887,NP4,"NP4 0LZ, NP4 0NJ, NP4 0NL, NP4 0NQ, NP4 0PF",281,254,27
W00007753,NP4,"NP4 7AR, NP4 7AU, NP4 7AW, NP4 7AY, NP4 7DJ, NP4 7DL, NP4 7DN, NP4 7DS, NP4 7DU, NP4 7DX, NP4 7DY, NP4 8PG",265,237,28
W00007888,NP4,"NP4 0QG, NP4 0QN, NP4 0QP, NP4 0QR, NP4 0QT",185,178,7
W00007744,NP4,"NP4 7EJ, NP4 7HY, NP4 7HZ, NP4 7JJ, NP4 7NR, NP4 7QR, NP4 7QZ, NP4 7RA, NP4 7RB, NP4 7RD, NP4 7RE, NP4 7RF, NP4 7RG, NP4 7RH, NP4 7RJ, NP4 7RL, NP4 7RQ",336,301,35
W00007742,NP4,"NP4 7AS, NP4 7EA, NP4 7EB, NP4 7EF, NP4 7EH, NP4 7EQ, NP4 7HA, NP4 7HB",331,301,30
W00007743,NP4,"NP4 7AA, NP4 7AB, NP4 7AE, NP4 7AF, NP4 7AH, NP4 7AJ, NP4 7AQ, NP4 7BB, NP4 7DZ, NP4 7EG, NP4 7EL, NP4 7EN, NP4 7EP, NP4 7HH",320,281,39
W00007745,NP4,"NP4 7JE, NP4 7JF, NP4 7LH, NP4 7LZ, NP4 7NL, NP4 7NP, NP4 7NU, NP4 7QJ, NP4 7QS, NP4 7QT, NP4 7RN, NP4 7RP, NP4 7YB",268,242,26
W00007746,NP4,"NP4 7PH, NP4 8PD, NP4 8PS, NP4 8PU, NP4 8QE, NP4 8QF, NP4 8QG, NP4 8QH, NP4 8QJ, NP4 8QQ, NP4 8QT, NP4 8XJ",293,272,21
W00007747,NP4,"NP4 7JP, NP4 7JQ, NP4 7JR, NP4 7NW, NP4 7NY, NP4 7NZ, NP4 7PA, NP4 7PB, NP4 7PD, NP4 7PE, NP4 7PF, NP4 7PG, NP4 7PJ, NP4 7PQ, NP4 7PT, NP4 7PU, NP4 7YF, NP4 7YJ, NP4 7YL, NP4 7YP, NP4 8PY, NP4 8PZ, NP4 8QB",318,274,44
W00009800,NP4,"NP4 5SX, NP4 5SY",419,361,58
W00007748,NP4,"NP4 6TD, NP4 6TG, NP4 6TH, NP4 6TQ, NP4 7AN, NP4 7DH, NP4 7DQ, NP4 8PE, NP4 8PF, NP4 8PJ, NP4 8QD, NP4 8QL, NP4 8QN, NP4 8QP, NP4 8QW, NP4 8XG, NP4 8XQ, NP4 8XR",279,263,16
W00007749,NP4,"NP4 7EE, NP4 7EU, NP4 7HD, NP4 7HP, NP4 7HR, NP4 7HU, NP4 7HW, NP4 7JG, NP4 7JS, NP4 7JU, NP4 7LA, NP4 7LB",302,272,30
W00007750,NP4,"NP4 7HT, NP4 7HX, NP4 7JA, NP4 7JB, NP4 7JD, NP4 7JL, NP4 7JX, NP4 7JY, NP4 7JZ, NP4 7LD",243,224,19
W00007751,NP4,"NP4 7AP, NP4 7DP, NP4 7DR, NP4 7DT, NP4 7DW, NP4 7HE, NP4 7HF, NP4 7HG, NP4 7HJ, NP4 7HL, NP4 7HN, NP4 7HQ, NP4 7HS, NP4 7JN, NP4 7JT, NP4 7JW, NP4 7LE",384,338,46
W00007886,NP4,"NP4 0QQ, NP4 0QS, NP4 0RP, NP4 0RS, NP4 0RT, NP4 0RW",230,221,9
W00007752,NP4,"NP4 7DF, NP4 8PL, NP4 8PN, NP4 8PP, NP4 8PQ, NP4 8PR, NP4 8PT, NP4 8PW, NP4 8PX, NP4 8QA, NP4 8QR, NP4 8QS, NP4 8RL, NP4 8RN",278,263,15
W00007889,NP4,"NP4 0PH, NP4 0PQ, NP4 0PT, NP4 0QH, NP4 0QL, NP4 0RN, NP4 0SU, NP4 0SW, NP4 0TW, NP4 0YA, NP4 0YN, NP4 0YY",271,248,23
W00007885,NP4,"NP4 0LX, NP4 0LY, NP4 0NG, NP4 0NN, NP4 0NP, NP4 0NW",244,234,10
W00007893,NP4,"NP4 0PJ, NP4 0PW, NP4 0PX, NP4 0PZ, NP4 0QE, NP4 0QF",252,236,16
W00007755,NP4,"NP4 7TE, NP4 7TF, NP4 7TG, NP4 7TH, NP4 7TJ, NP4 7TN, NP4 7TQ, NP4 7TR, NP4 7TS, NP4 7TT, NP4 7TU",329,288,41
W00008105,NP4,"NP4 0AS, NP4 0AT, NP4 0BG, NP4 0BH, NP4 0BP, NP4 0BQ",330,304,26
W00008106,NP4,"NP4 0AA, NP4 0AJ, NP4 0AU, NP4 0AW, NP4 0AX, NP4 0AY, NP4 0BD",301,271,30
W00008107,NP4,"NP4 0HE, NP4 0HF, NP4 0HG, NP4 0HH, NP4 0HJ, NP4 0HN, NP4 0HS, NP4 0HT, NP4 0HU, NP4 0HW, NP4 0JE, NP4 8RS, NP4 8RW, NP4 8RX, NP4 8SE, NP4 8SF, NP4 8UP",243,220,23
W00008108,NP4,"NP4 0HA, NP4 0HB, NP4 0HL, NP4 0HP, NP4 0HQ, NP4 0HR, NP4 0HX, NP4 0HY, NP4 0UD",298,266,32
W00008110,NP4,"NP4 0AD, NP4 0BJ, NP4 0JD, NP4 0JF, NP4 0JG, NP4 0JH, NP4 0JJ, NP4 8QY, NP4 8QZ, NP4 8RA, NP4 8RB, NP4 8RD, NP4 8RE, NP4 8RF, NP4 8RG, NP4 8RH, NP4 8RJ, NP4 8RQ, NP4 8RZ, NP4 8SA, NP4 8SG, NP4 8SJ, NP4 8SN, NP4 8TP, NP4 8TS, NP4 8TT",285,257,28
W00008111,NP4,"NP4 0AB, NP4 0AZ, NP4 0BB, NP4 0BE, NP4 0BR, NP4 0BS",271,242,29
W00008112,NP4,"NP4 0AF, NP4 0AH, NP4 0AL, NP4 0AN, NP4 0AP, NP4 0AQ, NP4 0AR, NP4 0BA, NP4 0BL, NP4 0BW, NP4 0DB, NP4 0DD, NP4 0DL, NP4 0YE, NP4 8RY, NP4 8SB, NP4 8SH, NP4 8SL, NP4 8SP, NP4 8SQ, NP4 8SS, NP4 8ST, NP4 8SU, NP4 8SX, NP4 8SY, NP4 8SZ, NP4 8TA, NP4 8TB, NP4 8TD, NP4 8TE, NP4 8TF, NP4 8TG, NP4 8TH, NP4 8TJ, NP4 8TL, NP4 8TN, NP4 8TQ, NP4 8TW, NP4 8XN, NP4 8XW",460,418,42
W00007872,NP4,"NP4 2AD, NP4 2AE, NP4 2AF, NP4 2AG, NP4 2AH, NP4 2AL, NP4 2AN, NP4 2AP, NP4 2AQ, NP4 2AR, NP4 2AS, NP4 2AT, NP4 2AU, NP4 2AW, NP4 2AX, NP4 2AY, NP4 2AZ, NP4 2BA, NP4 2BB, NP4 2BD, NP4 2BE, NP4 2BG, NP4 2BH, NP4 2BL, NP4 2BQ, NP4 2BU, NP4 2BX, NP4 2BY, NP4 2BZ, NP4 2DA, NP4 2DB, NP4 2DE, NP4 2DF, NP4 2DG, NP4 2DH, NP4 2DJ, NP4 2DL, NP4 2DP, NP4 2DQ, NP4 2DU, NP4 2DX, NP4 2DY, NP4 2DZ, NP4 2EA, NP4 2EB, NP4 2ED, NP4 2EE, NP4 2EF, NP4 2EG, NP4 2EH, NP4 2EJ, NP4 2EL, NP4 2EN, NP4 2EP, NP4 2EQ, NP4 2ER, NP4 2ES, NP4 2ET, NP4 2EU, NP4 2EW, NP4 2EX, NP4 2EY, NP4 2EZ, NP4 2HA, NP4 2HB, NP4 2HD, NP4 2HE, NP4 2HF, NP4 2HG, NP4 2HH, NP4 2HJ, NP4 2HN, NP4 2HP, NP4 2HR, NP4 2HS, NP4 2HT, NP4 2HU, NP4 2HW, NP4 2HX, NP4 2HY, NP4 2HZ, NP4 2JA, NP4 2JB, NP4 2JD, NP4 2JE, NP4 2JF, NP4 2JG, NP4 2JH, NP4 2JJ, NP4 2JL, NP4 2JQ, NP4 2JX, NP4 2JY, NP4 2JZ, NP4 2LD, NP4 2LE, NP4 2LF, NP4 2LG, NP4 2LH, NP4 2LJ, NP4 2LL, NP4 2LN, NP4 2LP, NP4 2LQ, NP4 2LR, NP4 2LS, NP4 2LT, NP4 2LU, NP4 2LX, NP4 2NB, NP4 2ND, NP4 2NE, NP4 2NF, NP4 2NG, NP4 2NH, NP4 2NJ, NP4 2NL, NP4 2NN, NP4 2NP, NP4 2NQ, NP4 2NR, NP4 2NS, NP4 2NT, NP4 2NU, NP4 2NW, NP4 2NX, NP4 2NY, NP4 2NZ, NP4 2PA, NP4 2PB, NP4 2PD, NP4 2PE, NP4 2PF, NP4 2PH, NP4 2PN, NP4 2PQ, NP4 2PR, NP4 2PT, NP4 2PU, NP4 2PW, NP4 2PX, NP4 2PY, NP4 2PZ, NP4 2QA, NP4 2QB, NP4 2QD, NP4 2QE, NP4 2QF, NP4 2QG, NP4 2QH, NP4 2QJ, NP4 2QL, NP4 2QN, NP4 2QP, NP4 2QQ, NP4 2QR, NP4 2QS, NP4 2QT, NP4 2QU, NP4 2QW, NP4 2QX, NP4 2RA, NP4 2RB, NP4 2RD, NP4 2RE, NP4 2RF, NP4 2RG, NP4 2RH, NP4 2RJ, NP4 2RL, NP4 2RN, NP4 2RP, NP4 2RQ, NP4 2RR, NP4 2RS, NP4 2RT, NP4 2RU, NP4 2RW, NP4 2RX, NP4 2RY, NP4 2RZ, NP4 2SA, NP4 2SB, NP4 2SD, NP4 2SE, NP4 2SF, NP4 2SG, NP4 2SH, NP4 2SJ, NP4 2SL, NP4 2SR, NP4 2SS, NP4 2ST, NP4 2SU, NP4 2SX, NP4 2SY, NP4 2SZ, NP4 2TA, NP4 2TB, NP4 2TD, NP4 2TE, NP4 2TF, NP4 2TG, NP4 2TH, NP4 2TJ, NP4 2TL, NP4 2TN, NP4 2TP, NP4 2TQ, NP4 2TT, NP4 2TU, NP4 2TX, NP4 2TY, NP4 2TZ, NP4 2UA, NP4 2UB, NP4 2UE, NP4 2UF, NP4 2UG, NP4 2UH, NP4 2UJ, NP4 2UL, NP4 2UN, NP4 2UP, NP4 2UQ, NP4 2UR, NP4 2US, NP4 2UT, NP4 2UU, NP4 2UW, NP4 2WA, NP4 2XB, NP4 2XD, NP4 2XE, NP4 2XF, NP4 2XG, NP4 2XH, NP4 2XJ, NP4 2XR, NP4 2XS, NP4 2YA, NP4 2YB, NP4 2YD, NP4 2YE, NP4 2YF, NP4 2YG, NP4 2YH, NP4 2YJ, NP4 2YL, NP4 2YN, NP4 2YP, NP4 2YQ, NP4 2YR, NP44 2AG, NP44 2AQ, NP44 2DF, NP44 2WN, NP44 2XA, NP44 2XH, NP44 2XJ, NP44 2XP, NP44 2XR, NP44 2XS, NP44 2ZA, NP44 8RA, NP44 8RB, NP44 8RE, NP44 8RG, NP44 8RQ, NP44 8SR, NP44 9SA",274,260,14
W00010354,NP4,"NP4 5FH, NP4 5YL, NP4 5YN, NP44 2YQ",332,285,47
W00007823,NP4,"NP4 4AR, NP4 4AS, NP4 4AT, NP4 4AU, NP4 4AX, NP4 4AZ, NP4 4EF, NP4 4EG, NP4 4EH, NP4 4EJ, NP4 4EL, NP4 4EN, NP4 4EP, NP4 4EQ, NP4 4EU, NP4 4EW, NP4 4EX, NP4 4EY, NP4 4EZ, NP4 4FJ, NP4 4FL, NP4 4FN, NP4 4FP, NP4 4FQ, NP4 4FR, NP4 4FS, NP4 4FT, NP4 4FU, NP4 4FW, NP4 4GA, NP4 4GB, NP4 4GD, NP4 4GE, NP4 4GF, NP4 4GG, NP4 4GH, NP4 4HA, NP4 4HB, NP4 4HD, NP4 4HE, NP4 4HF, NP4 4HG, NP4 4HH, NP4 4HJ, NP4 4HL, NP4 4HN, NP4 4HP, NP4 4HQ, NP4 4HR, NP4 4HS, NP4 4HT, NP4 4HU, NP4 4HW, NP4 4HX, NP4 4HY, NP4 4HZ, NP4 4JA, NP4 4JB, NP4 4JD, NP4 4JE, NP4 4JF, NP4 4JG, NP4 4JH, NP4 4JJ, NP4 4JL, NP4 4JN, NP4 4JP, NP4 4JQ, NP4 4JR, NP4 4JS, NP4 4JT, NP4 4JU, NP4 4JW, NP4 4JX, NP4 4JY, NP4 4JZ, NP4 4LA, NP4 4LB, NP4 4LD, NP4 4LE, NP4 4LF, NP4 4LG, NP4 4LH, NP4 4LJ, NP4 4LL, NP4 4LN, NP4 4LP, NP4 4LQ, NP4 4LR, NP4 4LS, NP4 4LT, NP4 4LU, NP4 4LW, NP4 4LX, NP4 4LY, NP4 4LZ, NP4 4NA, NP4 4NB, NP4 4ND, NP4 4NE, NP4 4NF, NP4 4NG, NP4 4NH, NP4 4NJ, NP4 4NL, NP4 4NN, NP4 4NP, NP4 4NQ, NP4 4NR, NP4 4NS, NP4 4NT, NP4 4NU, NP4 4NW, NP4 4NX, NP4 4NY, NP4 4NZ, NP4 4PA, NP4 4PB, NP4 4PD, NP4 4PE, NP4 4PF, NP4 4PG, NP4 4PH, NP4 4PJ, NP4 4PL, NP4 4PN, NP4 4PP, NP4 4PQ, NP4 4PR, NP4 4PS, NP4 4PT, NP4 4PU, NP4 4PW, NP4 4PX, NP4 4PY, NP4 4PZ, NP4 4QA, NP4 4QB, NP4 4QD, NP4 4QE, NP4 4QF, NP4 4QG, NP4 4QH, NP4 4QJ, NP4 4QL, NP4 4QN, NP4 4QP, NP4 4QQ, NP4 4QR, NP4 4QS, NP4 4QT, NP4 4QU, NP4 4QW, NP4 4QX, NP4 4QY, NP4 4QZ, NP4 4RA, NP4 4RB, NP4 4RD, NP4 4RE, NP4 4RF, NP4 4RG, NP4 4RH, NP4 4RJ, NP4 4RL, NP4 4RN, NP4 4RP, NP4 4RQ, NP4 4RR, NP4 4RS, NP4 4RT, NP4 4RU, NP4 4RW, NP4 4RX, NP4 4RY, NP4 4RZ, NP4 4SB, NP4 4SD, NP4 4SE, NP4 4SF, NP4 4SG, NP4 4SH, NP4 4SJ, NP4 4SL, NP4 4SN, NP4 4SP, NP4 4SQ, NP4 4SR, NP4 4SS, NP4 4ST, NP4 4SU, NP4 4SW, NP4 4SX, NP4 4SY, NP4 4SZ, NP4 4TA, NP4 4TB, NP4 4TD, NP4 4TE, NP4 4TF, NP4 4TG, NP4 4TH, NP4 4TJ, NP4 4TL, NP4 4TN, NP4 4TP, NP4 4TQ, NP4 4TR, NP4 4TS, NP4 4TT, NP4 4TU, NP4 4TW, NP4 4TY, NP4 4UA, NP4 4UB, NP4 4UD, NP4 4UE, NP4 4UF, NP4 4UG, NP4 4UH, NP4 4UJ, NP4 4UL, NP4 4UN, NP4 4UP, NP4 4UQ, NP4 4UR, NP4 4US, NP4 4UT, NP4 4UU, NP4 4UX, NP4 4UY, NP4 4UZ, NP4 4YB, NP4 4YD, NP4 4YE, NP4 4YF, NP4 4YZ, NP44 6JD, NP44 6JS, NP44 6JU, NP44 6LA",346,328,18
W00010343,NP4,"NP4 3AA, NP4 3AB, NP4 3AD, NP4 3AE, NP4 3AF, NP4 3AG, NP4 3AH, NP4 3AJ, NP4 3AL, NP4 3AN, NP4 3AP, NP4 3AQ, NP4 3AR, NP4 3AS, NP4 3AT, NP4 3AU, NP4 3AW, NP4 3AY, NP4 3AZ, NP4 3BB, NP4 3BD, NP4 3BE, NP4 3BG, NP4 3BH, NP4 3BJ, NP4 3BL, NP4 3BN, NP4 3BP, NP4 3BQ, NP4 3BR, NP4 3BS, NP4 3BT, NP4 3BU, NP4 3BW, NP4 3BX, NP4 3BY, NP4 3BZ, NP4 3DA, NP4 3DB, NP4 3DE, NP4 3DF, NP4 3DL, NP4 3DN, NP4 3DP, NP4 3DR, NP4 3DS, NP4 3DT, NP4 3DU, NP4 3DW, NP4 3DX, NP4 3DY, NP4 3DZ, NP4 3EA, NP4 3EB, NP4 3ED, NP4 3EF, NP4 3EG, NP4 3EH, NP4 3EJ, NP4 3EL, NP4 3EP, NP4 3EQ, NP4 3EX, NP4 3EY, NP4 3EZ, NP4 3HA, NP4 3HB, NP4 3HE, NP4 3HF, NP4 3HG, NP4 3HH, NP4 3HJ, NP4 3HL, NP4 3HN, NP4 3HP, NP4 3HQ, NP4 3HR, NP4 3HS, NP4 3HT, NP4 3HU, NP4 3HW, NP4 3HX, NP4 3HY, NP4 3HZ, NP4 3JA, NP4 3JB, NP4 3JD, NP4 3JE, NP4 3JF, NP4 3JG, NP4 3JH, NP4 3JJ, NP4 3JN, NP4 3JP, NP4 3JR, NP4 3JS, NP4 3JT, NP4 3JU, NP4 3JW, NP4 3JX, NP4 3JY, NP4 3JZ, NP4 3LA, NP4 3LB, NP4 3LD, NP4 3LE, NP4 3LF, NP4 3LG, NP4 3LJ, NP4 3LL, NP4 3LQ, NP4 3LR, NP4 3LS, NP4 3LT, NP4 3LU, NP4 3LX, NP4 3LZ, NP4 3NA, NP4 3NB, NP4 3ND, NP4 3NE, NP4 3NF, NP4 3NG, NP4 3NH, NP4 3NJ, NP4 3NL, NP4 3NN, NP4 3NP, NP4 3NQ, NP4 3NR, NP4 3NS, NP4 3NT, NP4 3NU, NP4 3NW, NP4 3NX, NP4 3NY, NP4 3NZ, NP4 3PA, NP4 3PB, NP4 3PG, NP4 3PH, NP4 3PJ, NP4 3PN, NP4 3PP, NP4 3PQ, NP4 3PR, NP4 3PS, NP4 3PT, NP4 3PU, NP4 3PW, NP4 3PX, NP4 3PZ, NP4 3QA, NP4 3QB, NP4 3QD, NP4 3QE, NP4 3QF, NP4 3QG, NP4 3QH, NP4 3QJ, NP4 3QL, NP4 3QN, NP4 3QP, NP4 3QQ, NP4 3QR, NP4 3QS, NP4 3QT, NP4 3QU, NP4 3QW, NP4 3QX, NP4 3QY, NP4 3QZ, NP4 3TG, NP4 3TJ, NP4 3XA, NP4 3XB, NP4 3XE, NP4 3XF, NP4 3XG, NP4 3XH, NP4 3XJ, NP4 3XL, NP4 3XN, NP4 3XQ, NP4 3XR, NP4 3XS, NP4 3XT, NP4 3XU, NP4 3XW, NP4 3XX, NP4 3XY, NP4 3YA, NP4 3YB, NP4 3YD, NP4 3YR, NP4 3YS, NP44 3AE, NP44 3AF, NP44 3AP, NP44 3AQ, NP44 3GB, NP44 7AN, NP44 7AQ, NP44 7AR, NP44 7AW, NP44 7BE",554,509,45
W00007821,NP4,"NP4 5PD, NP4 5SB, NP4 5SD, NP4 5SH, NP4 5SN, NP4 5SP, NP4 5SW, NP4 5SZ",268,252,16
W00007820,NP4,"NP4 5JZ, NP4 5LA, NP4 5RX, NP4 5RY, NP4 5RZ, NP4 5SA",341,313,28
W00007819,NP4,"NP4 5UA, NP4 5UY, NP4 5UZ, NP4 5XA, NP4 5XB, NP4 5XD, NP4 5XE, NP4 5XF, NP4 5XH, NP4 5XJ, NP4 5XN, NP4 5XP, NP4 5XQ, NP4 5XR, NP4 5XS, NP4 5XT, NP4 5XU, NP4 5XW, NP4 5XX, NP4 5XY",119,107,12
W00007754,NP4,"NP4 6SB, NP4 7AD, NP4 7AG, NP4 7AL, NP4 7AZ, NP4 7BE, NP4 7BG, NP4 7BQ, NP4 7DG, NP4 7EW, NP4 7TP, NP4 7TW, NP4 8PH",236,222,14
W00007768,NP4,"NP4 9EY, NP4 9EZ, NP4 9HB, NP4 9HD, NP4 9NH, NP4 9NJ, NP4 9QA, NP4 9QB, NP4 9QD, NP4 9QF, NP4 9QG, NP4 9QQ, NP4 9YD",299,260,39
W00007766,NP4,"NP4 8UN, NP4 9AY, NP4 9BE, NP4 9DY, NP4 9EB, NP4 9EE, NP4 9LE, NP4 9LF, NP4 9LG, NP4 9LH, NP4 9LQ, NP4 9LR",504,444,60
W00007765,NP4,"NP4 9AN, NP4 9AP, NP4 9AT, NP4 9AU, NP4 9BG, NP4 9BH, NP4 9EH",182,169,13
W00007764,NP4,"NP4 9BB, NP4 9EL, NP4 9EN, NP4 9EP, NP4 9ER, NP4 9EU, NP4 9EW",232,219,13
W00007763,NP4,"NP4 7LP, NP4 7LR, NP4 7LS, NP4 7LT, NP4 7LU, NP4 7LW, NP4 7LX, NP4 7LY, NP4 7NA, NP4 7NH, NP4 7NN, NP4 7NQ, NP4 7PL, NP4 7SL",322,277,45
W00007762,NP4,"NP4 7ED, NP4 7JH, NP4 7QA, NP4 7QB, NP4 7QD, NP4 7QG, NP4 7QL, NP4 7QQ, NP4 7QU, NP4 7QX, NP4 7QY, NP4 7RR, NP4 7RS, NP4 7SY, NP4 7SZ, NP4 7TL, NP4 7TX, NP4 7UF, NP4 7UG, NP4 7UH, NP4 7UR, NP4 7US, NP4 8TY",335,296,39
W00007761,NP4,"NP4 7BD, NP4 7LJ, NP4 7LL, NP4 7QN, NP4 7QW, NP4 7SE, NP4 7SJ, NP4 7SN, NP4 7SX",418,378,40
W00007760,NP4,"NP4 7PR, NP4 7PS, NP4 7QH, NP4 7SG, NP4 7SH, NP4 7SQ, NP4 7ST, NP4 7SU, NP4 7SW",354,309,45
W00007759,NP4,"NP4 7SB, NP4 7SP, NP4 7SR, NP4 7SS, NP4 7YG",309,264,45
W00007758,NP4,"NP4 7PY, NP4 7PZ, NP4 7QE, NP4 7QF, NP4 7SD",323,272,51
W00007757,NP4,"NP4 7AT, NP4 7RT, NP4 7RW, NP4 7RX, NP4 7RY, NP4 7RZ, NP4 7SA, NP4 7SF, NP4 8UA, NP4 8UB, NP4 8UG, NP4 8UH, NP4 8UQ",326,280,46
W00007818,NP4,"NP4 5RR, NP4 5RS, NP4 5RT, NP4 5SG, NP4 5SJ, NP4 5UF, NP4 5UG, NP4 5UH, NP4 5YD, NP4 5YE",372,356,16
W00007817,NP4,"NP4 5RU, NP4 5SE, NP4 5SF, NP4 5SL, NP4 5SQ, NP4 5SR, NP4 5XG, NP4 5YB, NP4 5YF, NP4 5YG",305,275,30
W00007756,NP4,"NP4 7NF, NP4 7NG, NP4 7NS, NP4 7PN, NP4 7PP, NP4 7PW, NP4 7PX, NP4 7QP, NP4 7RU, NP4 7TZ, NP4 7UA, NP4 7UB, NP4 7UD, NP4 7UE, NP4 7UJ, NP4 7UL, NP4 7UN, NP4 7UQ, NP4 8UJ, NP4 8UL, NP4 8UR, NP4 8US, NP4 8UU, NP4 8UW, NP4 8UY, NP4 8UZ, NP4 8XA, NP4 8XD, NP4 8XE, NP4 8XF, NP4 8XH, NP4 8XL, NP4 8XS, NP4 9DX, NP4 9DZ, NP4 9EA",235,206,29
W00007884,NP4,"NP4 0DA, NP4 0NS, NP4 0RG, NP4 0SX, NP4 0TA, NP4 0TS, NP4 0TT, NP4 0TU, NP4 0UE",357,329,28
W00007767,NP4,"NP4 9AW, NP4 9DU, NP4 9ED, NP4 9HE, NP4 9HH, NP4 9HL, NP4 9HR, NP4 9HS, NP4 9HT, NP4 9HU, NP4 9HX, NP4 9JF, NP4 9JS, NP4 9JT, NP4 9LJ, NP4 9LT",328,280,48
W00007890,NP4,"NP4 0ND, NP4 0PP, NP4 0PR, NP4 0PS, NP4 0PU, NP4 0RJ",259,246,13
W00007896,NP4,"NP4 0NZ, NP4 0PA, NP4 0PB, NP4 0PE",203,192,11
W00007774,NP4,"NP4 9DG, NP4 9DH, NP4 9DJ, NP4 9DL, NP4 9DN, NP4 9DP, NP4 9DQ, NP4 9DT, NP4 9XG, NP4 9XH, NP4 9XP, NP4 9YW",271,244,27
W00008041,NP4,"NP4 6DN, NP4 6DR, NP4 6DS, NP4 6DW, NP4 6EB, NP4 6EJ, NP4 6EL, NP4 6NS",249,237,12
W00008042,NP4,"NP4 6DT, NP4 6DU, NP4 6DX, NP4 6DY, NP4 6DZ, NP4 6EA, NP4 6EE",284,258,26
W00008043,NP4,"NP4 6AX, NP4 6AY, NP4 6BH, NP4 6DJ, NP4 6DP, NP4 6DQ, NP4 6ED, NP4 6EF, NP4 6EG, NP4 6EQ, NP4 6ES, NP4 6XL, NP4 6YA, NP4 6YD, NP4 6ZA, NP4 6ZD",336,304,32
W00007949,NP4,"NP4 6NX, NP4 6QR, NP4 6QT, NP4 6QX, NP4 6QZ, NP4 6RA, NP4 6RB, NP4 6RD, NP4 6RQ, NP4 6RY, NP4 6TR, NP4 6TT, NP4 6UB, NP4 6UF, NP4 6UL, NP4 6UN",271,248,23
W00007772,NP4,"NP4 9BA, NP4 9BS, NP4 9BT, NP4 9BU, NP4 9BW, NP4 9BX, NP4 9BY, NP4 9DA, NP4 9DB, NP4 9DD, NP4 9DE, NP4 9DF, NP4 9DR, NP4 9DS",256,233,23
W00007773,NP4,"NP4 9AR, NP4 9BQ, NP4 9JN, NP4 9JP, NP4 9JW, NP4 9LA, NP4 9LB, NP4 9LD",237,219,18
W00007945,NP4,"NP4 1AA, NP4 1AD, NP4 1AE, NP4 1AF, NP4 1AG, NP4 1AL, NP4 1AN, NP4 1AP, NP4 1AQ, NP4 1AR, NP4 1AS, NP4 1AT, NP4 1AU, NP4 1AW, NP4 1AX, NP4 1AY, NP4 1AZ, NP4 1BA, NP4 1BB, NP4 1BD, NP4 1BE, NP4 1BG, NP4 1BH, NP4 1BJ, NP4 1BL, NP4 1BN, NP4 1BP, NP4 1BQ, NP4 1BR, NP4 1BS, NP4 1BT, NP4 1BW, NP4 1BY, NP4 1DD, NP4 1DG, NP4 1DH, NP4 1DJ, NP4 1DL, NP4 1DN, NP4 1DP, NP4 1DQ, NP4 1DR, NP4 1DS, NP4 1DT, NP4 1DU, NP4 1DW, NP4 1DX, NP4 1DY, NP4 1DZ, NP4 1EA, NP4 1EB, NP4 1ED, NP4 1EE, NP4 1EF, NP4 1EG, NP4 1EH, NP4 1EJ, NP4 1EL, NP4 1EN, NP4 1EP, NP4 1EQ, NP4 1ER, NP4 1ES, NP4 1ET, NP4 1EU, NP4 1EW, NP4 1EX, NP4 1EY, NP4 1EZ, NP4 1FA, NP4 1HA, NP4 1HB, NP4 1HD, NP4 1HE, NP4 1HF, NP4 1HG, NP4 1HH, NP4 1HJ, NP4 1HL, NP4 1HN, NP4 1HP, NP4 1HQ, NP4 1HR, NP4 1HS, NP4 1HT, NP4 1HU, NP4 1HW, NP4 1HX, NP4 1HY, NP4 1HZ, NP4 1JA, NP4 1JB, NP4 1JE, NP4 1JF, NP4 1JL, NP4 1JN, NP4 1JP, NP4 1JQ, NP4 1JR, NP4 1JS, NP4 1JT, NP4 1JU, NP4 1JW, NP4 1JX, NP4 1JY, NP4 1JZ, NP4 1LA, NP4 1LB, NP4 1LD, NP4 1LE, NP4 1LF, NP4 1LG, NP4 1LH, NP4 1LJ, NP4 1LL, NP4 1LN, NP4 1LP, NP4 1LQ, NP4 1LR, NP4 1LS, NP4 1LT, NP4 1LU, NP4 1LW, NP4 1LY, NP4 1LZ, NP4 1NA, NP4 1NB, NP4 1ND, NP4 1NE, NP4 1NF, NP4 1NG, NP4 1NH, NP4 1NJ, NP4 1NL, NP4 1NN, NP4 1NP, NP4 1NQ, NP4 1NR, NP4 1NS, NP4 1NT, NP4 1NU, NP4 1NW, NP4 1NY, NP4 1NZ, NP4 1PF, NP4 1PG, NP4 1PH, NP4 1PJ, NP4 1PL, NP4 1PN, NP4 1PP, NP4 1PQ, NP4 1PR, NP4 1PS, NP4 1PT, NP4 1PU, NP4 1PW, NP4 1PX, NP4 1PY, NP4 1PZ, NP4 1QA, NP4 1QB, NP4 1QD, NP4 1QE, NP4 1QF, NP4 1QG, NP4 1QH, NP4 1QJ, NP4 1QL, NP4 1QN, NP4 1QP, NP4 1QQ, NP4 1QR, NP4 1QS, NP4 1QT, NP4 1QU, NP4 1QW, NP4 1QX, NP4 1RA, NP4 1RB, NP4 1RD, NP4 1RE, NP4 1RF, NP4 1RG, NP4 1RH, NP4 1RJ, NP4 1RL, NP4 1RN, NP4 1RP, NP4 1RQ, NP4 1RR, NP4 1RS, NP4 1RT, NP4 1RU, NP4 1RW, NP4 1RX, NP4 1RY, NP4 1RZ, NP4 1SA, NP4 1SB, NP4 1SD, NP4 1SE, NP4 1SF, NP4 1SG, NP4 1SL, NP4 1SN, NP4 1SP, NP4 1SR, NP4 1SS, NP4 1ST, NP4 1SU, NP4 1SW, NP4 1SX, NP4 1SY, NP4 1SZ, NP4 1TA, NP4 1TB, NP4 1TD, NP4 1TE, NP4 1TF, NP4 1TG, NP4 1TH, NP4 1TJ, NP4 1TL, NP4 1TQ, NP4 1TS, NP4 1TT, NP4 1TU, NP4 1TX, NP4 1TY, NP4 1TZ, NP4 1UA, NP4 1UB, NP4 1UD, NP4 1UE, NP4 1UF, NP4 1UH, NP4 1UJ, NP4 1UL, NP4 1UN, NP4 1UP, NP4 1UQ, NP4 1WR, NP4 1WS, NP4 1WT, NP4 1WX, NP4 1WY, NP4 1XA, NP4 1XB, NP4 1XD, NP4 1XE, NP4 1XF, NP4 1XG, NP4 1XH, NP4 1XJ, NP4 1XL, NP4 1XN, NP4 1XP, NP4 1XQ, NP4 1XS, NP4 1XT, NP4 1XW, NP4 1XX, NP4 1XY, NP4 1YA, NP4 1YD, NP4 1YE, NP4 1YF, NP4 1YH, NP4 1YJ, NP4 1YL, NP4 1YP, NP4 1YR, NP4 1YS, NP4 1YT, NP4 1YW, NP4 1YY, NP4 1YZ, NP44 1LG, NP44 1LL, NP44 1LQ, NP44 1LR",267,243,24
W00007891,NP4,"NP4 0NB, NP4 0NE, NP4 0NH, NP4 0NR",262,239,23
W00007775,NP4,"NP4 9HN, NP4 9HW, NP4 9JQ, NP4 9LN, NP4 9LP, NP4 9LW, NP4 9LX, NP4 9LY",242,220,22
W00007776,NP4,"NP4 9AX, NP4 9AZ, NP4 9RT, NP4 9RX, NP4 9SB, NP4 9SD, NP4 9SE, NP4 9SF, NP4 9SG, NP4 9SJ, NP4 9SL, NP4 9SR, NP4 9SW, NP4 9XU",111,96,15
W00007777,NP4,"NP4 9DW, NP4 9PX, NP4 9QJ, NP4 9QL, NP4 9QN, NP4 9QR, NP4 9QS, NP4 9QW, NP4 9QY, NP4 9RB, NP4 9RP, NP4 9RS, NP4 9RU, NP4 9RW, NP4 9SA, NP4 9SH, NP4 9SQ, NP4 9XJ, NP4 9XT, NP4 9XW",245,227,18
W00007778,NP4,"NP4 9PF, NP4 9PG, NP4 9PH, NP4 9PQ, NP4 9QT, NP4 9QU, NP4 9QX",385,354,31
W00007779,NP4,"NP4 9AA, NP4 9AB, NP4 9AD, NP4 9AF, NP4 9AG, NP4 9AH, NP4 9AJ, NP4 9AQ, NP4 9BN, NP4 9BP, NP4 9RF, NP4 9RG, NP4 9RJ, NP4 9RL, NP4 9RN, NP4 9RQ, NP4 9RR, NP4 9XR, NP4 9YA",270,237,33
W00007780,NP4,"NP4 9NT, NP4 9NU, NP4 9NX, NP4 9NY, NP4 9NZ, NP4 9PA, NP4 9PB, NP4 9PD, NP4 9PE, NP4 9QZ",237,223,14
W00007781,NP4,"NP4 9HF, NP4 9HG, NP4 9HQ, NP4 9NG, NP4 9NL, NP4 9NN, NP4 9NQ, NP4 9NW, NP4 9PN, NP4 9QH, NP4 9QP, NP4 9RA",332,312,20
W00007782,NP4,"NP4 9JD, NP4 9JE, NP4 9NP, NP4 9NR, NP4 9NS, NP4 9PJ",303,277,26
W00007783,NP4,"NP4 9AL, NP4 9EJ, NP4 9ET, NP4 9EX, NP4 9HA, NP4 9NB, NP4 9ND, NP4 9NE, NP4 9NF, NP4 9PS, NP4 9PU, NP4 9PW, NP4 9PY, NP4 9PZ, NP4 9QE, NP4 9XB, NP4 9XD, NP4 9XF, NP4 9XN, NP4 9XS",250,231,19
W00007784,NP4,"NP4 9JA, NP4 9JB, NP4 9JG, NP4 9JH, NP4 9JJ, NP4 9PL, NP4 9PP",272,247,25
W00007785,NP4,"NP4 6BR, NP4 6HN, NP4 6HQ, NP4 6HW, NP4 6XH",216,208,8
W00007786,NP4,"NP4 6AE, NP4 6AJ, NP4 6AL, NP4 6AP, NP4 6EN, NP4 6GE, NP4 6LB, NP4 6LD, NP4 6LE, NP4 6LF, NP4 6LH, NP4 6LJ, NP4 6LN",212,200,12
W00007787,NP4,"NP4 6BX, NP4 6DB, NP4 6DD, NP4 6HL, NP4 6HP, NP4 6HR, NP4 6HS",245,233,12
W00007788,NP4,"NP4 6FD, NP4 6HG, NP4 6HU, NP4 6HX, NP4 6HY, NP4 6HZ",230,209,21
W00007789,NP4,"NP4 6HD, NP4 6HF, NP4 6HH, NP4 6HJ, NP4 6HT",251,233,18
W00007790,NP4,"NP4 6AF, NP4 6EP, NP4 6ET, NP4 6EU, NP4 6EX, NP4 6HA, NP4 6HB, NP4 6HE",229,219,10
W00007982,NP4,"NP4 8LX, NP4 8NA, NP4 8ND, NP4 8NE, NP4 8NF, NP4 8NG, NP4 8NN, NP4 8NP, NP4 8NQ, NP4 8NR, NP4 8NW, NP4 8PB",249,232,17
W00008040,NP4,"NP4 6DE, NP4 6DF, NP4 6DG, NP4 6DL, NP4 6EH, NP4 6NJ, NP4 6NR, NP4 6NT",360,334,26
W00008038,NP4,"NP4 6AG, NP4 6AQ, NP4 6AR, NP4 6AS, NP4 6AT, NP4 6AU",245,222,23
W00008037,NP4,"NP4 6AH, NP4 6AN, NP4 6AW, NP4 6BB, NP4 6BD, NP4 6BT",302,277,25
W00008036,NP4,"NP4 6AZ, NP4 6BA, NP4 6BE, NP4 6BG, NP4 6BJ, NP4 6BL, NP4 6BN, NP4 6BP, NP4 6BQ, NP4 6BS, NP4 6BW, NP4 6FA, NP4 6TP, NP4 6UP, NP4 6UQ, NP4 6UR, NP4 6US, NP4 6UT, NP4 6UU, NP4 6UX, NP4 6WA",421,374,47
W00007981,NP4,"NP4 6SD, NP4 6SG, NP4 6SH, NP4 6SJ, NP4 6SL, NP4 6SN, NP4 6SP, NP4 6SQ, NP4 6SR, NP4 6SU, NP4 6SW, NP4 6SX, NP4 6SY, NP4 6WD",258,235,23
W00007980,NP4,"NP4 6NP, NP4 6SZ, NP4 8LU, NP4 8LY, NP4 8LZ, NP4 8PA, NP4 8YT",243,225,18
W00007979,NP4,"NP4 6RR, NP4 6TA, NP4 6TJ, NP4 6TS, NP4 6TW, NP4 6TX, NP4 6TZ, NP4 7BL, NP4 7BU, NP4 7BX, NP4 7BY, NP4 7BZ, NP4 7TA, NP4 7TB, NP4 7TD",343,325,18
W00007984,NP4,"NP4 6NF, NP4 6NG, NP4 6NL, NP4 6NY, NP4 8NH, NP4 8NJ, NP4 8NL, NP4 8NS, NP4 8NT, NP4 8NU, NP4 8NX, NP4 8NY, NP4 8NZ",251,236,15
W00007964,NP4,"NP4 8BB, NP4 8BN, NP4 8BR, NP4 8DA",250,242,8
W00007963,NP4,"NP4 8DD, NP4 8EG, NP4 8GA, NP4 8HR, NP4 8JA, NP4 8JJ, NP4 8JN, NP4 8JQ, NP4 8JR, NP4 8JS, NP4 8JU, NP4 8JX, NP4 8NB, NP4 8TU",525,473,52
W00007962,NP4,"NP4 8JG, NP4 8JH, NP4 8JL, NP4 8JP, NP4 8JW",327,299,28
W00010333,NP4,"NP4 5DZ, NP4 5EP, NP4 5ES, NP4 5EW, NP4 5NA",202,191,11
W00007961,NP4,"NP4 8AX, NP4 8BD, NP4 8BE, NP4 8BG, NP4 8BQ, NP4 8BX, NP4 8BY, NP4 8BZ, NP4 8JT",375,342,33
W00007960,NP4,"NP4 8BP, NP4 8BS, NP4 8BT, NP4 8BU, NP4 8BW",316,301,15
W00007985,NP4,"NP4 7BA, NP4 7BH, NP4 7BJ, NP4 7BN, NP4 7BP, NP4 7BR, NP4 7BS, NP4 7BT, NP4 7BW, NP4 7DA, NP4 7TY, NP4 7UU, NP4 7UZ, NP4 7WQ, NP4 7WY, NP4 7XZ",327,297,30
W00007986,NP4,"NP4 6TB, NP4 6TE, NP4 6TF, NP4 6TL, NP4 8EW, NP4 8HH, NP4 8HJ",255,242,13
W00007927,NP4,"NP4 5HD, NP4 5HG, NP4 5HH, NP4 5HL, NP4 5HQ",283,247,36
W00007959,NP4,"NP4 4AD, NP4 4SA, NP4 4ZZ, NP4 6JE, NP4 6JF, NP4 6JH, NP4 6JL, NP4 6JP, NP4 6JQ, NP4 6JR, NP4 6JT, NP4 6JU, NP4 6NZ, NP4 6XG, NP4 6XQ, NP4 6XT, NP4 6XY, NP4 6XZ, NP4 6YB, NP4 6YE, NP4 6YG, NP4 6YH, NP4 6YL, NP4 6YN, NP4 6ZE, NP4 8BA, NP4 8BJ, NP4 8BL, NP4 8DB, NP4 8DF",304,283,21
W00007958,NP4,"NP4 6BU, NP4 6BY, NP4 6BZ, NP4 6DA, NP4 6DH, NP4 6GQ, NP4 6GR, NP4 6JB, NP4 6JD, NP4 6JG, NP4 6JJ, NP4 6JN, NP4 6JS, NP4 6JW, NP4 6LR, NP4 6LS, NP4 6LT, NP4 6LU, NP4 6LY, NP4 6NA, NP4 6NB, NP4 6ND, NP4 6NH, NP4 6NN, NP4 6NW, NP4 6XA, NP4 6XD, NP4 6XJ, NP4 6XU, NP4 6XX, NP4 6YJ, NP4 6YP, NP4 6YQ, NP4 6ZW, NP4 8BH, NP4 8DE",304,278,26
W00007957,NP4,"NP4 6GA, NP4 6GP, NP4 6GS, NP4 6GT, NP4 6LX, NP4 6LZ, NP4 6NQ",316,283,33
W00007956,NP4,"NP4 0BT, NP4 0RF, NP4 0RH, NP4 0XB, NP4 0XE, NP4 0XJ, NP4 5DG, NP4 5LF, NP4 5LG, NP4 5LH, NP4 5NB, NP4 6XB, NP4 8ER, NP4 8ES, NP4 8ET",299,275,24
W00007955,NP4,"NP4 5JS, NP4 5JY, NP4 6EW, NP4 6LG, NP4 6LL, NP4 6LQ, NP4 6LW, NP4 6XE, NP4 6XF, NP4 6XP, NP4 6XR, NP4 8AP, NP4 8AR, NP4 8AT, NP4 8AU, NP4 8AY, NP4 8AZ",264,252,12
W00007954,NP4,"NP4 5JT, NP4 5JU, NP4 5JX, NP4 5LB, NP4 5LD, NP4 5LE, NP4 5SS, NP4 8AN, NP4 8AW, NP4 8EU, NP4 8HU",321,295,26
W00007953,NP4,"NP4 0WA, NP4 0WD, NP4 0WY, NP4 0WZ, NP4 0XG, NP4 0XU, NP4 0YB, NP4 0YF, NP4 0YJ, NP4 0YQ, NP4 0YU, NP4 0YX, NP4 0ZB, NP4 0ZT, NP4 4AA, NP4 4AB, NP4 4AE, NP4 4AF, NP4 4AG, NP4 4AH, NP4 4AJ, NP4 4AL, NP4 4AN, NP4 4AP, NP4 4AQ, NP4 4BA, NP4 4BB, NP4 4BD, NP4 4BE, NP4 4BF, NP4 4BG, NP4 4BH, NP4 4BJ, NP4 4BL, NP4 4BN, NP4 4BP, NP4 4BQ, NP4 4BR, NP4 4BS, NP4 4BT, NP4 4BU, NP4 4BW, NP4 4BX, NP4 4BY, NP4 4BZ, NP4 4DA, NP4 4DB, NP4 4DD, NP4 4DE, NP4 4DF, NP4 4DG, NP4 4DH, NP4 4DJ, NP4 4DL, NP4 4DN, NP4 4DP, NP4 4DQ, NP4 4DR, NP4 4DS, NP4 4DT, NP4 4DU, NP4 4DW, NP4 4DX, NP4 4DY, NP4 4DZ, NP4 4EA, NP4 4EB, NP4 4ED, NP4 4EE, NP4 5WY, NP4 5WZ, NP4 5YQ, NP4 5YU, NP4 5YZ, NP4 5ZA, NP4 6AB, NP4 6AD, NP4 6PB, NP4 6PQ, NP4 6QA, NP4 6QB, NP4 6QD, NP4 6QH, NP4 6QJ, NP4 6QL, NP4 6QN, NP4 6QP, NP4 6TN, NP4 6TU, NP4 6WH, NP4 6WW, NP4 6WX, NP4 6WY, NP4 6WZ, NP4 6YF, NP4 6YR, NP4 6YS, NP4 6YT, NP4 6YU, NP4 6YW, NP4 6YX, NP4 6YZ, NP4 6ZB, NP4 6ZR, NP4 7WS, NP4 7WZ, NP4 7XU, NP4 7YA, NP4 7YD, NP4 7YE, NP4 7YH, NP4 7YN, NP4 7ZB, NP4 7ZS, NP4 7ZX, NP4 8WN, NP4 8YA, NP4 8YD, NP4 8YF, NP4 8YL, NP4 8YN, NP4 8YP, NP4 8YQ, NP4 8YR, NP4 8YS, NP4 8YU, NP4 8YW, NP4 8YX, NP4 8ZR, NP4 9WR, NP4 9YB, NP4 9YE, NP4 9ZD",274,246,28
W00007952,NP4,"NP4 6PG, NP4 6PH, NP4 6PJ, NP4 6PL, NP4 6PN, NP4 6PP, NP4 6PW, NP4 6PZ, NP4 6QE, NP4 6QF, NP4 6QG, NP4 6QQ, NP4 6UW",260,236,24
W00007951,NP4,"NP4 6PA, NP4 6PR, NP4 6PS, NP4 6PT, NP4 6PU, NP4 6PX, NP4 6PY, NP4 6QS, NP4 6QU, NP4 6QY, NP4 6RE, NP4 6RF, NP4 6RH, NP4 6RU",305,279,26
W00007950,NP4,"NP4 6JA, NP4 6NE, NP4 6NU, NP4 6PD, NP4 6PE, NP4 6PF, NP4 6QW, NP4 6SA, NP4 6SE, NP4 6SF, NP4 6SS, NP4 6ST, NP4 6YY",267,246,21
W00008021,NP4,"NP4 5DQ, NP44 1AB, NP44 1DA, NP44 1FR, NP44 1FS, NP44 1FT, NP44 1FW, NP44 1GB, NP44 1SN, NP44 5AA, NP44 5AB, NP44 5AD, NP44 5AE, NP44 5AF, NP44 5AG, NP44 5AL, NP44 5AN, NP44 5AQ, NP44 5AT, NP44 5AX, NP44 5AY, NP44 5SL, NP44 5SN, NP44 5ST, NP44 5SU, NP44 5SW",312,282,30
W00007769,NP4,"NP4 9AE, NP4 9AS, NP4 9BD, NP4 9BJ, NP4 9BL, NP4 9BR, NP4 9BZ, NP4 9LZ, NP4 9NA, NP4 9PT, NP4 9RD, NP4 9RE, NP4 9XA",236,224,12
W00007770,NP4,"NP4 9HP, NP4 9HY, NP4 9HZ, NP4 9JL, NP4 9JR, NP4 9LU, NP4 9PR",359,320,39
W00007987,NP4,"NP4 8LD, NP4 8LH, NP4 8LJ, NP4 8LL, NP4 8LN, NP4 8LP, NP4 8LQ, NP4 8LR, NP4 8LS, NP4 8LT, NP4 8LW",288,271,17
W00007926,NP4,"NP4 5HJ, NP4 5LN, NP4 5LR, NP4 5LS, NP4 5LT",281,263,18
W00007791,NP4,"NP4 6AA, NP4 6EY, NP4 6EZ, NP4 6JX, NP4 6JY, NP4 6JZ, NP4 6LA, NP4 6LP",248,223,25
W00007925,NP4,"NP4 0XZ, NP4 5HF, NP4 5HU, NP4 5HX, NP4 5HY, NP4 5HZ, NP4 5JA, NP4 5JD, NP4 5LZ, NP4 5YA",257,235,22
W00007903,NP4,"NP4 0PG, NP4 0QJ, NP4 0QU, NP4 0RA, NP4 0RE",327,292,35
W00007989,NP4,"NP4 8DY, NP4 8DZ, NP4 8EY, NP4 8JY, NP4 8JZ, NP4 8YE, NP4 8YG, NP4 8YH, NP4 8YJ",276,247,29
W00007902,NP4,"NP4 0EY, NP4 0LT, NP4 0LU, NP4 0XT, NP4 0XW, NP4 0YG",261,247,14
W00007901,NP4,"NP4 0DE, NP4 0DG, NP4 0EX",243,236,7
W00007900,NP4,"NP4 0PD, NP4 0ST, NP4 8RP, NP4 8RR",292,273,19
W00007898,NP4,"NP4 0QY, NP4 0RB, NP4 0RD, NP4 8AB, NP4 8AJ, NP4 8AQ, NP4 8AS, NP4 8EQ, NP4 8FA, NP4 8HW",293,266,27
W00007897,NP4,"NP4 8AA, NP4 8AD, NP4 8AE, NP4 8AF, NP4 8AG, NP4 8AH, NP4 8AL",244,219,25
W00007990,NP4,"NP4 8DG, NP4 8DQ, NP4 8DT, NP4 8EN, NP4 8FD, NP4 8JD, NP4 8TR",289,261,28
W00007895,NP4,"NP4 0BX, NP4 0BY, NP4 0BZ, NP4 0NT, NP4 0NU, NP4 0NX, NP4 0NY, NP4 0TN, NP4 0TP, NP4 0TR, NP44 2BZ, NP44 2NA, NP44 2PP, NP44 2PQ",466,443,23
W00007904,NP4,"NP4 0DF, NP4 0EZ, NP4 0JR, NP4 0QW, NP4 0RR",291,278,13
W00007894,NP4,"NP4 0PL, NP4 0PN, NP4 0PY, NP4 0QA, NP4 0QB",279,260,19
W00007992,NP4,"NP4 8DH, NP4 8DJ, NP4 8DL, NP4 8DN, NP4 8DW, NP4 8HQ, NP4 8JB, NP4 8LA, NP4 8LB",282,274,8
W00007993,NP4,"NP4 8HF, NP4 8HG, NP4 8HT",261,246,15
W00007994,NP4,"NP4 8HN, NP4 8HP, NP4 8HS, NP4 8HZ, NP4 8JE, NP4 8JF",231,214,17
W00007995,NP4,"NP4 8EH, NP4 8EL, NP4 8EP, NP4 8EZ",304,285,19
W00007996,NP4,"NP4 8DU, NP4 8EA, NP4 8ED, NP4 8EF, NP4 8EJ",317,282,35
W00007997,NP4,"NP4 8DP, NP4 8DR, NP4 8DS, NP4 8DX, NP4 8EB, NP4 8EE",264,244,20
W00010321,NP4,"NP4 5YH, NP4 5YJ",299,248,51
W00008177,NP4,"NP4 9SS, NP7 0HL, NP7 9EX, NP7 9RH, NP7 9RN, NP7 9RP, NP7 9RQ, NP7 9RR, NP7 9RS, NP7 9RT, NP7 9RU, NP7 9RW, NP7 9RX, NP7 9RY, NP7 9RZ, NP7 9SE, NP7 9SF",263,232,31
W00007892,NP4,"NP4 0NA, NP4 0NF, NP4 0QZ",235,222,13
W00007991,NP4,"NP4 8HB, NP4 8HE, NP4 8HY, NP4 8LE, NP4 8LF, NP4 8YB",292,267,25
W00007905,NP4,"NP4 5DJ, NP4 5HN, NP4 5HP, NP4 5HW, NP4 5NE",300,264,36
W00007899,NP4,"NP4 0HD, NP4 0HZ, NP4 0JA, NP4 0JB, NP4 0JL, NP4 0LW, NP4 0QD, NP4 0QX, NP4 0XA, NP4 0XD, NP4 0XF, NP4 0XH, NP4 0XS, NP4 0XX, NP4 0XY, NP4 0YD, NP4 0YH, NP4 0YL, NP4 0YP, NP4 0YR, NP4 0YT, NP4 8QU, NP4 8QX",275,268,7
W00007771,NP4,"NP4 9HJ, NP4 9JU, NP4 9JX, NP4 9JY, NP4 9JZ, NP4 9LL, NP4 9LS",267,240,27
W00007924,NP4,"NP4 5HA, NP4 5HB, NP4 5HE, NP4 5JN, NP4 5LL, NP4 5LP, NP4 5LW",243,228,15
W00007923,NP4,"NP4 5LJ, NP4 5LQ, NP4 5QE, NP4 5QU, NP4 5SU",245,222,23
W00007922,NP4,"NP4 5BP, NP4 5BT, NP4 5BW, NP4 5BY, NP4 5BZ, NP4 5FD",335,307,28
W00007921,NP4,"NP4 0ET, NP4 5DB, NP4 5DD, NP4 5ED, NP4 5EG, NP4 5EQ, NP4 5FB",239,230,9
W00007920,NP4,"NP4 5BJ, NP4 5DX, NP4 5DY, NP4 5EA, NP4 5EB",250,221,29
W00007988,NP4,"NP4 8EX, NP4 8HA, NP4 8HD, NP4 8HL, NP4 8LG",269,242,27
W00007919,NP4,"NP4 5AP, NP4 5AR, NP4 5AS, NP4 5BR, NP4 5BS",247,224,23
W00007918,NP4,"NP4 5AW, NP4 5BU, NP4 5BX, NP4 5XZ",281,252,29
W00007916,NP4,"NP4 5AJ, NP4 5AL, NP4 5AN, NP4 5AT",275,251,24
W00007915,NP4,"NP4 5AB, NP4 5AD, NP4 5AF, NP4 5AH, NP4 5BG, NP4 5BH",262,233,29
W00007983,NP4,"NP4 6RG, NP4 6RJ, NP4 6RL, NP4 6RN, NP4 6RP, NP4 6RS, NP4 6RT, NP4 6RW, NP4 6RX, NP4 6RZ",268,247,21
W00007913,NP4,"NP4 5AG, NP4 5AQ, NP4 5DA, NP4 5EX, NP4 5EY, NP4 5GA, NP4 5GB, NP4 5GD, NP4 5ST",314,298,16
W00007912,NP4,"NP4 5DP, NP4 5DR, NP4 5DT, NP4 5GZ, NP4 5JR, NP4 5LU",319,296,23
W00007911,NP4,"NP4 0DQ, NP4 0LS, NP4 0SH, NP4 0TL, NP4 0YS, NP4 0YW, NP4 0YZ, NP4 5DF, NP4 5HR, NP4 5HT, NP4 5JF, NP4 5JG, NP4 5JH, NP4 5JP, NP4 5JQ, NP4 5ND, NP4 5NF, NP4 5NG, NP4 5NH, NP4 5NJ, NP4 5NL, NP4 5NN, NP4 5NP, NP4 5NQ, NP4 5NR, NP4 5NS, NP4 5NT, NP4 5NU, NP4 5NW, NP4 5NX, NP4 5NY, NP4 5NZ, NP4 5PA, NP4 5PB, NP4 5PE, NP4 5PF, NP4 5PG, NP4 5PH, NP4 5PJ, NP4 5PL, NP4 5PN, NP4 5PP, NP4 5PQ, NP4 5PR, NP4 5PS, NP4 5PT, NP4 5PU, NP4 5PW, NP4 5PX, NP4 5PY, NP4 5PZ, NP4 5QA, NP4 5QB, NP4 5QD, NP4 5QF, NP4 5QG, NP4 5QH, NP4 5QJ, NP4 5QL, NP4 5QN, NP4 5QP, NP4 5QQ, NP4 5QR, NP4 5QS, NP4 5QT, NP4 5QW, NP4 5QX, NP4 5QY, NP4 5QZ, NP4 5RA, NP4 5RB, NP4 5RD, NP4 5RE, NP4 5RF, NP4 5RG, NP4 5RH, NP4 5RJ, NP4 5RL, NP4 5RN, NP4 5RP, NP4 5RQ, NP4 5RW, NP4 5TA, NP4 5TB, NP4 5TD, NP4 5TE, NP4 5TF, NP4 5TG, NP4 5TH, NP4 5TJ, NP4 5TL, NP4 5TN, NP4 5TP, NP4 5TQ, NP4 5TR, NP4 5TS, NP4 5TT, NP4 5TU, NP4 5TW, NP4 5TX, NP4 5TY, NP4 5TZ, NP4 5UB, NP4 5UD, NP4 5UE, NP4 5UJ, NP4 5UL, NP4 5UN, NP4 5UP, NP4 5UQ, NP4 5UR, NP4 5US, NP4 5UT, NP4 5UW, NP4 5UX, NP4 5WA, NP4 5YX",226,214,12
W00007910,NP4,"NP4 5EE, NP4 5EF, NP4 5EH, NP4 5EJ, NP4 5EL, NP4 5EN, NP4 5ET",277,262,15
W00007909,NP4,"NP4 5BE, NP4 5DE, NP4 5DH, NP4 5DL, NP4 5DN, NP4 5DW, NP4 5LY, NP4 5YY",290,260,30
W00007908,NP4,"NP4 5AU, NP4 5AX, NP4 5AY, NP4 5AZ, NP4 5BA, NP4 5BB, NP4 5BD, NP4 5EZ, NP4 5YP",260,249,11
W00007914,NP4,"NP4 5BQ, NP4 5DS, NP4 5DU, NP4 5ER, NP4 5EU, NP4 5FA, NP4 5YR, NP4 5YS, NP4 5YT, NP4 5YW",271,257,14
W00007907,NP4,"NP4 5HS, NP4 5JB, NP4 5JE, NP4 5JJ, NP4 5JL, NP4 5JW, NP4 5LX",291,266,25
W00007906,NP4,"NP4 5AA, NP4 5AE, NP4 5BL, NP4 5BN",282,259,23
W00007840,NP44,"NP44 4BQ, NP44 4LD, NP44 4LE, NP44 4LG",292,275,17
W00010326,NP44,"NP44 3AG, NP44 3DH, NP44 3FE, NP44 3LP, NP44 3XQ, NP44 5AJ, NP44 5BB, NP44 5BJ, NP44 5BL",245,210,35
W00010329,NP44,"NP44 3BJ, NP44 3BN, NP44 3GH",183,171,12
W00010330,NP44,"NP44 3AB, NP44 3BL, NP44 3BW, NP44 3DJ, NP44 3FH, NP44 3FL, NP44 3FN, NP44 3HG, NP44 3HN, NP44 3HP, NP44 3HR, NP44 3WZ",546,500,46
W00010331,NP44,"NP44 3BH, NP44 3DA",130,120,10
W00007839,NP44,"NP44 5AP, NP44 5HA, NP44 5HD, NP44 5HE, NP44 5HF, NP44 5HG, NP44 5HH, NP44 5HJ, NP44 5HL, NP44 5HN, NP44 5HQ, NP44 5HR",335,318,17
W00007838,NP44,"NP44 4EH, NP44 4EJ, NP44 6JP, NP44 6UB, NP44 6UF, NP44 6UH",276,254,22
W00010322,NP44,NP44 3BZ,98,82,16
W00010325,NP44,"NP44 1DG, NP44 1FE, NP44 1FF, NP44 1FG",253,221,32
W00007831,NP44,"NP44 4TX, NP44 6UG, NP44 6UJ, NP44 6UL",282,257,25
W00007832,NP44,"NP44 4DE, NP44 4PR, NP44 4PS, NP44 4PT, NP44 4PZ, NP44 4QG, NP44 4QH",268,248,20
W00007835,NP44,"NP44 4EE, NP44 4EF, NP44 4EG, NP44 4EQ, NP44 4PU, NP44 4PX, NP44 4PY, NP44 4QB, NP44 4QF",270,247,23
W00007836,NP44,"NP44 6JT, NP44 6JY, NP44 6LB",340,313,27
W00007834,NP44,"NP44 4DA, NP44 4DF, NP44 4DG, NP44 4DH, NP44 4DJ, NP44 4DL, NP44 4DN, NP44 4DQ, NP44 4DZ, NP44 4HG",290,258,32
W00007837,NP44,"NP44 6UD, NP44 6UE, NP44 6US, NP44 6UT, NP44 6YF, NP44 6YW",259,230,29
W00010332,NP44,"NP44 3AT, NP44 3BQ, NP44 3DD, NP44 3GD, NP44 3GE, NP44 3XE",448,393,55
W00007833,NP44,"NP44 6JA, NP44 6JQ, NP44 6JR, NP44 6LD",273,239,34
W00007792,NP44,"NP44 7AE, NP44 7AY, NP44 7DJ, NP44 7DS, NP44 7DU, NP44 7DX, NP44 7EA, NP44 7ED, NP44 7EL, NP44 7EU, NP44 7EW, NP44 7XQ",415,377,38
W00007829,NP44,"NP44 6JJ, NP44 6JL, NP44 6UN, NP44 6UP, NP44 6UR",294,278,16
W00007793,NP44,"NP44 4TG, NP44 4TW, NP44 7DP, NP44 7DT, NP44 7LT",460,431,29
W00007794,NP44,"NP44 4TH, NP44 4TJ, NP44 4TL, NP44 4TN, NP44 4TQ, NP44 4TT",282,263,19
W00007795,NP44,"NP44 4TP, NP44 4TU, NP44 7AG, NP44 7DR, NP44 7EB, NP44 7EH, NP44 7UA, NP44 7UR",302,278,24
W00007796,NP44,"NP44 6TU, NP44 6TY",262,238,24
W00007797,NP44,"NP44 6HF, NP44 6HG, NP44 6HJ, NP44 6TZ, NP44 6YB, NP44 6YD, NP44 6YE, NP44 6YJ, NP44 6YL, NP44 6YN, NP44 6YP, NP44 6YQ",313,298,15
W00007798,NP44,"NP44 4TE, NP44 4TF, NP44 4TR, NP44 4TS, NP44 6YY",326,283,43
W00007799,NP44,"NP44 2ND, NP44 2NE, NP44 2NH, NP44 2NZ, NP44 2PD, NP44 2PF, NP44 2PN, NP44 2PR, NP44 2PT, NP44 2PU, NP44 2PW, NP44 2QA",380,349,31
W00007800,NP44,"NP44 2LW, NP44 2NF, NP44 2NG, NP44 2NN, NP44 2NQ, NP44 2NS, NP44 2NW",287,256,31
W00007801,NP44,"NP44 2PX, NP44 2PY, NP44 2PZ, NP44 2QE, NP44 2QL",234,217,17
W00007802,NP44,"NP44 2QN, NP44 2QP, NP44 2QQ, NP44 2QR, NP44 2QW",256,241,15
W00007803,NP44,"NP44 2JA, NP44 2JB, NP44 2JD, NP44 2JL, NP44 2LL, NP44 2LU, NP44 2NR, NP44 2QB, NP44 2QY",315,301,14
W00007804,NP44,"NP44 2JE, NP44 2JF, NP44 2JG, NP44 2JH, NP44 2QG",245,230,15
W00007805,NP44,"NP44 2NJ, NP44 2NL, NP44 2NP, NP44 2NT, NP44 2NU, NP44 2QJ",263,246,17
W00007806,NP44,"NP44 2HA, NP44 2HE, NP44 2HJ, NP44 2HL, NP44 2NB, NP44 2NX, NP44 2NY, NP44 2PE, NP44 2PH",261,249,12
W00007807,NP44,"NP44 2LJ, NP44 2LN, NP44 2LP, NP44 2LR, NP44 2LX, NP44 2YJ, NP44 2YT",308,269,39
W00007808,NP44,"NP44 2DW, NP44 2DY, NP44 2JX, NP44 2JZ, NP44 2LD, NP44 2LY",246,235,11
W00007809,NP44,"NP44 2LB, NP44 2LG, NP44 2LH, NP44 2LQ, NP44 2LS, NP44 2LT",238,225,13
W00007828,NP44,"NP44 4AF, NP44 4PW, NP44 4QJ, NP44 4QL, NP44 4QN, NP44 4QQ, NP44 4QR, NP44 4QS, NP44 4QW, NP44 4SZ, NP44 4YY",308,277,31
W00007827,NP44,"NP44 6JF, NP44 6JG",226,214,12
W00007826,NP44,"NP44 5EA, NP44 5EB, NP44 5YY, NP44 6UQ",291,259,32
W00007825,NP44,"NP44 5BN, NP44 5BP, NP44 5LA, NP44 6HY, NP44 6JE, NP44 6JH, NP44 6JN",302,275,27
W00007824,NP44,"NP44 4DB, NP44 4DD, NP44 4DW, NP44 4DY, NP44 4EN, NP44 4EW, NP44 4EY, NP44 4EZ, NP44 4HE, NP44 4HF, NP44 4HN, NP44 4HQ, NP44 4HW",346,311,35
W00007822,NP44,"NP44 4PQ, NP44 4QT, NP44 4QU, NP44 4QX, NP44 4TA, NP44 4TZ, NP44 4YF, NP44 4YZ, NP44 6UA",242,219,23
W00007830,NP44,"NP44 4QA, NP44 4QD, NP44 4QE, NP44 4QP, NP44 4QY, NP44 4QZ, NP44 4RA, NP44 4TY",276,257,19
W00007816,NP44,"NP44 2DA, NP44 2DT, NP44 2DU, NP44 2DZ, NP44 2EH, NP44 2EJ, NP44 2EL, NP44 2HG, NP44 2JY, NP44 2LF, NP44 2XB, NP44 2YS",292,266,26
W00007814,NP44,"NP44 2AS, NP44 2AU, NP44 2AY, NP44 2AZ, NP44 2BB, NP44 2BE, NP44 2BL, NP44 2HF, NP44 2PA, NP44 2PB, NP44 2PG",344,313,31
W00007813,NP44,"NP44 2BG, NP44 2BQ, NP44 2DX, NP44 2EP, NP44 2ER, NP44 2ES, NP44 2ET, NP44 2HD, NP44 2HH, NP44 2HN, NP44 2HP",246,221,25
W00007812,NP44,"NP44 2AH, NP44 2AL, NP44 2AN, NP44 2AP, NP44 2AR, NP44 2AT, NP44 2AW, NP44 2AX, NP44 2BA, NP44 2BD, NP44 2BH, NP44 2BJ, NP44 2YA, NP44 2YB",277,258,19
W00007841,NP44,"NP44 5UE, NP44 5UF, NP44 5UG, NP44 5UJ, NP44 5UR, NP44 5US",322,293,29
W00007811,NP44,"NP44 2EA, NP44 2EB, NP44 2ED, NP44 2EE, NP44 2EF, NP44 2EG, NP44 2EN, NP44 2EQ",308,284,24
W00007810,NP44,"NP44 2QD, NP44 2QF, NP44 2QH, NP44 2QS, NP44 2QT, NP44 2QU, NP44 2QX, NP44 2WP",221,206,15
W00007815,NP44,"NP44 2EU, NP44 2EW, NP44 2EX, NP44 2EY, NP44 2EZ, NP44 2HB, NP44 2LE",277,259,18
W00007842,NP44,"NP44 5AR, NP44 5AU, NP44 5AW, NP44 5ED, NP44 5EE, NP44 5EF",246,227,19
W00008019,NP44,"NP44 5AS, NP44 5SG, NP44 5SH, NP44 5UD",269,246,23
W00007844,NP44,"NP44 4LH, NP44 5UH, NP44 5UL",321,285,36
W00008023,NP44,"NP44 1HD, NP44 1HF, NP44 1HN, NP44 1HR, NP44 1HS, NP44 1HW, NP44 5HB, NP44 5HZ, NP44 5JE",290,275,15
W00008024,NP44,"NP44 1EX, NP44 1HA, NP44 1HB, NP44 1HE, NP44 1HG, NP44 1HJ, NP44 1HQ",248,228,20
W00008025,NP44,"NP44 1AY, NP44 1AZ, NP44 1BB, NP44 1BD, NP44 1BH, NP44 1ES, NP44 1ET, NP44 1EU, NP44 1EY, NP44 1EZ, NP44 1HL, NP44 1JL, NP44 1JP",287,270,17
W00008026,NP44,"NP44 5TT, NP44 5TU, NP44 5TW, NP44 5TX, NP44 5UA, NP44 5UX, NP44 5UY",312,289,23
W00008027,NP44,"NP44 5JQ, NP44 5TA, NP44 5TB, NP44 5TD, NP44 5TJ, NP44 5TN",173,163,10
W00008028,NP44,"NP44 1JN, NP44 1JT, NP44 1JU, NP44 1JW, NP44 1JX, NP44 1JZ, NP44 1LA",294,263,31
W00008029,NP44,"NP44 5HT, NP44 5HU, NP44 5HW, NP44 5HX, NP44 5JF, NP44 5LD, NP44 5LH, NP44 5LJ",347,323,24
W00008030,NP44,"NP44 5JA, NP44 5JB, NP44 5SP",202,188,14
W00007843,NP44,"NP44 5SA, NP44 5SB, NP44 5SD, NP44 5SE, NP44 5SF",316,280,36
W00008031,NP44,"NP44 5SQ, NP44 5SX, NP44 5TH, NP44 5TL",254,237,17
W00008032,NP44,"NP44 5TY, NP44 5UT, NP44 5UU, NP44 5UW, NP44 5UZ, NP44 5XT",331,312,19
W00008033,NP44,"NP44 5SJ, NP44 5SR, NP44 5TZ, NP44 5UB, NP44 5WA, NP44 5YB, NP44 5YG, NP44 5YH, NP44 5YL, NP44 5YR, NP44 5YZ",244,230,14
W00008034,NP44,"NP44 5UN, NP44 5UP, NP44 5UQ",244,222,22
W00008035,NP44,"NP44 1BY, NP44 1DB, NP44 1DD",234,213,21
W00007948,NP44,"NP44 1SA, NP44 1TA, NP44 1TB, NP44 1UA, NP44 1UD, NP44 1XY, NP44 1YR",312,281,31
W00007946,NP44,"NP44 1AQ, NP44 1DL, NP44 1DP, NP44 1LB, NP44 1LN, NP44 1LS, NP44 1LT, NP44 1LU, NP44 1LW",257,240,17
W00007944,NP44,"NP44 1NA, NP44 1ND, NP44 1NH, NP44 1NJ, NP44 1NT, NP44 1NU",293,261,32
W00007930,NP44,"NP44 1LZ, NP44 1NN, NP44 1NW, NP44 1QA, NP44 1QE, NP44 1QQ",304,278,26
W00007931,NP44,"NP44 1LY, NP44 1NE, NP44 1NG, NP44 1NQ, NP44 1PJ, NP44 3EW, NP44 3LN, NP44 3NR",209,193,16
W00007932,NP44,"NP44 1NF, NP44 1PF, NP44 1PY, NP44 1PZ, NP44 1QB, NP44 1QL, NP44 1QP, NP44 1UR, NP44 1UT, NP44 1UZ, NP44 1YG, NP44 4YU",248,239,9
W00007933,NP44,"NP44 1BE, NP44 1BG, NP44 1BJ, NP44 1BQ, NP44 1BW",290,266,24
W00007934,NP44,"NP44 1BL, NP44 1BS, NP44 1EL, NP44 1RT, NP44 1RX, NP44 1RZ, NP44 1SE",277,254,23
W00007935,NP44,"NP44 1QZ, NP44 1RB, NP44 1RD, NP44 1RG, NP44 1RH, NP44 1RN, NP44 1RP, NP44 1RQ, NP44 1RR, NP44 1TS, NP44 1TY, NP44 1TZ, NP44 1UB, NP44 1UF, NP44 1UG, NP44 1UH, NP44 1UU, NP44 1XB, NP44 1XE",403,365,38
W00008022,NP44,"NP44 5TE, NP44 5TF, NP44 5TG, NP44 5TQ",288,264,24
W00007936,NP44,"NP44 1ED, NP44 1ER, NP44 1RS, NP44 1RU, NP44 1RY, NP44 1SF",265,241,24
W00007938,NP44,"NP44 1NB, NP44 1NL, NP44 1NP, NP44 1NR, NP44 1NS, NP44 1NY, NP44 1NZ, NP44 1PG, NP44 1TT, NP44 1TX, NP44 1UE, NP44 1XH, NP44 1YA, NP44 1YL, NP44 2YP, NP44 2YR",299,277,22
W00007939,NP44,"NP44 1EB, NP44 1EF, NP44 1EW, NP44 1RA, NP44 1RE, NP44 1RF",252,235,17
W00007940,NP44,"NP44 1DQ, NP44 1DX, NP44 1EA, NP44 1EG, NP44 1EN, NP44 1EQ, NP44 1LH, NP44 1LJ",195,181,14
W00007941,NP44,"NP44 1AL, NP44 1AR, NP44 1AS, NP44 1AT, NP44 1AU, NP44 1AW, NP44 1AX",303,281,22
W00007942,NP44,"NP44 1AA, NP44 1AD, NP44 1AF, NP44 1AG, NP44 1AN, NP44 1EH, NP44 1EJ, NP44 1EP, NP44 1LP, NP44 1UX, NP44 1UY, NP44 1YQ, NP44 1YZ, NP44 1ZA",252,227,25
W00007943,NP44,"NP44 1AE, NP44 1DN, NP44 1DR, NP44 1DS, NP44 1DT, NP44 1DU, NP44 1DW, NP44 1DY, NP44 1DZ, NP44 1EE, NP44 1PH",254,227,27
W00007937,NP44,"NP44 1BA, NP44 1BN, NP44 1BP, NP44 1BR, NP44 1BT",256,223,33
W00007929,NP44,"NP44 1QX, NP44 2JU, NP44 2JW",188,165,23
W00010334,NP44,"NP44 3EN, NP44 3ER, NP44 3ES, NP44 3ET",180,171,9
W00007966,NP44,"NP44 4LX, NP44 4NA, NP44 4NB, NP44 4ND, NP44 4NF, NP44 4PN, NP44 4PP",270,246,24
W00008018,NP44,"NP44 1FZ, NP44 1JR, NP44 1JS, NP44 1JY, NP44 1LD, NP44 1LE, NP44 1LF, NP44 5LE, NP44 5LF, NP44 5LL",267,244,23
W00008017,NP44,"NP44 6EZ, NP44 6HA, NP44 6HB, NP44 6HH, NP44 6HL, NP44 6HP, NP44 6HR, NP44 6HS, NP44 6HX, NP44 6JB, NP44 6JZ, NP44 6LE",279,267,12
W00008016,NP44,"NP44 6HU, NP44 6HZ, NP44 7AS, NP44 7AT, NP44 7AU, NP44 7AZ",129,118,11
W00008015,NP44,"NP44 7LN, NP44 7LP",138,134,4
W00008014,NP44,NP44 7LR,111,109,2
W00008013,NP44,"NP44 6EQ, NP44 6ES, NP44 6ET, NP44 6EX, NP44 6HN, NP44 6HQ",322,291,31
W00008012,NP44,"NP44 6EA, NP44 6EB, NP44 6ED, NP44 6EE, NP44 6EY, NP44 6HD, NP44 6HW",424,386,38
W00008011,NP44,"NP44 6EH, NP44 6EJ, NP44 6EN, NP44 6ER, NP44 6EU, NP44 6EW",315,285,30
W00008009,NP44,"NP44 7JE, NP44 7JF, NP44 7LH",244,232,12
W00008008,NP44,"NP44 7AF, NP44 7LG, NP44 7LJ, NP44 7LL",265,249,16
W00008007,NP44,"NP44 7JD, NP44 7US, NP44 7UT, NP44 7XP",325,284,41
W00008006,NP44,"NP44 7AD, NP44 7PF, NP44 7PH, NP44 7PJ, NP44 7PL, NP44 7PN, NP44 7UU, NP44 7YE, NP44 7YJ, NP44 7YL, NP44 7YN",281,256,25
W00008005,NP44,"NP44 7AA, NP44 7AB, NP44 7EX, NP44 7HJ, NP44 7HZ, NP44 7LD, NP44 7NZ, NP44 7XN, NP44 7XR",281,261,20
W00008004,NP44,"NP44 7HG, NP44 7NX, NP44 7NY",234,225,9
W00008003,NP44,"NP44 7HL, NP44 7HN, NP44 7HQ, NP44 7HS, NP44 7HW, NP44 7HX, NP44 7LU",243,229,14
W00008002,NP44,"NP44 7JG, NP44 7JQ, NP44 7JR, NP44 7LF",362,335,27
W00008001,NP44,"NP44 7GN, NP44 7JB, NP44 7JH, NP44 7JJ, NP44 7JL, NP44 7JN, NP44 7JP",349,303,46
W00007967,NP44,"NP44 3AA, NP44 3AD, NP44 3AH, NP44 3AL, NP44 3AN, NP44 3BA, NP44 3DG, NP44 3DQ, NP44 3JQ, NP44 3LH, NP44 3LS, NP44 3NS, NP44 3NT, NP44 3NY, NP44 3NZ, NP44 3UZ, NP44 4JZ, NP44 4LT, NP44 4YX, NP44 5AZ, NP44 5BA, NP44 5BD, NP44 5BE, NP44 5BG, NP44 5BH, NP44 5BR, NP44 5XA, NP44 5XB, NP44 5XD, NP44 5XU, NP44 5XW, NP44 5YS, NP44 5YT, NP44 5YU, NP44 5YW, NP44 5YX",308,279,29
W00007969,NP44,"NP44 4AA, NP44 4AB, NP44 4AD, NP44 4RG, NP44 4RH, NP44 4RJ, NP44 4RN, NP44 4RP, NP44 4RQ, NP44 4RS, NP44 4RU",295,259,36
W00007970,NP44,"NP44 3AR, NP44 4LJ, NP44 4LL, NP44 4LN, NP44 4LQ, NP44 4LR, NP44 4PH, NP44 4PJ",255,234,21
W00007971,NP44,"NP44 4NN, NP44 4NR, NP44 4NS, NP44 4NT, NP44 4NU, NP44 4PE, NP44 4RL, NP44 4RR, NP44 4RT, NP44 4RW, NP44 4SY",206,193,13
W00007972,NP44,"NP44 4LS, NP44 4LU, NP44 4NY, NP44 4NZ, NP44 4PA, NP44 4PB, NP44 4PD, NP44 4PF, NP44 4PG",267,239,28
W00007973,NP44,"NP44 4AE, NP44 4NE, NP44 4NG, NP44 4NH, NP44 4NJ, NP44 4NL, NP44 4NP, NP44 4NQ, NP44 4NW, NP44 4NX, NP44 4YT",281,254,27
W00007965,NP44,"NP44 3JA, NP44 3LB, NP44 3LD, NP44 3LE, NP44 3LF, NP44 3LZ, NP44 3NL, NP44 3NP, NP44 3PF, NP44 4HA",294,272,22
W00007974,NP44,"NP44 3JL, NP44 3LG, NP44 3LT, NP44 3LY, NP44 3NE",194,184,10
W00007976,NP44,"NP44 3LJ, NP44 3LQ, NP44 3LU, NP44 3LW, NP44 3NB",207,193,14
W00007977,NP44,"NP44 4HB, NP44 4LP, NP44 4LW, NP44 4LY, NP44 4LZ, NP44 4UA",279,259,20
W00007978,NP44,"NP44 3NF, NP44 3NG, NP44 3NQ, NP44 3NW, NP44 3NX, NP44 3PA, NP44 4PL",184,174,10
W00007998,NP44,"NP44 7JS, NP44 7JY, NP44 7JZ, NP44 7LA, NP44 7LB, NP44 7LE",227,210,17
W00007999,NP44,"NP44 7HP, NP44 7HR, NP44 7HT, NP44 7HU, NP44 7HY, NP44 7PA, NP44 7PB, NP44 7PE",256,245,11
W00008000,NP44,"NP44 7JA, NP44 7JT, NP44 7JU, NP44 7JW, NP44 7JX, NP44 7NE, NP44 7NF",264,245,19
W00007975,NP44,"NP44 3LL, NP44 3LR, NP44 3LX, NP44 3NA, NP44 3ND, NP44 3NH, NP44 3NJ, NP44 3NN, NP44 3NU",274,249,25
W00007928,NP44,"NP44 1QD, NP44 1QF, NP44 1QG, NP44 1QH, NP44 1QJ, NP44 1QN, NP44 1QW",289,277,12
W00007855,NP44,"NP44 3PQ, NP44 3PX, NP44 3QA, NP44 3QD, NP44 3QE, NP44 3QF, NP44 3QP, NP44 3QQ",218,208,10
W00007880,NP44,"NP44 8AD, NP44 8AE, NP44 8AF, NP44 8DG, NP44 8DQ",123,116,7
W00010341,NP44,"NP44 1BX, NP44 1DE, NP44 1DH, NP44 1DJ, NP44 1FA, NP44 1FB, NP44 1FD, NP44 1FQ",441,391,50
W00007860,NP44,"NP44 3AZ, NP44 3DL, NP44 3DN, NP44 3EF, NP44 3EG, NP44 3EP, NP44 3FJ",290,271,19
W00007861,NP44,"NP44 3DU, NP44 3DW, NP44 3DX, NP44 3EY, NP44 3EZ, NP44 3HA",356,337,19
W00007863,NP44,"NP44 3BX, NP44 3DB, NP44 3DS, NP44 3DT, NP44 3DY, NP44 3EA, NP44 3FP",311,291,20
W00007864,NP44,"NP44 3DP, NP44 3DR, NP44 3EJ, NP44 3EL, NP44 3EQ",320,303,17
W00009797,NP44,"NP44 6EL, NP44 6EP",179,167,12
W00009798,NP44,"NP44 7LQ, NP44 7LS",247,227,20
W00009801,NP44,"NP44 6HE, NP44 6HT, NP44 6JW, NP44 6JX",281,267,14
W00007878,NP44,"NP44 8SN, NP44 8TT, NP44 8TU, NP44 8UG, NP44 8UH, NP44 8UN, NP44 8UQ, NP44 8US, NP44 8UT, NP44 8UU, NP44 8UW, NP44 8YN, NP44 8YY",306,283,23
W00007865,NP44,"NP44 3BS, NP44 3BU, NP44 3BY, NP44 3DE, NP44 3DF",278,261,17
W00007866,NP44,"NP44 3AW, NP44 3BT, NP44 3DZ, NP44 3EB, NP44 3ED, NP44 3EH, NP44 3FG, NP44 3GA, NP44 3XB",345,306,39
W00007868,NP44,"NP44 8RF, NP44 8RU, NP44 8RX, NP44 8RZ, NP44 8SA, NP44 8SE, NP44 8SF, NP44 8TS",282,268,14
W00007869,NP44,"NP44 8HN, NP44 8RJ, NP44 8RL, NP44 8RN, NP44 8RR, NP44 8RT, NP44 8RW, NP44 8RY, NP44 8SS",274,258,16
W00007870,NP44,"NP44 8HP, NP44 8HW, NP44 8SL, NP44 8SU, NP44 8SX",311,284,27
W00010345,NP44,"NP44 3AU, NP44 3AX, NP44 3AY, NP44 3FD, NP44 3FT, NP44 3FW, NP44 3HB, NP44 3HD, NP44 3HQ, NP44 3SE, NP44 3UW, NP44 3XF, NP44 3XL, NP44 3XS, NP44 7AH, NP44 7AL, NP44 7AX, NP44 7BB",167,154,13
W00010346,NP44,"NP44 3AS, NP44 3BB, NP44 3BE, NP44 3BG, NP44 3TJ",135,115,20
W00010347,NP44,"NP44 1AP, NP44 1BU, NP44 1RJ, NP44 1RL, NP44 1RW, NP44 1SB, NP44 1SD, NP44 1SG",341,318,23
W00007871,NP44,"NP44 8HR, NP44 8HS, NP44 8RD, NP44 8RH, NP44 8RP, NP44 8RS, NP44 8SB, NP44 8SD, NP44 8SG, NP44 8SJ",234,213,21
W00007873,NP44,"NP44 8TA, NP44 8TB, NP44 8TD, NP44 8TE, NP44 8TF, NP44 8TG, NP44 8TH, NP44 8TJ",273,246,27
W00007874,NP44,"NP44 8ST, NP44 8SY, NP44 8SZ, NP44 8TL, NP44 8TN, NP44 8TP, NP44 8TQ",250,234,16
W00007875,NP44,"NP44 8HU, NP44 8HX, NP44 8JA, NP44 8JH, NP44 8JJ, NP44 8JL, NP44 8JQ",231,222,9
W00010351,NP44,"NP44 3AJ, NP44 3FA, NP44 3FB, NP44 3FQ, NP44 3FR, NP44 3XA",439,391,48
W00007857,NP44,"NP44 3BP, NP44 3BR, NP44 3EE, NP44 3EU, NP44 3HE, NP44 3HF, NP44 3HH, NP44 3HJ, NP44 3HL, NP44 3HS, NP44 3JJ, NP44 3YJ, NP44 3YL",374,345,29
W00007859,NP44,"NP44 3BD, NP44 3EX, NP44 3FS, NP44 3UX, NP44 3UY, NP44 3XJ, NP44 3XZ, NP44 3YN, NP44 3YS, NP44 3ZA, NP44 7AJ, NP44 7AP, NP44 7BA, NP44 7EZ, NP44 7HA, NP44 7HB, NP44 7HD, NP44 7HE, NP44 7HF, NP44 7HH, NP44 7PD, NP44 7PG, NP44 7XA, NP44 7XB, NP44 7XD, NP44 7XE, NP44 7XF, NP44 7XG, NP44 7XH, NP44 7XJ, NP44 7XX, NP44 7XY, NP44 7XZ",261,236,25
W00008020,NP44,"NP44 1HH, NP44 1HP, NP44 1SR, NP44 1SS, NP44 1SY, NP44 1SZ, NP44 5HP, NP44 5HS, NP44 5HY",307,285,22
W00007845,NP44,"NP44 5EG, NP44 5EJ, NP44 5EP",281,272,9
W00007846,NP44,"NP44 4BJ, NP44 4LF, NP44 4SA, NP44 4SE, NP44 4SF, NP44 4SG, NP44 4SH",319,304,15
W00007847,NP44,"NP44 4ST, NP44 4UX, NP44 4UY, NP44 4UZ, NP44 4WA",313,289,24
W00007848,NP44,"NP44 4RD, NP44 4RF, NP44 4SR, NP44 4SU, NP44 4SW, NP44 4SX, NP44 4TD",322,301,21
W00007849,NP44,"NP44 4LA, NP44 4LB, NP44 4RB, NP44 4RE, NP44 4RX, NP44 4RY, NP44 4RZ",290,262,28
W00007850,NP44,"NP44 4SB, NP44 4SD, NP44 4SJ, NP44 4SL, NP44 4SN, NP44 4SP, NP44 4SQ, NP44 4SS, NP44 4TB",287,263,24
W00007856,NP44,"NP44 3JZ, NP44 3LA, NP44 3PG, NP44 3PT, NP44 3PU, NP44 3PY, NP44 3QR, NP44 3QW, NP44 3YG",211,195,16
W00007876,NP44,"NP44 8HT, NP44 8HY, NP44 8HZ, NP44 8JB, NP44 8JD, NP44 8JE, NP44 8JG, NP44 8JN, NP44 8SH",310,287,23
W00007852,NP44,"NP44 1AH, NP44 1AJ, NP44 1BZ, NP44 1DF, NP44 1GD, NP44 1GE, NP44 1NX, NP44 1PA, NP44 1PB, NP44 1PD, NP44 1PE, NP44 1PL, NP44 1PN, NP44 1PP, NP44 1PQ, NP44 1PR, NP44 1PS, NP44 1PT, NP44 1PU, NP44 1PW, NP44 1PX, NP44 1QR, NP44 1QS, NP44 1QT, NP44 1QU, NP44 1UJ, NP44 1UL, NP44 1UN, NP44 1UQ, NP44 1WW, NP44 1WY, NP44 1XA, NP44 1XD, NP44 1XF, NP44 1XG, NP44 1XJ, NP44 1XL, NP44 1XN, NP44 1XP, NP44 1XQ, NP44 1XR, NP44 1XS, NP44 1XT, NP44 1XU, NP44 1XW, NP44 1XX, NP44 1XZ, NP44 1YB, NP44 1YD, NP44 1YE, NP44 1YF, NP44 1YH, NP44 1YJ, NP44 1YN, NP44 1YP, NP44 1YS, NP44 1YT, NP44 1YU, NP44 1YW, NP44 1YX, NP44 1YY, NP44 1ZP, NP44 1ZQ, NP44 1ZW, NP44 1ZY, NP44 2JJ, NP44 2WA, NP44 2WE, NP44 2WY, NP44 2WZ, NP44 2XD, NP44 2XE, NP44 2XF, NP44 2XG, NP44 2XL, NP44 2XN, NP44 2XQ, NP44 2XT, NP44 2YD, NP44 2YE, NP44 2YF, NP44 2YG, NP44 2YH, NP44 2YL, NP44 2YN, NP44 2YU, NP44 2YW, NP44 2YX, NP44 2YY, NP44 2YZ, NP44 3FU, NP44 3PJ, NP44 3QH, NP44 3QS, NP44 3QT, NP44 3UU, NP44 3WG, NP44 3WH, NP44 3WX, NP44 3WY, NP44 3XD, NP44 3XG, NP44 3XN, NP44 3XP, NP44 3XT, NP44 3XU, NP44 3XW, NP44 3XX, NP44 3XY, NP44 3YB, NP44 3YD, NP44 3YE, NP44 3YF, NP44 3YH, NP44 3YP, NP44 3YU, NP44 3ZB, NP44 3ZD, NP44 3ZE, NP44 3ZF, NP44 3ZG, NP44 3ZH, NP44 3ZQ, NP44 3ZR, NP44 4WZ, NP44 4YA, NP44 4YB, NP44 4YD, NP44 4YE, NP44 4YP, NP44 4YW, NP44 4ZR, NP44 5WZ, NP44 5YA, NP44 5YD, NP44 5YE, NP44 5YF, NP44 5YJ, NP44 5YN, NP44 5YQ, NP44 6YA, NP44 6YG, NP44 6YH, NP44 6ZR, NP44 7WY, NP44 7WZ, NP44 7YA, NP44 7YB, NP44 7YD, NP44 7YF, NP44 7YG, NP44 7YH, NP44 7YP, NP44 7YQ, NP44 7YR, NP44 7YS, NP44 8WZ, NP44 8YA, NP44 8YB, NP44 8YD, NP44 8YE, NP44 8YR, NP44 9AA, NP44 9AB, NP44 9AD, NP44 9AE, NP44 9AF, NP44 9AG, NP44 9AH, NP44 9AJ, NP44 9AL, NP44 9AN, NP44 9AP, NP44 9AQ, NP44 9AR, NP44 9AS, NP44 9AT, NP44 9AU, NP44 9AW, NP44 9AX, NP44 9AY, NP44 9BA, NP44 9BB, NP44 9BD, NP44 9BE, NP44 9BF, NP44 9BG, NP44 9BH, NP44 9BJ, NP44 9BL, NP44 9BN, NP44 9BP, NP44 9BQ, NP44 9BR, NP44 9BS, NP44 9BT, NP44 9BU, NP44 9BW, NP44 9BX, NP44 9BY, NP44 9BZ, NP44 9DA, NP44 9DB, NP44 9DD, NP44 9DE, NP44 9DF, NP44 9DG, NP44 9DH, NP44 9DJ, NP44 9DL, NP44 9DN, NP44 9DP, NP44 9DQ, NP44 9DR, NP44 9DS, NP44 9DT, NP44 9DU, NP44 9DW, NP44 9DX, NP44 9DY",141,138,3
W00007854,NP44,"NP44 3PZ, NP44 3QG, NP44 3QJ, NP44 3QL, NP44 3QN, NP44 3QY, NP44 3QZ, NP44 3XR, NP44 8HQ",191,181,10
W00007877,NP44,"NP44 8JF, NP44 8TX, NP44 8TY, NP44 8TZ, NP44 8UA, NP44 8UB, NP44 8UD, NP44 8UE, NP44 8UF, NP44 8UJ, NP44 8UL, NP44 8UP, NP44 8UR",312,281,31
W00010338,NP44,"NP44 1FH, NP44 1FJ, NP44 1FL, NP44 1FN",213,175,38
W00007851,NP44,"NP44 3FF, NP44 3JB, NP44 3JN, NP44 3JP, NP44 3JU, NP44 3JW, NP44 3JX, NP44 3JY, NP44 3TG, NP44 3YT",286,265,21
W00007853,NP44,"NP44 3JR, NP44 3JS, NP44 3JT, NP44 3PB, NP44 3PD, NP44 3PE, NP44 3PH, NP44 3PP, NP44 3PR, NP44 3PS, NP44 3PW, NP44 3QB, NP44 3QU, NP44 3QX, NP44 3XH, NP44 3YA, NP44 3YQ, NP44 3YR",431,405,26
W00008166,NP7,"NP7 8BE, NP7 9AA, NP7 9AB, NP7 9AD, NP7 9AF, NP7 9AG, NP7 9AH, NP7 9AL, NP7 9AN, NP7 9AR, NP7 9AS, NP7 9AT, NP7 9BS, NP7 9BT, NP7 9SH, NP7 9SL, NP7 9SN, NP7 9SS, NP7 9ST, NP7 9SU, NP7 9SY, NP7 9TA, NP7 9TB, NP7 9TF, NP7 9UY, NP7 9YR",323,299,24
W00008229,NP7,"NP7 5SG, NP7 5SH, NP7 5SY, NP7 5TA, NP7 5TL, NP7 5TN, NP7 5TR, NP7 5TU, NP7 5TW, NP7 5UA, NP7 5UB, NP7 5YT, NP7 5ZL",322,295,27
W00010349,NP7,"NP7 9AX, NP7 9AZ, NP7 9PZ, NP7 9QA, NP7 9QB, NP7 9QD",313,278,35
W00008228,NP7,"NP7 5RB, NP7 5RD, NP7 5RE, NP7 5RG, NP7 5RH, NP7 5RN, NP7 5RW, NP7 5TE, NP7 5TF, NP7 5TG",268,243,25
W00008220,NP7,"NP7 5EL, NP7 5LJ, NP7 5LS, NP7 5LT, NP7 5LU, NP7 5NJ, NP7 5NQ",201,179,22
W00008080,NP7,"NP7 8AH, NP7 8EE, NP7 8EF, NP7 8EH, NP7 8ET, NP7 8HG, NP7 8HL, NP7 8HN, NP7 8HR, NP7 8HS, NP7 8HT, NP7 8HU, NP7 8HY, NP7 8LB, NP7 8LD, NP7 8LN, NP7 8NB, NP7 8ND, NP7 8NE, NP7 8NL, NP7 8NN, NP7 8NP, NP7 8NR, NP7 8NS, NP7 8NW, NP7 8RD, NP7 8RE, NP7 8RF, NP7 8RG, NP7 8RH, NP7 8RN, NP7 8RP, NP7 8RR, NP7 8RW, NP7 8SP, NP7 8UP",472,432,40
W00008225,NP7,"NP7 5HQ, NP7 5HX, NP7 5JA, NP7 5JB, NP7 9QZ, NP7 9SJ, NP7 9SP, NP7 9SQ, NP7 9SR, NP7 9SX, NP7 9SZ",239,219,20
W00008079,NP7,"NP7 8AF, NP7 8EP, NP7 8EQ, NP7 8ER, NP7 8ES, NP7 8EX, NP7 8EY, NP7 8HA, NP7 8HB, NP7 8HD, NP7 8HE, NP7 8HF, NP7 8HP, NP7 8LE, NP7 8LF, NP7 8LG, NP7 8LL, NP7 8LP, NP7 8LQ, NP7 8LW",384,346,38
W00008223,NP7,"NP7 5AE, NP7 5AF, NP7 5AG, NP7 5AH, NP7 5AJ, NP7 5AS, NP7 5ER, NP7 5EU, NP7 5HB, NP7 5HD, NP7 5HF, NP7 5JQ, NP7 5JR, NP7 5LD, NP7 5LP, NP7 5LR, NP7 5NA, NP7 5NB, NP7 5ND, NP7 5NE, NP7 5NF, NP7 5NH, NP7 5NL, NP7 5NN, NP7 5NP, NP7 5NR, NP7 5NS, NP7 5NT, NP7 5NU, NP7 5NW, NP7 5PA, NP7 5PB, NP7 5PE, NP7 5PF, NP7 5PG, NP7 5PH, NP7 5PN, NP7 5RU, NP7 5RY, NP7 5SA, NP7 5SD, NP7 5SE, NP7 5TP, NP7 5TS, NP7 5TT, NP7 5YJ",324,304,20
W00010344,NP7,"NP7 9BR, NP7 9LJ, NP7 9NJ, NP7 9NQ, NP7 9NZ",206,198,8
W00008222,NP7,"NP7 5JP, NP7 5LA, NP7 5LB, NP7 5LE, NP7 5LG, NP7 5LL, NP7 5LN, NP7 5LQ, NP7 5LW, NP7 5LY, NP7 5LZ",479,437,42
W00008226,NP7,"NP7 5EY, NP7 5JS, NP7 5PJ, NP7 5PP, NP7 5PQ, NP7 5PR, NP7 5PS, NP7 5PU, NP7 5PY, NP7 5RA, NP7 5RJ, NP7 5SP, NP7 5SR, NP7 5TD",295,273,22
W00008224,NP7,"NP7 5HG, NP7 5HH, NP7 5HL, NP7 5HN, NP7 5HS, NP7 5HT, NP7 5HW, NP7 5HY, NP7 5HZ, NP7 5LF, NP7 5LH",297,272,25
W00008078,NP7,"NP7 7LB, NP7 7LD, NP7 7LF, NP7 7LG, NP7 7LH, NP7 7LJ, NP7 7LN, NP7 7LW, NP7 7NB, NP7 7ND, NP7 8DA, NP7 8DB, NP7 8DD, NP7 8DG, NP7 8DJ",282,255,27
W00009818,NP7,"NP7 5JD, NP7 5JU, NP7 5JZ, NP7 5RF, NP7 6AJ, NP7 6AQ",246,220,26
W00008168,NP7,"NP7 8LH, NP7 8LR, NP7 8LS, NP7 8LT, NP7 8LU, NP7 8LY, NP7 8NA, NP7 8PB, NP7 8PD, NP7 8PE, NP7 8PF, NP7 8PG, NP7 8PH, NP7 8PL, NP7 8PN, NP7 8PP, NP7 8PR, NP7 8PS, NP7 8PT, NP7 8PW, NP7 8UA, NP7 8UB, NP7 8UF, NP7 8UG, NP7 8UH, NP7 8UN, NP7 8WB",326,300,26
W00008173,NP7,"NP7 9NT, NP7 9NU, NP7 9NY, NP7 9PA, NP7 9PD, NP7 9PF, NP7 9PH, NP7 9PN, NP7 9RL, NP7 9SG",313,281,32
W00008174,NP7,"NP7 9PJ, NP7 9PQ, NP7 9PS, NP7 9PT, NP7 9PU, NP7 9PW, NP7 9PY, NP7 9RF, NP7 9SA, NP7 9SB, NP7 9SD",257,232,25
W00008175,NP7,"NP7 9BZ, NP7 9PG, NP7 9PP, NP7 9PR",260,245,15
W00008176,NP7,"NP7 9PL, NP7 9RA, NP7 9RB, NP7 9RD, NP7 9RE, NP7 9RG, NP7 9RJ",220,185,35
W00008178,NP7,"NP7 6NT, NP7 6NU, NP7 6NY, NP7 6PA, NP7 6PB, NP7 6PR, NP7 6PS, NP7 6PT, NP7 6PU, NP7 6PY, NP7 7HR, NP7 7HS, NP7 7HT, NP7 7LE, NP7 8AR, NP7 8AS, NP7 8AT, NP7 8AU, NP7 8AY, NP7 8BA, NP7 8BB, NP7 8BD, NP7 8BY, NP7 8DE, NP7 8DF, NP7 8NF",487,437,50
W00008179,NP7,"NP7 8AA, NP7 8AB, NP7 8AD, NP7 8AE, NP7 8AG, NP7 8AP, NP7 8AW, NP7 8BG, NP7 8BH, NP7 8BL, NP7 8BU, NP7 8NG, NP7 8NH",249,218,31
W00008180,NP7,"NP7 6AP, NP7 6AS, NP7 6AX, NP7 6AZ, NP7 6BB, NP7 6BD, NP7 6LH, NP7 6LN, NP7 6LS, NP7 6LT, NP7 6LU, NP7 6LY, NP7 6LZ, NP7 6PQ, NP7 6PX, NP7 6QA, NP7 7HN",494,462,32
W00008181,NP7,"NP7 6HQ, NP7 6HU, NP7 6HY, NP7 6LA, NP7 6LB, NP7 6LJ, NP7 6LL, NP7 6NA, NP7 6NB, NP7 6ND, NP7 6NE, NP7 6NF, NP7 6NH, NP7 6NL",282,251,31
W00008182,NP7,"NP7 6JX, NP7 6JY, NP7 6JZ, NP7 6LD, NP7 6LE, NP7 6LF, NP7 6LG, NP7 6LP, NP7 6LQ, NP7 6LR, NP7 6LW, NP7 6LX, NP7 6NJ, NP7 6PJ, NP7 6PW, NP7 6PZ",441,402,39
W00008183,NP7,"NP7 6BA, NP7 6PH, NP7 6PL, NP7 6PN",335,294,41
W00008184,NP7,"NP7 6HD, NP7 6HJ, NP7 6HT, NP7 6HX, NP7 6NG, NP7 6PP",237,214,23
W00010323,NP7,"NP7 9LL, NP7 9LW, NP7 9LZ, NP7 9PX",199,177,22
W00010317,NP7,"NP7 9AQ, NP7 9FJ, NP7 9LQ, NP7 9QF",278,253,25
W00008165,NP7,"NP7 8BN, NP7 8BP, NP7 8BS, NP7 8BT, NP7 8BW, NP7 8SA, NP7 8SB, NP7 8SD, NP7 8SE, NP7 8SF, NP7 9TD, NP7 9TE, NP7 9TG, NP7 9TH, NP7 9TL, NP7 9TN, NP7 9TP, NP7 9TR, NP7 9TS, NP7 9TT, NP7 9TU, NP7 9TW, NP7 9TY, NP7 9UD, NP7 9UF, NP7 9UG, NP7 9UH, NP7 9UL, NP7 9UT, NP7 9UU, NP7 9YH",367,339,28
W00009820,NP7,"NP7 5DZ, NP7 5JT, NP7 5LX, NP7 5YY, NP7 5ZY",159,144,15
W00009819,NP7,"NP7 5JW, NP7 5JX, NP7 5JY, NP7 5RL, NP7 5RP, NP7 5RR, NP7 5RS",211,189,22
W00008167,NP7,"NP7 9AJ, NP7 9AP, NP7 9AU, NP7 9AW, NP7 9AY, NP7 9BA, NP7 9BB, NP7 9BD, NP7 9BE, NP7 9BG, NP7 9DF, NP7 9DS, NP7 9DT, NP7 9DU, NP7 9DY, NP7 9DZ, NP7 9EA, NP7 9UN, NP7 9UP, NP7 9UR, NP7 9UW, NP7 9YE, NP7 9YF",311,286,25
W00008164,NP7,"NP7 9AE, NP7 9BY, NP7 9DA, NP7 9DB, NP7 9DD, NP7 9DE, NP7 9DG, NP7 9ED, NP7 9EE, NP7 9EF, NP7 9EQ, NP7 9ER, NP7 9ES, NP7 9ET, NP7 9EU, NP7 9EY, NP7 9HA, NP7 9HB, NP7 9HD, NP7 9HY, NP7 9LA, NP7 9YD",324,309,15
W00008227,NP7,"NP7 5PW, NP7 5SL, NP7 5SN, NP7 5SS, NP7 5SU, NP7 5SW, NP7 5TB",212,200,12
W00008153,NP7,"NP7 7ER, NP7 7ES, NP7 7ET, NP7 7EU, NP7 7EY, NP7 7LA, NP8 1EP",143,125,18
W00008061,NP7,"NP7 7AB, NP7 7AD, NP7 7AE, NP7 7AG, NP7 7AN, NP7 7AW, NP7 7EH, NP7 7EJ, NP7 7EN",257,241,16
W00008060,NP7,"NP7 7AR, NP7 7AT, NP7 7AU, NP7 7AY, NP7 7BA, NP7 7BB, NP7 7BH, NP7 7EW, NP7 7HF",272,240,32
W00008059,NP7,"NP7 6DH, NP7 6DN, NP7 6DP, NP7 6DR, NP7 6DT, NP7 7AF, NP7 7AQ, NP7 7RP, NP7 7RS",402,364,38
W00008058,NP7,"NP7 6DB, NP7 6DF, NP7 6DG, NP7 6DX, NP7 6EH, NP7 6EP, NP7 6ER, NP7 6EW, NP7 7YA",245,231,14
W00008125,NP7,"NP7 5TH, NP7 6BG, NP7 6BU, NP7 6DA, NP7 6DJ, NP7 6EF",236,212,24
W00008126,NP7,"NP7 6AL, NP7 6AN, NP7 6BL, NP7 6BN, NP7 6BS, NP7 6BW, NP7 6BY",253,236,17
W00008127,NP7,"NP7 6EE, NP7 6EJ, NP7 6EL",235,202,33
W00008128,NP7,"NP7 6AA, NP7 6AB, NP7 6AE, NP7 6AF, NP7 6AG, NP7 6AH, NP7 6AW",276,245,31
W00008154,NP7,"NP7 7EP, NP7 9BQ, NP7 9LF, NP7 9LG, NP7 9LH, NP7 9LP, NP7 9LR, NP7 9LX, NP7 9NG, NP7 9NH, NP7 9NL, NP7 9NN, NP7 9NP, NP7 9NR, NP7 9NW, NP7 9NX, NP7 9PB, NP7 9PE, NP7 9YA, NP7 9YB",253,242,11
W00008057,NP7,"NP7 7AJ, NP7 7AS, NP7 7BD, NP7 7BE, NP7 7BL, NP7 7BN, NP7 7BR, NP7 7BS, NP7 7BU, NP7 7BW, NP7 7DB, NP7 7DE, NP7 7HA, NP7 7HE, NP7 7HG, NP7 7HH, NP7 7HL, NP7 7HU, NP7 7HY, NP7 7RJ, NP7 7RW, NP7 7YD, NP7 7YJ",357,316,41
W00009790,NP7,"NP7 7LR, NP8 1DF, NP8 1EB, NP8 1ED, NP8 1HF, NP8 1SJ, NP8 1SQ, NP8 1SR, NP8 1SS, NP8 1ST, NP8 1SU, NP8 1TA, NP8 1TB, NP8 1TD",267,252,15
W00008119,NP7,"NP7 0WA, NP7 0WW, NP7 0WX, NP7 0WY, NP7 0WZ, NP7 0YA, NP7 0YB, NP7 0YE, NP7 0YF, NP7 0YG, NP7 0YQ, NP7 0ZR, NP7 1AB, NP7 1AG, NP7 1AJ, NP7 1AN, NP7 1AP, NP7 1AU, NP7 1AW, NP7 1AX, NP7 1AY, NP7 1BB, NP7 1BD, NP7 1BE, NP7 1BF, NP7 1BG, NP7 1BH, NP7 1BJ, NP7 1BL, NP7 1BN, NP7 1BP, NP7 1BQ, NP7 1BR, NP7 1BS, NP7 1BT, NP7 1BU, NP7 1BW, NP7 1BX, NP7 1BY, NP7 1BZ, NP7 1DA, NP7 1DB, NP7 1DD, NP7 1DE, NP7 1DF, NP7 1DG, NP7 1DJ, NP7 1DL, NP7 1DN, NP7 1DP, NP7 1DQ, NP7 1DR, NP7 1DS, NP7 1DT, NP7 1DU, NP7 1DW, NP7 1DX, NP7 1DY, NP7 1DZ, NP7 1EA, NP7 1EB, NP7 5AA, NP7 5AB, NP7 5AD, NP7 5AN, NP7 5AP, NP7 5AR, NP7 5AT, NP7 5AU, NP7 5AX, NP7 5AZ, NP7 5BA, NP7 5BD, NP7 5BG, NP7 5BJ, NP7 5BP, NP7 5BQ, NP7 5DJ, NP7 5DL, NP7 5EB, NP7 5ED, NP7 5EE, NP7 5EF, NP7 5EG, NP7 5EH, NP7 5EJ, NP7 5EN, NP7 5EP, NP7 5EQ, NP7 5ET, NP7 5EW, NP7 5HA, NP7 5HU, NP7 5NG, NP7 5PL, NP7 5RT, NP7 5SB, NP7 5TY, NP7 5WQ, NP7 5WR, NP7 5WS, NP7 5WT, NP7 5WU, NP7 5WW, NP7 5WX, NP7 5WY, NP7 5WZ, NP7 5XB, NP7 5XD, NP7 5XF, NP7 5XQ, NP7 5XS, NP7 5XT, NP7 5XU, NP7 5XW, NP7 5XX, NP7 5XY, NP7 5XZ, NP7 5YF, NP7 5YG, NP7 5YH, NP7 5YL, NP7 5YN, NP7 5YS, NP7 5YX, NP7 5YZ, NP7 5ZH, NP7 5ZJ, NP7 5ZS, NP7 5ZT, NP7 6WB, NP7 6WX, NP7 6WY, NP7 6WZ, NP7 6YA, NP7 6YD, NP7 6YE, NP7 6YF, NP7 6YG, NP7 7WU, NP7 7WW, NP7 7WY, NP7 7WZ, NP7 7YB, NP7 7YE, NP7 7YF, NP7 7YG, NP7 7YH, NP7 7YL, NP7 7YN, NP7 7YR, NP7 7YZ, NP7 7ZH, NP7 7ZR, NP7 7ZW, NP7 7ZX, NP7 8WA, NP7 8WX, NP7 8WY, NP7 8WZ, NP7 8YA, NP7 8YB, NP7 8YD, NP7 8YE, NP7 8YF, NP7 8YG, NP7 8YH, NP7 8YJ, NP7 8YL, NP7 8YU, NP7 8ZR, NP7 9WA, NP7 9WB, NP7 9WW, NP7 9WX, NP7 9WY, NP7 9WZ, NP7 9YG, NP7 9YL, NP7 9YN, NP7 9YP, NP7 9YQ, NP7 9YS, NP7 9YU, NP7 9YW, NP7 9YY, NP7 9YZ, NP7 9ZA, NP7 9ZB, NP8 1WW, NP8 1WX, NP8 1WY, NP8 1WZ, NP8 1XA, NP8 1XD, NP8 1XF, NP8 1YA, NP8 1YD, NP8 1YE, NP8 1YF, NP8 1YG, NP8 1YH, NP8 1YJ, NP8 1YN, NP8 1YP, NP8 1YR",286,276,10
W00008118,NP7,"NP7 5BT, NP7 5BU, NP7 5DA, NP7 5DD, NP7 5DY, NP7 5UF, NP7 5UG, NP7 5UY, NP7 5YB",260,223,37
W00008138,NP7,"NP7 0PE, NP7 0PH, NP7 0PL, NP7 0PN, NP7 0PT, NP7 0PW, NP7 0PY, NP7 0RA",317,290,27
W00008139,NP7,"NP7 0AR, NP7 0BB, NP7 0BX, NP7 0DE, NP7 0DF, NP7 0DG, NP7 0DH, NP7 0DL, NP7 0DN, NP7 0DP, NP7 0DR, NP7 0EE, NP7 0EG, NP7 0EH",312,294,18
W00008140,NP7,"NP7 0BU, NP7 0BY, NP7 0DD, NP7 0DY, NP7 0EN, NP7 0EP, NP7 0EW, NP7 0HF, NP7 0HW",261,235,26
W00008141,NP7,"NP7 0DA, NP7 0DB, NP7 0DW, NP7 0EL, NP7 0RL, NP7 0RN, NP7 0RP, NP7 0RW",326,298,28
W00008062,NP7,"NP7 5AL, NP7 5BX, NP7 5BZ, NP7 5PD, NP7 5UD, NP7 5UH, NP7 7DA, NP7 7DD, NP7 7DH, NP7 7RN",290,258,32
W00008142,NP7,"NP7 0AA, NP7 0AB, NP7 0AD, NP7 0AE, NP7 0AG, NP7 0AH, NP7 0AJ, NP7 0AN, NP7 0AW, NP7 0DX, NP7 0ED, NP7 0EJ, NP7 0FA",432,382,50
W00008063,NP7,"NP7 7AA, NP7 7BQ, NP7 7BT, NP7 7DF, NP7 7DG, NP7 7DR, NP7 7DS, NP7 7EB",268,233,35
W00008065,NP7,"NP7 7AH, NP7 7AL, NP7 7AP, NP7 7DU, NP7 7DY, NP7 7EA, NP7 7ED, NP7 7EE, NP7 7RD, NP7 7RE, NP7 7RU",339,316,23
W00008077,NP7,"NP7 8DP, NP7 8DT, NP7 8DW, NP7 8EA, NP7 8ED, NP7 8EG, NP7 8EL, NP7 8EN, NP7 8EW, NP7 8RS, NP7 8RU",293,260,33
W00008076,NP7,"NP7 7PD, NP7 7PE, NP7 8AN, NP7 8DH, NP7 8DL, NP7 8DN, NP7 8DQ, NP7 8DU, NP7 8DX, NP7 8HW, NP7 8RT",321,287,34
W00008075,NP7,"NP7 7LL, NP7 7LS, NP7 7LT, NP7 7LU, NP7 7NA, NP7 7NE, NP7 7NF, NP7 7NG, NP7 7NH, NP7 7NL, NP7 7NN, NP7 7NR, NP7 7NS, NP7 7NT, NP7 7NU, NP7 7NW, NP7 7NY, NP7 7PA, NP7 7PB, NP7 7PF, NP7 7PG, NP7 7PH, NP7 8DR, NP7 8DS",295,266,29
W00008074,NP7,"NP7 6HA, NP7 6HH, NP7 6HN, NP7 6HP, NP7 6HR, NP7 6HZ, NP7 6JA, NP7 6YB",248,229,19
W00008073,NP7,"NP7 6HB, NP7 6HE, NP7 6HF, NP7 6HW, NP7 6XB",242,217,25
W00008072,NP7,"NP7 6AT, NP7 6AY, NP7 6BE, NP7 6BQ, NP7 6HG, NP7 6HL, NP7 6XA",292,271,21
W00008071,NP7,"NP7 6AU, NP7 6NN, NP7 6NP, NP7 6NQ, NP7 6NR, NP7 6NS, NP7 6NW",230,208,22
W00008070,NP7,"NP7 6AD, NP7 6BJ, NP7 6EU, NP7 6EY, NP7 6PD, NP7 6PE",317,293,24
W00008069,NP7,"NP7 6HS, NP7 6PF, NP7 6PG, NP7 6XD, NP7 6XE, NP7 6XF, NP7 6XG, NP7 6XH, NP7 6XJ, NP7 6XL",247,226,21
W00008068,NP7,"NP7 5EX, NP7 5HE, NP7 5HJ, NP7 5HP, NP7 5HR",101,97,4
W00008120,NP7,"NP7 5AW, NP7 5BL, NP7 5BN, NP7 5BS, NP7 5BW, NP7 5DS, NP7 5DU, NP7 5ES, NP7 5UE, NP7 5XA",232,206,26
W00008121,NP7,"NP7 5BB, NP7 5BE, NP7 5BH, NP7 5BY, NP7 5DB, NP7 5DE, NP7 5DH, NP7 5DN, NP7 5DP, NP7 5DQ, NP7 5DR, NP7 5DT, NP7 5DW, NP7 5DX, NP7 5EA",259,237,22
W00008122,NP7,"NP7 5DF, NP7 5DG, NP7 5UL, NP7 5UN, NP7 5UP, NP7 5UW, NP7 5YD, NP7 5YE",253,222,31
W00008123,NP7,"NP7 6AR, NP7 6BP, NP7 6BR, NP7 6DL, NP7 6EB, NP7 6ED",271,256,15
W00008124,NP7,"NP7 6BH, NP7 6BT, NP7 6DY, NP7 6EA, NP7 6EG, NP7 6EN, NP7 6EQ",273,252,21
W00008067,NP7,"NP7 9BP, NP7 9JA, NP7 9JB, NP7 9JD, NP7 9JE, NP7 9JF, NP7 9JG, NP7 9JH, NP7 9JJ, NP7 9JL, NP7 9JN, NP7 9SW",309,276,33
W00008066,NP7,"NP7 6DD, NP7 6DE, NP7 6DU, NP7 6DW",299,274,25
W00008064,NP7,"NP7 5AQ, NP7 5AY, NP7 7DL, NP7 7DN, NP7 7DP, NP7 7DT, NP7 7DW, NP7 7RA",273,249,24
W00008143,NP7,"NP7 0BA, NP7 0BD, NP7 0BE, NP7 0BH, NP7 0EA, NP7 0EX",273,252,21
W00008136,NP7,"NP7 0DQ, NP7 0DZ, NP7 0ER, NP7 0ES, NP7 0ET, NP7 0EU, NP7 0EY, NP7 0HA, NP7 0HB, NP7 0HD, NP7 0HE, NP7 0YD",229,211,18
W00008116,NP7,"NP7 5UR, NP7 7AX, NP7 7EG, NP7 7EL, NP7 7RB, NP7 7RF, NP7 7RG, NP7 7RH, NP7 7RL, NP7 7RQ, NP7 7RR, NP7 7RT, NP7 7RX, NP7 7RY, NP7 7RZ, NP7 7SA, NP7 7YP",250,228,22
W00008145,NP7,"NP7 0BJ, NP7 0BL, NP7 0BP, NP7 0EZ",315,282,33
W00008147,NP7,"NP7 0LJ, NP7 0LR, NP7 0LS, NP7 0LT, NP7 0LU, NP7 0LY, NP7 0LZ, NP7 0NA, NP7 0NB, NP7 0ND, NP7 0NE, NP7 0NF, NP7 0NH",310,277,33
W00008148,NP7,"NP7 0HG, NP7 0HH, NP7 0LE, NP7 0LW, NP7 0NN, NP7 0NP, NP7 0NR, NP7 0NS, NP7 0NU, NP7 0NW, NP7 0NY, NP7 0PA, NP7 0PB, NP7 0PD, NP7 0PF, NP7 0PG, NP7 0PP, NP7 0PR, NP7 0PS, NP7 0PU, NP7 0PZ, NP7 0RE, NP7 0RF, NP7 0RG, NP7 0RH",355,319,36
W00008117,NP7,"NP7 5UU, NP7 5UZ, NP7 5YA",229,209,20
W00008152,NP7,"NP7 9HJ, NP7 9HN, NP7 9HW",246,225,21
W00008150,NP7,"NP7 9FD, NP7 9FE, NP7 9FF, NP7 9FL, NP7 9LD, NP7 9LE, NP7 9LN, NP7 9LS, NP7 9LT, NP7 9ND, NP7 9NE, NP7 9NF, NP7 9NS",467,424,43
W00008151,NP7,"NP7 9BU, NP7 9BX, NP7 9DQ, NP7 9EB, NP7 9EJ, NP7 9HE, NP7 9HF, NP7 9HG, NP7 9HH, NP7 9HL, NP7 9HP, NP7 9HR, NP7 9HS, NP7 9HT, NP7 9HU, NP7 9LB, NP7 9YJ, NP7 9YT, NP7 9YX",244,205,39
W00008149,NP7,"NP7 9JZ, NP7 9LU, NP7 9LY, NP7 9NA, NP7 9NB",217,200,17
W00008144,NP7,"NP7 0AX, NP7 0AY, NP7 0AZ, NP7 0BG, NP7 0BN, NP7 0BS, NP7 0BT, NP7 0DS, NP7 0DT, NP7 0EB, NP7 0EQ",314,294,20
W00002320,NP8,"NP8 1AA, NP8 1AB, NP8 1AD, NP8 1AE, NP8 1AF, NP8 1AG, NP8 1AQ, NP8 1AU, NP8 1AX, NP8 1BB, NP8 1BD, NP8 1BE, NP8 1BH, NP8 1BJ, NP8 1BL, NP8 1BN, NP8 1BP, NP8 1BQ, NP8 1BS, NP8 1BW, NP8 1DE, NP8 1DT, NP8 1SL, NP8 1ZR, NP8 1ZW, NP8 1ZY",246,231,15
W00002321,NP8,"NP8 1AW, NP8 1DH, NP8 1DJ, NP8 1DL, NP8 1DN, NP8 1RB, NP8 1SE, NP8 1SF",297,268,29
W00002323,NP8,"NP8 1BT, NP8 1BY, NP8 1BZ, NP8 1DD, NP8 1DQ, NP8 1EZ, NP8 1SW",355,311,44
W00002324,NP8,"NP8 1AH, NP8 1AJ, NP8 1AL, NP8 1AN, NP8 1AP, NP8 1AZ, NP8 1BX, NP8 1ER, NP8 1EX, NP8 1SN",286,260,26
W00009787,NP8,"NP8 1AT, NP8 1DG, NP8 1DP, NP8 1DR, NP8 1DU, NP8 1DW, NP8 1DX, NP8 1DY",374,335,39
W00002325,NP8,"NP8 1EA, NP8 1EE, NP8 1EF, NP8 1EG, NP8 1EH, NP8 1EJ, NP8 1EL, NP8 1EN, NP8 1ES, NP8 1ET, NP8 1EU, NP8 1EW, NP8 1EY, NP8 1HA, NP8 1HB, NP8 1HD, NP8 1HE, NP8 1TE, NP8 1TF, NP8 1TG, NP8 1TH, NP8 1TJ, NP8 1TL, NP8 1TN, NP8 1TP, NP8 1WB, NP8 1XB, NP8 1XE, NP8 1XG, NP8 1XH, NP8 1XJ, NP8 1XL, NP8 1XN, NP8 1XP",415,376,39
W00002467,NP8,"NP8 1HU, NP8 1HY, NP8 1LA, NP8 1LQ, NP8 1PA, NP8 1PB, NP8 1PD, NP8 1PE, NP8 1PF, NP8 1PJ, NP8 1PL",256,234,22
W00002475,NP8,"NP8 1LS, NP8 1LX, NP8 1NA, NP8 1NB, NP8 1NE, NP8 1NF, NP8 1NG, NP8 1NQ, NP8 1NX, NP8 1NZ",357,314,43
W00009788,NP8,"NP8 1BR, NP8 1DA, NP8 1DB, NP8 1DS, NP8 1SD",354,318,36
W00002465,NP8,"NP8 1EQ, NP8 1HH, NP8 1HL, NP8 1HN, NP8 1HP, NP8 1HQ, NP8 1HR, NP8 1HS, NP8 1HT, NP8 1HW, NP8 1LB, NP8 1LD, NP8 1LF, NP8 1LG, NP8 1LH, NP8 1LJ, NP8 1LZ, NP8 1PN, NP8 1PP, NP8 1QA",362,323,39
W00002466,NP8,"NP8 1DZ, NP8 1HG, NP8 1HX, NP8 1LE, NP8 1LP, NP8 1LW, NP8 1PG, NP8 1PH, NP8 1PQ, NP8 1PR, NP8 1PS, NP8 1PT, NP8 1PU, NP8 1PW, NP8 1PY, NP8 1PZ, NP8 1YB, NP8 1YL",313,277,36
W00002477,NP8,"NP8 1NH, NP8 1NJ, NP8 1NL, NP8 1NN, NP8 1NR, NP8 1NT, NP8 1NY",290,260,30
W00002476,NP8,"NP8 1LL, NP8 1LN, NP8 1LR, NP8 1LT, NP8 1LU, NP8 1LY, NP8 1ND, NP8 1NP, NP8 1NS, NP8 1NU, NP8 1NW, NP8 1PX",374,336,38
W00009789,NP8,"NP8 1AR, NP8 1AS, NP8 1AY, NP8 1BA, NP8 1BG, NP8 1BU",155,134,21
W00010075,SA1,"SA1 1BE, SA1 1HB, SA1 1LE, SA1 1LF, SA1 1LG, SA1 1LQ, SA1 1LR, SA1 1LS, SA1 1NY, SA1 1NZ, SA1 1PH, SA1 2AJ, SA1 2AQ, SA1 2AR, SA1 2DJ, SA1 3BB, SA1 3BD, SA1 3BS, SA1 3BY, SA1 3DF, SA1 3ET, SA1 3SG, SA1 5AA, SA1 5AB, SA1 5AD, SA1 5AF, SA1 5AG, SA1 5AH, SA1 5AN, SA1 5AS, SA1 5AT, SA1 5AY, SA1 5AZ, SA1 5BE, SA1 5BL, SA1 5BR, SA1 5BS, SA1 5BW, SA1 5BX, SA1 5BY, SA1 5BZ, SA1 5DA, SA1 5DB, SA1 5DF, SA1 5DJ, SA1 5DP, SA1 5DR, SA1 5DW, SA1 5EB, SA1 5HG, SA1 5HQ, SA1 5HX, SA1 5LF, SA1 5LQ, SA1 5LR, SA1 5LS, SA1 5UH",313,299,14
W00010090,SA1,"SA1 1AF, SA1 1BH, SA1 1BJ, SA1 1BN, SA1 1DE, SA1 1DF, SA1 1DG, SA1 1DH, SA1 1DJ, SA1 1DL, SA1 1DN, SA1 1DP, SA1 1DQ, SA1 1DS, SA1 1DW, SA1 1DY, SA1 1DZ, SA1 1EG, SA1 1EN, SA1 1EP, SA1 1EQ, SA1 1EW, SA1 1EZ, SA1 1FH, SA1 1FR, SA1 1FX, SA1 1GD, SA1 1GP, SA1 1GR, SA1 1HA, SA1 1HH, SA1 1HZ, SA1 1JB, SA1 1JD, SA1 1JE, SA1 1JF, SA1 1JJ, SA1 1JL, SA1 1JP, SA1 1JQ, SA1 1JU, SA1 1JX, SA1 1PR, SA1 1SJ, SA1 1SP, SA1 1SR, SA1 1TQ, SA1 1WN, SA1 1WP, SA1 1WT, SA1 1XP, SA1 1XS, SA1 1XT, SA1 1XU, SA1 1YT, SA1 1ZE, SA1 1ZL, SA1 2AB, SA1 2AD, SA1 2AE, SA1 2AF, SA1 2AG, SA1 2AH, SA1 2AL, SA1 2AP, SA1 2AS, SA1 2AT, SA1 2AU, SA1 2AX, SA1 2BA, SA1 2DH, SA1 3LH, SA1 3LR, SA1 3LT, SA1 3LW, SA1 3LY, SA1 3LZ, SA1 3ND, SA1 3NE, SA1 3PP, SA1 3PU, SA1 3RP, SA1 3RR, SA1 3RS, SA1 3RT, SA1 4NX, SA1 5AE, SA1 5BH, SA1 5BN, SA1 5EW, SA1 5EY, SA1 5HA, SA1 5HB, SA1 5HD, SA1 5HE, SA1 5HF, SA1 5HZ, SA1 5LH, SA1 5LW, SA1 5TH, SA1 8AB, SA1 8AD, SA1 8AE, SA1 8AQ",263,250,13
W00010091,SA1,"SA1 1LB, SA1 3BU, SA1 3BX, SA1 3NS, SA1 3RA, SA1 3XD, SA1 3XE, SA1 3XF, SA1 3XG, SA1 3XH",142,129,13
W00010093,SA1,"SA1 1AZ, SA1 1FZ, SA1 1SA, SA1 1SG, SA1 1UN",209,190,19
W00010094,SA1,"SA1 1FY, SA1 1RZ",178,157,21
W00010097,SA1,"SA1 1AU, SA1 1HN, SA1 1HP, SA1 1QP, SA1 1QX, SA1 1RB, SA1 1RD, SA1 1RF, SA1 1RS, SA1 1RT, SA1 1TT, SA1 1UE, SA1 1UP, SA1 1WG, SA1 3XL, SA1 3YG, SA1 8JA, SA1 8JB, SA1 8JD",219,205,14
W00010239,SA1,"SA1 8AH, SA1 8AJ",117,109,8
W00010072,SA1,"SA1 1JN, SA1 1JW, SA1 1PG, SA1 3RZ, SA1 3SD, SA1 3SF, SA1 3SJ, SA1 3SL, SA1 3SN, SA1 3SS, SA1 3SW, SA1 9AX, SA1 9SA, SA1 9SB, SA1 9SD, SA1 9SE, SA1 9SF, SA1 9SG, SA1 9SH, SA1 9SJ, SA1 9SL, SA1 9SN, SA1 9SP, SA1 9SQ, SA1 9SR, SA1 9SS, SA1 9ST, SA1 9SU, SA1 9SW, SA1 9SX, SA1 9SY, SA1 9SZ, SA1 9TA, SA1 9TB, SA1 9TD, SA1 9TE, SA1 9TF, SA1 9TG, SA1 9TH, SA1 9TJ, SA1 9TL, SA1 9TN, SA1 9TP, SA1 9TQ, SA1 9TR, SA1 9TS, SA1 9TT, SA1 9TU, SA1 9TW, SA1 9TX, SA1 9UA, SA1 9ZZ",135,124,11
W00010242,SA1,"SA1 7AN, SA1 7AW, SA1 7ET",284,267,17
W00010240,SA1,"SA1 1DB, SA1 3JL, SA1 8JE, SA1 8PL, SA1 8PP, SA1 8PY",198,183,15
W00010096,SA1,"SA1 1PL, SA1 1XR, SA1 1YG, SA1 1YH, SA1 1YJ, SA1 1YQ, SA1 1YW, SA1 1YX, SA1 1YZ",132,113,19
W00010070,SA1,"SA1 3TS, SA1 3UL, SA1 3UP",251,233,18
W00004650,SA1,"SA1 5TQ, SA2 0DS, SA2 0ET, SA2 0HR, SA2 0HT, SA2 0HU, SA2 0HW",418,372,46
W00004671,SA1,"SA1 6BS, SA1 6JH, SA1 6JW",220,198,22
W00004668,SA1,"SA1 1UY, SA1 6DA, SA1 6DB, SA1 6DD, SA1 6DH, SA1 6HU, SA1 6HX, SA1 6JX, SA1 6JY, SA1 6NT",319,293,26
W00004658,SA1,"SA1 4HQ, SA1 4LN, SA1 4LU, SA1 4LX, SA1 4LY, SA1 4NW",402,353,49
W00004656,SA1,"SA1 4BL, SA1 4JE, SA1 4JF, SA1 4JG, SA1 4JH, SA1 4JJ, SA1 4JL, SA1 4JQ, SA1 4ND, SA1 4NE",461,419,42
W00004655,SA1,"SA1 4LH, SA1 4LJ, SA1 4LL, SA1 4LW, SA1 4NG, SA1 4NY, SA1 4NZ, SA1 4QT, SA1 4QX, SA1 4YD, SA1 4YE, SA1 4YG, SA1 4YH, SA1 4YJ, SA1 4YN, SA1 4YP, SA1 4YQ",402,370,32
W00004654,SA1,"SA1 4QN, SA2 0AD, SA2 0AE, SA2 0AF, SA2 0AQ, SA2 0EB, SA2 0HP",368,331,37
W00004651,SA1,"SA1 4LP, SA1 4LR, SA1 4LS, SA1 4LT, SA1 4QP",305,266,39
W00004649,SA1,"SA1 4JN, SA1 4JW, SA1 4JX, SA1 4JZ, SA1 4PS, SA1 4PT, SA1 4PU, SA1 4PY, SA1 4PZ, SA1 4QA, SA1 4QD, SA1 5PX, SA1 6DS",348,316,32
W00004648,SA1,"SA1 4HS, SA1 4HT, SA1 4JP, SA1 4JS, SA1 4JT, SA1 4JU, SA1 4YR, SA1 4YT, SA1 4YU, SA1 4YW, SA1 4YX, SA1 4YZ, SA1 4ZD, SA1 4ZF, SA1 5NJ, SA1 5PA, SA1 5PE, SA1 5PF, SA1 5PP, SA1 5PR, SA1 5PS, SA1 5PW, SA1 5PY, SA1 5PZ, SA1 5QA, SA1 5QG, SA1 5QR, SA1 5QT, SA1 5QU, SA1 5QX, SA1 5RU",387,345,42
W00004645,SA1,"SA1 4HY, SA1 4QB, SA1 4QF, SA1 4QG, SA1 4QH, SA1 6DE, SA1 6DF, SA1 6DG, SA1 6DL, SA1 6DP, SA1 6DQ, SA1 6DT, SA1 6DX, SA1 6DY, SA1 6DZ, SA1 6EA, SA1 6EB, SA2 0QU, SA2 0RE",331,297,34
W00004638,SA1,"SA1 1HJ, SA1 5PQ, SA1 5QD, SA1 5QE, SA1 5QF, SA1 5QH, SA1 5QJ, SA1 5QP, SA1 5RA, SA1 5RJ, SA1 6BL, SA1 6BN, SA1 6BP, SA1 6BT, SA1 6BW, SA1 6BZ, SA1 6DR",286,261,25
W00010244,SA1,"SA1 8AG, SA1 8AS, SA1 8AW, SA1 8BP, SA1 8DA, SA1 8ES, SA1 8ET, SA1 8JF, SA1 8JG, SA1 8JJ, SA1 8JL, SA1 8JW, SA1 8PG, SA1 8PH, SA1 8PJ, SA1 8RQ",272,255,17
W00003983,SA1,"SA1 3UD, SA1 3UE, SA1 3UH, SA1 3UJ, SA1 3UQ, SA1 3UT",415,377,38
W00010245,SA1,"SA1 1QN, SA1 1QR, SA1 1RJ, SA1 1SF, SA1 1TN, SA1 3XJ, SA1 3YW, SA1 8AL, SA1 8AN, SA1 8EW, SA1 8FD, SA1 8FE, SA1 8JH, SA1 8QH, SA1 8QY, SA1 8QZ, SA1 8RH, SA1 8RL, SA1 8RN, SA1 8RP, SA1 8RR, SA1 8RU, SA1 8RW, SA1 8RX, SA1 8RY, SA1 8SE, SA1 8XP",277,262,15
W00003984,SA1,"SA1 3JR, SA1 3TU, SA1 3TX, SA1 3TZ, SA1 3UB, SA1 3US, SA1 3UU, SA1 4PF",375,343,32
W00010251,SA1,"SA1 3UA, SA1 3UN, SA1 3UR, SA1 3UW, SA1 4AJ, SA1 4BP",273,245,28
W00003960,SA1,"SA1 7AT, SA1 7AY, SA1 7AZ, SA1 7BA, SA1 7BB, SA1 7BX, SA1 7BY, SA1 7BZ",371,352,19
W00010442,SA1,"SA1 7DD, SA1 7FA, SA1 7FE, SA1 7FN, SA1 7FP, SA1 7FY",211,197,14
W00010438,SA1,"SA1 6AG, SA1 6AH, SA1 6AJ, SA1 6AW, SA1 6RA, SA1 6RB, SA1 6RD, SA1 6RE, SA1 6SB",340,286,54
W00010433,SA1,"SA1 7FB, SA1 7FQ, SA1 7FS, SA1 7GA",197,176,21
W00010432,SA1,"SA1 8NT, SA1 8NU, SA1 8NY",281,261,20
W00010431,SA1,"SA1 2AN, SA1 2EQ, SA1 2EZ, SA1 2HA, SA1 2HB",250,231,19
W00010425,SA1,"SA1 8QL, SA1 8QR, SA1 8QX, SA1 8SD, SA10 6BL, SA10 6JH, SA10 6JJ, SA10 6JL, SA10 6JP, SA10 6JR, SA10 6JS, SA10 6JT, SA10 6LJ, SA10 6NG, SA10 6NH",290,259,31
W00010420,SA1,"SA1 1AA, SA1 1AG, SA1 1AH, SA1 1AW, SA1 1BB, SA1 1BL, SA1 1BP, SA1 1EA, SA1 1FN, SA1 1GH, SA1 1GT, SA1 1HQ, SA1 1PS, SA1 1QT, SA1 1QY, SA1 1RX, SA1 1SX, SA1 1TA, SA1 1TB, SA1 1TE, SA1 1TF, SA1 1TG, SA1 1TJ, SA1 1TP, SA1 1TR, SA1 1WA, SA1 1WB, SA1 1WH, SA1 1WL, SA1 1WR, SA1 1WU, SA1 1WW, SA1 1WX, SA1 1WY, SA1 1WZ, SA1 1XD, SA1 1XH, SA1 1XJ, SA1 1XN, SA1 1XQ, SA1 1YA, SA1 1YD, SA1 1YL, SA1 1YN, SA1 1YP, SA1 1YS, SA1 1YU, SA1 1YY, SA1 1ZB, SA1 1ZF, SA1 1ZH, SA1 1ZJ, SA1 1ZS, SA1 2BB, SA1 2JN, SA1 2TA, SA1 2TB, SA1 2TE, SA1 2TF, SA1 2TG, SA1 2TJ, SA1 2TP, SA1 2XB, SA1 2YA, SA1 2YB, SA1 2YD, SA1 2YF, SA1 2YG, SA1 2YJ, SA1 2YN, SA1 2YS, SA1 2YT, SA1 3AL, SA1 3AP, SA1 3LJ, SA1 3WY, SA1 3WZ, SA1 3XY, SA1 3XZ, SA1 3YB, SA1 3YD, SA1 3YE, SA1 3YF, SA1 3YH, SA1 3YJ, SA1 3YL, SA1 3YN, SA1 3YQ, SA1 3YS, SA1 3YU, SA1 3YX, SA1 3YY, SA1 3YZ, SA1 3ZT, SA1 3ZW, SA1 3ZX, SA1 4YA, SA1 4YB, SA1 4YF, SA1 4YL, SA1 4YS, SA1 4YY, SA1 4ZA, SA1 4ZB, SA1 4ZE, SA1 4ZG, SA1 4ZH, SA1 4ZL, SA1 4ZN, SA1 4ZQ, SA1 4ZW, SA1 5WX, SA1 5WY, SA1 5WZ, SA1 5XB, SA1 5YA, SA1 5YB, SA1 5YD, SA1 5YH, SA1 5YJ, SA1 5YL, SA1 5YN, SA1 5YQ, SA1 5YR, SA1 5YS, SA1 5YT, SA1 5YW, SA1 5YX, SA1 5YY, SA1 5YZ, SA1 6TU, SA1 6UF, SA1 6WB, SA1 6WD, SA1 6WE, SA1 6WJ, SA1 6WL, SA1 6WN, SA1 6WP, SA1 6WS, SA1 6WU, SA1 6WW, SA1 6WX, SA1 6XA, SA1 6XD, SA1 6XF, SA1 6ZA, SA1 6ZB, SA1 6ZD, SA1 6ZE, SA1 6ZF, SA1 6ZG, SA1 6ZH, SA1 6ZQ, SA1 6ZR, SA1 6ZS, SA1 6ZT, SA1 6ZW, SA1 6ZX, SA1 7DL, SA1 7DN, SA1 7DP, SA1 7DR, SA1 7DT, SA1 7GB, SA1 7GD, SA1 7GE, SA1 7YA, SA1 7YB, SA1 7YG, SA1 7YH, SA1 7YL, SA1 8YA, SA1 8YB, SA1 8YF, SA1 8YG, SA1 8YH, SA1 8YN, SA1 8YQ, SA1 8YR, SA1 8YU, SA1 8ZX, SA1 9AA, SA1 9AB, SA1 9AD, SA1 9AE, SA1 9AF, SA1 9AG, SA1 9AH, SA1 9AJ, SA1 9AL, SA1 9AN, SA1 9AP, SA1 9AQ, SA1 9AR, SA1 9AS, SA1 9AT, SA1 9AU, SA1 9AW, SA1 9AY, SA1 9AZ, SA1 9BA, SA1 9BB, SA1 9BD, SA1 9BE, SA1 9BF, SA1 9BG, SA1 9BH, SA1 9BJ, SA1 9BL, SA1 9BN, SA1 9BP, SA1 9BQ, SA1 9BR, SA1 9BS, SA1 9BT, SA1 9BU, SA1 9BW, SA1 9BX, SA1 9BY, SA1 9BZ, SA1 9DA, SA1 9DB, SA1 9DD, SA1 9DE, SA1 9DF, SA1 9DG, SA1 9DH, SA1 9DJ, SA1 9DL, SA1 9DN, SA1 9DP, SA1 9DQ, SA1 9DR, SA1 9DS, SA1 9DT, SA1 9DU, SA1 9DW, SA1 9DX, SA1 9DY, SA1 9DZ, SA1 9EA, SA1 9EB, SA1 9ED, SA1 9EE, SA1 9EF, SA1 9EG, SA1 9EH, SA1 9EJ, SA1 9EL, SA1 9EN, SA1 9EP, SA1 9EQ, SA1 9ER, SA1 9ES, SA1 9ET, SA1 9EU, SA1 9EW, SA1 9EX, SA1 9EY, SA1 9EZ, SA1 9FA, SA1 9FB, SA1 9FD, SA1 9FE, SA1 9FF, SA1 9FG, SA1 9FH, SA1 9FJ, SA1 9FL, SA1 9FN, SA1 9FP, SA1 9FQ, SA1 9FR, SA1 9FS, SA1 9FT, SA1 9FW, SA1 9FX, SA1 9FY, SA1 9FZ, SA1 9GA, SA1 9GB, SA1 9GD, SA1 9GE, SA1 9GF, SA1 9GG, SA1 9GH, SA1 9GJ, SA1 9GL, SA1 9GN, SA1 9GP, SA1 9GQ, SA1 9GR, SA1 9GS, SA1 9GT, SA1 9GU, SA1 9GW, SA1 9GX, SA1 9GY, SA1 9GZ, SA1 9HA, SA1 9HB, SA1 9HD, SA1 9HE, SA1 9HF, SA1 9HG, SA1 9HH, SA1 9HJ, SA1 9HL, SA1 9HN, SA1 9HP, SA1 9HQ, SA1 9HR, SA1 9HS, SA1 9HT, SA1 9HU, SA1 9HW, SA1 9HX, SA1 9HY, SA1 9HZ, SA1 9JA, SA1 9JD, SA1 9JE, SA1 9JF, SA1 9JG, SA1 9JH, SA1 9JJ, SA1 9JL, SA1 9JN, SA1 9JP, SA1 9JQ, SA1 9JR, SA1 9JS, SA1 9JT, SA1 9JU, SA1 9JW, SA1 9JX, SA1 9JY, SA1 9JZ, SA1 9LA, SA1 9LB, SA1 9LD, SA1 9LE, SA1 9LF, SA1 9LG, SA1 9LH, SA1 9LJ, SA1 9LL, SA1 9LN, SA1 9LP, SA1 9LQ, SA1 9LR, SA1 9LS, SA1 9LT, SA1 9LU, SA1 9LW, SA1 9LX, SA1 9LY, SA1 9LZ, SA1 9NA, SA1 9NB, SA1 9ND, SA1 9NE, SA1 9NF, SA1 9NG, SA1 9NH, SA1 9NJ, SA1 9NL, SA1 9NN, SA1 9NP, SA1 9NQ, SA1 9NR, SA1 9NS, SA1 9NT, SA1 9NU, SA1 9NW, SA1 9NX, SA1 9NY, SA1 9NZ, SA1 9PA, SA1 9PB, SA1 9PD, SA1 9PE, SA1 9PF, SA1 9PG, SA1 9PH, SA1 9PJ, SA1 9PL, SA1 9PN, SA1 9PP, SA1 9PQ, SA1 9PR, SA1 9PS, SA1 9PT, SA1 9PU, SA1 9PX, SA1 9PY, SA1 9PZ, SA1 9QA, SA1 9QB, SA1 9QD, SA1 9QE, SA1 9QG, SA1 9QH, SA1 9QL, SA1 9QN, SA1 9QP, SA1 9QQ, SA1 9QR, SA1 9QS, SA1 9QT, SA1 9QU, SA1 9QW, SA1 9QX, SA1 9QY, SA1 9QZ, SA1 9RA, SA1 9RB, SA1 9RD, SA1 9RE, SA1 9RF, SA1 9RG, SA1 9RH, SA1 9RJ, SA1 9RL, SA1 9RN, SA1 9RP, SA1 9RQ, SA1 9RR, SA1 9RS, SA1 9RT, SA1 9RU, SA1 9RW, SA1 9RX, SA1 9RY, SA1 9RZ, SA1 9TY, SA1 9TZ, SA1 9UB, SA1 9UD, SA2 0WA, SA2 0WB, SA2 0WD, SA2 0WE, SA2 0WJ, SA2 0WL, SA2 0WN, SA2 0WP, SA2 0WQ, SA2 0WR, SA2 0WS, SA2 0WT, SA2 0WU, SA2 0WW, SA2 0WY, SA2 0WZ, SA2 0XZ, SA2 0YT, SA2 0YU, SA2 0YW, SA2 0YX, SA2 0ZA, SA2 0ZB, SA2 0ZD, SA2 0ZL, SA2 0ZP, SA2 0ZR, SA2 0ZT, SA2 0ZX, SA2 0ZY, SA2 7WA, SA2 7WB, SA2 7WZ, SA2 7YA, SA2 7YB, SA2 7YE, SA2 7YF, SA2 7YH, SA2 7YJ, SA2 7YP, SA2 7YQ, SA2 7YS, SA2 7YT, SA2 7YU, SA2 7YZ, SA2 7ZE, SA2 7ZS, SA2 7ZW, SA2 7ZX, SA2 8XQ, SA2 8XZ, SA2 8YA, SA2 8YB, SA2 8YD, SA2 8YE, SA2 8YF, SA2 8YG, SA2 8YH, SA2 8YL, SA2 8YN, SA2 8YP, SA2 8YQ, SA2 8YR, SA2 8YS, SA2 8YT, SA2 8YW, SA2 8YX, SA2 9WX, SA2 9WY, SA2 9WZ, SA2 9XZ, SA2 9YA, SA2 9YB, SA2 9YD, SA2 9YF, SA2 9YG, SA2 9YL, SA2 9YP, SA2 9YS, SA2 9YU, SA3 3WW, SA3 4WX, SA3 4XJ, SA3 4XR, SA3 4XX, SA3 4YL, SA3 4YU, SA3 4ZS, SA3 5YN, SA3 9AE, SA3 9AU, SA3 9AW, SA3 9AX, SA3 9BA, SA3 9BB, SA3 9BD, SA3 9BE, SA3 9BF, SA3 9BG, SA3 9BH, SA3 9BJ, SA3 9BL, SA3 9BN, SA3 9BP, SA3 9BQ, SA3 9BR, SA3 9BS, SA3 9BT, SA3 9BU, SA3 9BW, SA3 9BX, SA3 9BY, SA3 9BZ, SA3 9DA, SA3 9DB, SA3 9DD, SA3 9DE, SA3 9DF, SA3 9DG, SA5 4YE, SA5 4YF, SA5 4YG, SA5 4YH, SA5 4YL, SA5 4YP, SA5 4YR, SA5 4YS, SA5 4YT, SA5 4YW, SA5 4ZL, SA5 4ZP, SA5 4ZR, SA5 5WS, SA5 5WX, SA5 5WY, SA5 5WZ, SA5 5YB, SA5 5YJ, SA5 5YN, SA5 5YP, SA5 5YR, SA5 5YS, SA5 5YT, SA5 5ZW, SA5 7WF, SA5 7WZ, SA5 7YA, SA5 7YB, SA5 7YE, SA5 7YF, SA5 7YG, SA5 8YE, SA5 8YH, SA5 8YJ, SA5 8YP, SA5 8YQ, SA5 8YR, SA5 8YS, SA5 8ZW, SA5 8ZX, SA5 9WA, SA5 9YA, SA5 9YB, SA5 9YD, SA5 9YH, SA5 9YL, SA5 9YP, SA5 9YQ, SA5 9YR, SA5 9YU, SA5 9YY, SA6 5WW, SA6 5YP, SA6 6WA, SA6 6WY, SA6 6WZ, SA6 6XQ, SA6 6XT, SA6 6XU, SA6 6XW, SA6 6XX, SA6 6XY, SA6 6YB, SA6 6YJ, SA6 6YL, SA6 6YN, SA6 6YQ, SA6 6YR, SA6 6YU, SA6 6YW, SA6 6YY, SA6 6ZH, SA6 6ZN, SA6 6ZQ, SA6 6ZS, SA6 6ZU, SA6 6ZW, SA6 6ZX, SA6 7YA, SA6 7YD, SA6 7YE, SA6 7YH, SA6 7YP, SA6 8AH, SA6 8BX, SA6 8DP, SA6 8JS, SA6 8QT, SA6 8QY, SA6 8RE, SA6 8RG, SA6 8RJ, SA6 8RR, SA6 8RS, SA6 8WA, SA6 8WD, SA6 8WR, SA6 8WZ, SA6 8YA, SA6 8YD, SA6 8YH, SA6 8YU, SA6 8ZD, SA6 8ZE, SA6 8ZF, SA6 8ZG, SA6 8ZH, SA6 8ZJ, SA6 8ZL, SA6 8ZP, SA6 8ZQ, SA6 8ZU, SA7 0YU, SA7 9BB, SA7 9DQ, SA7 9FJ, SA7 9FQ, SA7 9FT, SA7 9LA, SA7 9LB, SA7 9RR, SA7 9RS, SA7 9UE, SA7 9WT, SA7 9WU, SA7 9WW, SA7 9WX, SA7 9WY, SA7 9WZ, SA7 9YA, SA7 9YG, SA7 9YH, SA7 9YJ, SA7 9YL, SA7 9YN, SA7 9YP, SA7 9YR, SA7 9YS, SA7 9YT, SA7 9YU, SA7 9YW, SA7 9YX, SA7 9YY, SA7 9YZ, SA7 9ZA, SA7 9ZD, SA7 9ZE, SA7 9ZF, SA7 9ZG, SA7 9ZJ, SA7 9ZL, SA7 9ZP, SA7 9ZQ, SA7 9ZR, SA7 9ZS, SA7 9ZU, SA7 9ZW, SA7 9ZX, SA80 8AA, SA80 8AB, SA80 8AD, SA80 8AE, SA80 8AF, SA80 8AG, SA80 8AH, SA80 8AJ",316,281,35
W00010413,SA1,"SA1 1DD, SA1 1HL, SA1 1LH, SA1 1PJ, SA1 3AA, SA1 3AB, SA1 3AE, SA1 3AF, SA1 3AG, SA1 3AH, SA1 3AJ, SA1 3AN, SA1 3AQ, SA1 3AS, SA1 3BA, SA1 3BE, SA1 3BG, SA1 3BH, SA1 3BJ, SA1 3BL, SA1 3BN, SA1 3BP, SA1 3BQ, SA1 3BR, SA1 3BT, SA1 3BW, SA1 3DH, SA1 3DJ, SA1 3DL, SA1 3DN, SA1 3DP, SA1 3DR, SA1 3DS, SA1 3DT, SA1 3DW, SA1 3DZ, SA1 3EA, SA1 3EB, SA1 3ED, SA1 3EE, SA1 3EF, SA1 3EH, SA1 3EQ, SA1 3HT, SA1 3PE, SA1 3PF, SA1 3PQ, SA1 3PR, SA1 3PS, SA1 3PX, SA1 3PY, SA1 3QE, SA1 3QL, SA1 3QQ, SA1 4AD, SA1 4AE, SA1 4AF, SA1 4AH, SA1 4AN, SA1 4AQ, SA1 4EH, SA1 5HH, SA1 5HJ, SA1 5HL, SA1 5HN, SA1 5HP, SA1 5HT, SA1 5HU, SA1 5HW, SA1 5HY, SA1 5JA, SA1 5JB, SA1 5JD, SA1 5JE, SA1 5JF, SA1 5JG, SA1 5JH, SA1 5JJ, SA1 5JS, SA1 5SU, SA1 5TX",188,176,12
W00010408,SA1,"SA1 8PT, SA1 8PX, SA1 8PZ, SA10 6HX, SA10 6JA, SA10 6JB, SA10 6JD",114,107,7
W00010403,SA1,"SA1 1TD, SA1 2DQ, SA1 2EB, SA1 2ED, SA1 2EF, SA1 2EH, SA1 2EJ, SA1 2EL, SA1 2EN, SA1 2EP, SA1 2FD, SA1 2GD, SA1 2HS, SA1 2HT",111,92,19
W00010400,SA1,"SA1 1EL, SA1 3DU, SA1 3HZ, SA1 3JA, SA1 3JB, SA1 3JD, SA1 4AB, SA1 4AL, SA1 4AR, SA1 4AS, SA1 4AW, SA1 4DT, SA1 4DU, SA1 4EJ, SA1 4EN, SA1 4EP, SA1 4ER, SA1 4ES, SA1 4ET, SA1 4EW, SA1 4EX, SA1 4HF, SA1 5DL, SA1 5JN, SA1 5JP, SA1 5JQ, SA1 5JU, SA1 5JW, SA1 5JX, SA1 5JZ, SA1 5SL, SA1 5SP, SA1 5SQ, SA1 5SR, SA1 5SS, SA1 5ST, SA1 5SY, SA1 5TR, SA1 5TT, SA1 5TW, SA1 5UD",468,432,36
W00010394,SA1,"SA1 1DA, SA1 1LY, SA1 8PW, SA1 8QD, SA1 8QN, SA1 8QT, SA1 8QU, SA1 8RA, SA1 8RB, SA1 8RD, SA1 8RE, SA1 8SB, SA1 8SF",307,272,35
W00010384,SA1,"SA1 8FB, SA1 8JN, SA1 8JS, SA1 8JT, SA1 8JU, SA1 8RF",249,235,14
W00010382,SA1,"SA1 8AA, SA1 8DD, SA1 8EN, SA1 8EP, SA1 8PR, SA1 8QA, SA1 8QB, SA1 8QE, SA1 8QG, SA1 8QJ, SA1 8QQ, SA1 8SH, SA1 8YD",2148,2012,136
W00010380,SA1,"SA1 7FG, SA1 7FL, SA1 7FW, SA1 7FX, SA1 7FZ",192,175,17
W00010378,SA1,"SA1 7BP, SA1 7DF, SA1 7DS, SA1 7EG, SA1 7EX, SA1 7FT, SA1 7FU",257,230,27
W00010376,SA1,"SA1 2DL, SA1 2DN, SA1 2DP, SA1 2EA, SA1 2EE, SA1 2GA, SA1 2GB, SA1 2GE",895,812,83
W00010372,SA1,"SA1 8EL, SA1 8ER, SA1 8FA, SA1 8JQ, SA1 8JR, SA1 8LP, SA1 8QS, SA1 8QW, SA1 8RG",234,223,11
W00010366,SA1,"SA1 8DE, SA1 8DG, SA1 8NH, SA1 8PN",332,290,42
W00010365,SA1,"SA1 1LA, SA1 1LD, SA1 1LJ, SA1 1LT, SA1 1LU, SA1 1NG, SA1 1NN, SA1 1NQ, SA1 1NW, SA1 1NX, SA1 1PA, SA1 1PB, SA1 1PD, SA1 1PE, SA1 1PF, SA1 1PN, SA1 1QL, SA1 2BG, SA1 2BJ, SA1 3PT, SA1 5AJ, SA1 5AL, SA1 5AQ, SA1 5AU, SA1 5AW, SA1 5AX, SA1 5BA, SA1 5BB, SA1 5BD, SA1 5BQ, SA1 5DS, SA1 5DT, SA1 5DU, SA1 5DX, SA1 5DY, SA1 5DZ, SA1 5ED, SA1 5EE, SA1 5EF, SA1 5EH, SA1 5EJ, SA1 5EN, SA1 5EQ, SA1 5ER, SA1 5ES, SA1 5ET, SA1 5EU, SA1 5EX, SA1 5LD, SA1 6YR, SA1 6YS",454,429,25
W00010265,SA1,"SA1 1RW, SA1 1SS, SA1 1TS, SA1 1TX, SA1 4AT",147,139,8
W00010255,SA1,"SA1 1HF, SA1 1HY, SA1 1JG, SA1 1JH",115,107,8
W00010253,SA1,"SA1 1SD, SA1 1UD, SA1 1UT",156,140,16
W00010252,SA1,"SA1 1JZ, SA1 1SU, SA1 1UA, SA1 1YB, SA1 1YR, SA1 8RJ",211,183,28
W00010246,SA1,"SA1 7AA, SA1 7FD, SA1 7FF, SA1 7FH, SA1 7FJ, SA1 7FR",187,167,20
W00003961,SA1,"SA1 7LD, SA1 7LE, SA1 7LF, SA1 7LG, SA1 7LH, SA1 7LJ",293,276,17
W00004703,SA1,"SA1 1WF, SA1 1WJ, SA3 5NJ, SA3 5NZ, SA3 5PJ, SA3 5PL",201,186,15
W00003963,SA1,"SA1 7LQ, SA7 9XP, SA7 9XR, SA7 9XS, SA7 9XT, SA7 9XW, SA7 9XY, SA7 9YE",446,409,37
W00004602,SA1,"SA1 6PB, SA1 6UN, SA1 6UQ, SA1 6UY",307,289,18
W00004601,SA1,"SA1 6PA, SA1 6TD, SA1 6TE, SA1 6UW",270,250,20
W00004600,SA1,"SA1 6NH, SA1 6PG, SA1 6PQ, SA1 6PS",314,296,18
W00004552,SA1,"SA1 8DB, SA1 8LD, SA1 8LN, SA1 8LW, SA1 8NX, SA1 8NZ, SA1 8PA, SA1 8PB, SA1 8PQ, SA1 8PS, SA1 8PU, SA1 8QP, SA1 8SA",412,376,36
W00004550,SA1,"SA1 8JX, SA1 8JY, SA1 8LB, SA1 8LE, SA1 8LH, SA1 8LJ",276,256,20
W00004549,SA1,"SA1 8LL, SA1 8NE, SA1 8NJ",238,222,16
W00004547,SA1,"SA1 8HR, SA1 8HS, SA1 8HW, SA1 8LZ, SA1 8NA, SA1 8YJ, SA1 8YP",265,244,21
W00004546,SA1,"SA1 8HJ, SA1 8HT, SA1 8HU, SA1 8LY, SA1 8YE, SA1 8YL",271,250,21
W00004545,SA1,"SA1 8LQ, SA1 8NB, SA1 8ND",287,264,23
W00004544,SA1,"SA1 8JZ, SA1 8LA, SA1 8LF, SA1 8LG, SA1 8LR",341,322,19
W00004542,SA1,"SA1 8BE, SA1 8BH, SA1 8BJ, SA1 8BQ, SA1 8BR, SA1 8BS",282,271,11
W00004541,SA1,"SA1 8DY, SA1 8DZ, SA1 8EA, SA1 8EB, SA1 8EX, SA1 8EY",292,266,26
W00004540,SA1,"SA1 8EZ, SA1 8HA, SA1 8HB, SA1 8HD, SA1 8HG, SA1 8HP, SA1 8RS, SA1 8RT",352,333,19
W00004539,SA1,"SA1 8NN, SA1 8NP, SA1 8NR, SA1 8NS, SA1 8NW",272,255,17
W00004538,SA1,"SA1 8DP, SA1 8DR, SA1 8DU, SA1 8DW",293,276,17
W00004537,SA1,"SA1 8AZ, SA1 8BA, SA1 8BD, SA1 8BG, SA1 8DN",329,301,28
W00004536,SA1,"SA1 8HE, SA1 8HF, SA1 8HH, SA1 8HL, SA1 8HN, SA1 8HQ",281,264,17
W00004535,SA1,"SA1 8NF, SA1 8NG, SA1 8NL, SA1 8NQ",297,282,15
W00004534,SA1,"SA1 1WQ, SA1 8DS, SA1 8DT, SA1 8DX, SA1 8EE, SA1 8EF, SA1 8EG, SA1 8EH, SA1 8EJ, SA1 8EQ",296,271,25
W00004533,SA1,"SA1 8BL, SA1 8BN, SA1 8BW, SA1 8EU",275,245,30
W00004532,SA1,"SA1 8BT, SA1 8BU, SA1 8BX, SA1 8BY, SA1 8BZ",285,262,23
W00004531,SA1,"SA1 8AT, SA1 8AU, SA1 8AX, SA1 8AY, SA1 8BB, SA1 8DH, SA1 8DJ, SA1 8DL, SA1 8DQ",217,205,12
W00004375,SA1,"SA1 1EX, SA1 1EY, SA1 1FL, SA1 1FP, SA1 1FS, SA1 1FT, SA1 1FU, SA1 1FW, SA1 1GA, SA1 1GB, SA1 1GE, SA1 1GF, SA1 1GG, SA1 1GJ, SA1 1GL, SA1 1GN, SA1 1GQ, SA1 1GS, SA1 1GU, SA1 1GW, SA1 1GX, SA1 1GY, SA1 1GZ, SA6 6BP, SA6 6BR, SA6 6BW, SA6 7JH, SA6 7JJ",211,189,22
W00004331,SA1,"SA1 1EU, SA6 6DL, SA6 7DQ, SA6 7DR, SA6 7DT, SA6 7DY, SA6 7DZ, SA6 7EA",251,216,35
W00004328,SA1,"SA1 1ES, SA1 1ET, SA1 1FA, SA1 1FG, SA6 7AJ, SA6 7AL, SA6 7AP, SA6 7AS, SA6 7AT, SA6 7AW, SA6 7AY, SA6 8AF, SA6 8AT",312,282,30
W00003977,SA1,"SA1 7AR, SA1 7AS, SA1 7DU, SA1 7EU, SA1 7HA, SA1 7HQ",311,290,21
W00003976,SA1,"SA1 7AG, SA1 7AH, SA1 7AP, SA1 7AQ, SA1 7BR, SA1 7BS, SA1 7BT",243,237,6
W00003975,SA1,"SA1 7AU, SA1 7AX, SA1 7HB, SA1 7HE, SA1 7HF",330,297,33
W00003973,SA1,"SA1 7DG, SA1 7DQ, SA1 7EP",282,245,37
W00004603,SA1,"SA1 6LL, SA2 0XB, SA2 0XE",293,277,16
W00004604,SA1,"SA1 6LD, SA1 6LE, SA1 6PE, SA1 6SX, SA1 6UD, SA1 6WH, SA1 6WY, SA1 6WZ",263,241,22
W00004607,SA1,"SA1 6PL, SA1 6PN, SA1 6PW, SA2 0XD",321,305,16
W00004608,SA1,"SA1 6LQ, SA1 6PF, SA1 6PT, SA1 6PU",198,195,3
W00003962,SA1,"SA1 7EF, SA1 7EQ, SA1 7LB, SA1 7LP, SA7 9YB",244,227,17
W00004637,SA1,"SA1 4HU, SA1 5NW, SA1 5PN, SA1 5QQ, SA1 5RB, SA1 5RD, SA1 5RE, SA1 5RF, SA1 5RG, SA1 5RH, SA1 6BG, SA1 6BH, SA1 6BQ, SA1 6BR, SA1 6BU, SA1 6JL",383,360,23
W00004634,SA1,"SA1 1ZG, SA1 1ZN, SA1 4BJ, SA1 4BN, SA1 4LZ, SA1 4NA, SA1 4NB, SA1 4NF, SA1 4NH, SA1 4NJ, SA1 4NL, SA1 4NN, SA1 4NP, SA1 4NQ, SA1 4NR, SA1 4NS, SA1 4NT, SA1 4PA, SA1 4PB, SA1 4PD, SA1 4PE, SA1 4PG, SA1 4PH, SA1 4PJ, SA1 4PL, SA1 4PN, SA1 4PQ, SA1 5AR",425,385,40
W00004633,SA1,"SA1 4QJ, SA1 4QL, SA1 4QQ, SA1 4QR, SA1 4QS, SA2 0HJ, SA2 0NU, SA2 0NZ, SA2 0PA, SA2 0PE",332,290,42
W00004630,SA1,"SA1 6BX, SA1 6DJ, SA1 6HY, SA1 6HZ, SA1 6JN",212,187,25
W00004629,SA1,"SA1 6PD, SA1 6SY, SA1 6UE, SA1 6UG, SA1 6UL, SA1 6UP",304,291,13
W00003979,SA1,"SA1 7BD, SA1 7BE, SA1 7BG, SA1 7BH, SA1 7BJ, SA1 7BL, SA1 7BN, SA1 7BQ, SA1 7BU, SA1 7BW, SA1 7EZ, SA1 7HG, SA1 7JG, SA1 8ED, SA7 9YD, SA7 9YF, SA7 9YQ",125,114,11
W00003980,SA1,"SA1 7DY, SA1 7ES, SA1 7JU",127,122,5
W00004628,SA1,"SA1 6LN, SA1 6LR, SA2 0XF",277,267,10
W00004627,SA1,"SA1 6LS, SA1 6QL, SA1 6QR, SA1 6QZ",356,338,18
W00004626,SA1,"SA1 6SZ, SA1 6TH, SA1 6TJ, SA1 6TL, SA1 6TQ",256,245,11
W00004625,SA1,"SA1 6QH, SA1 6QN, SA1 6QP, SA1 6QY",295,274,21
W00004624,SA1,"SA1 6QE, SA1 6QG, SA1 6QQ, SA1 6RR, SA1 6RS",268,253,15
W00003981,SA1,"SA1 1JR, SA1 1JS, SA1 1JT, SA1 1LP, SA1 1NB, SA1 1NE, SA1 1NF, SA1 1NJ, SA1 1NL, SA1 1NS, SA1 1NT, SA1 1PW, SA1 1QW, SA1 2EG, SA1 2EU, SA1 2EX, SA1 2EY, SA1 3RL, SA1 5AP, SA1 5LJ, SA1 5LN",148,142,6
W00003972,SA1,"SA1 7HJ, SA1 7HL, SA1 7HZ, SA1 7JA, SA1 7JB",312,294,18
W00004623,SA1,"SA1 1US, SA1 6RL, SA1 6RN, SA1 6RP, SA1 6RW, SA1 6TG, SA1 6TN",379,355,24
W00004621,SA1,"SA1 6AN, SA1 6RU, SA1 6RX, SA1 6RY, SA1 6RZ, SA1 6SA",251,237,14
W00004620,SA1,"SA1 6RH, SA1 6RJ, SA1 6RQ, SA1 6TA, SA1 6TB, SA1 6TF, SA1 6TW, SA5 8NH",341,326,15
W00004619,SA1,"SA1 6NA, SA1 6NP, SA1 6NQ, SA1 6NW",261,235,26
W00004618,SA1,"SA1 6NB, SA1 6NL, SA1 6NN",245,222,23
W00004617,SA1,"SA1 6ND, SA1 6PP, SA1 6PR",254,245,9
W00004616,SA1,"SA1 6JZ, SA1 6LA, SA1 6LB, SA1 6NJ, SA1 6UZ, SA1 6WA, SA1 6WF, SA1 6WG, SA1 6WQ, SA1 6WR, SA1 6WT, SA1 6YU, SA1 6YX, SA1 6YY",278,262,16
W00004615,SA1,"SA1 6SN, SA1 6ST, SA1 6SU, SA1 6SW, SA1 6TX",314,296,18
W00004614,SA1,"SA1 6SP, SA1 6SR, SA1 6SS, SA1 6TY, SA1 6UB",277,265,12
W00003982,SA1,"SA1 3JF, SA1 3JQ, SA1 3JX, SA1 3JZ, SA1 3TB, SA1 3TD, SA1 3TQ",408,382,26
W00004613,SA1,"SA1 6NE, SA1 6PJ, SA2 0UU, SA2 0YP",229,217,12
W00004612,SA1,"SA1 6NF, SA1 6NG, SA1 6NR, SA1 6PH",219,206,13
W00004611,SA1,"SA1 1WS, SA1 6LG, SA1 6LH, SA1 6QD, SA1 6QF",296,275,21
W00004610,SA1,"SA1 6TZ, SA1 6UH, SA1 6UJ, SA1 6UR, SA1 6US, SA1 6UT, SA1 6UU",349,334,15
W00004609,SA1,"SA1 6LJ, SA1 6QA, SA1 6QB",154,149,5
W00004622,SA1,"SA1 6QJ, SA1 6QU, SA1 6QX, SA1 6RT, SA1 6SE",286,271,15
W00003971,SA1,"SA1 7DH, SA1 7DJ, SA1 7HD, SA1 7JR, SA1 7JS",276,255,21
W00003978,SA1,"SA1 2NW, SA1 7AB, SA1 7AD, SA1 7AE, SA1 7AF, SA1 7AJ, SA1 7AL",244,236,8
W00003969,SA1,"SA1 7HN, SA1 7HP, SA1 7HS, SA1 7HW, SA1 7HY, SA1 7YE, SA1 7YF",249,237,12
W00004005,SA1,"SA1 1HE, SA1 2BZ, SA1 2DA, SA1 2DE, SA1 6FJ, SA1 6FL",200,183,17
W00004006,SA1,"SA1 2BL, SA1 2BN, SA1 2BP, SA1 2BR, SA1 2BS, SA1 2BW",196,190,6
W00004007,SA1,"SA1 6FH, SA1 6FN, SA1 6FQ, SA1 6FT, SA1 6FW",297,284,13
W00004008,SA1,"SA1 1HU, SA1 1LZ, SA1 1QA, SA1 1QE, SA1 1QF, SA1 1QG, SA1 6FE, SA1 6YT",195,181,14
W00004010,SA1,"SA1 6XR, SA1 6XS, SA1 6XT, SA1 6XU, SA1 6XX, SA1 6XZ, SA2 6XT",206,193,13
W00004012,SA1,"SA1 6HS, SA1 6HT, SA1 6UA",172,158,14
W00004013,SA1,"SA1 6XY, SA1 6YD, SA1 6YE, SA1 6YQ",231,208,23
W00004004,SA1,"SA1 1DX, SA1 2BE, SA1 2BX, SA1 2BY, SA1 2DB, SA1 2DW, SA1 2DY, SA1 2DZ, SA5 9LF",498,471,27
W00004014,SA1,"SA1 1LL, SA1 1LN, SA1 1LW, SA1 1NA, SA1 1NH, SA1 1NP, SA1 1NR, SA1 1NU, SA1 1PP, SA1 1QB, SA1 1QD, SA1 2AA, SA1 2AW, SA1 2ER, SA1 5BP, SA1 8AF, SA1 8AP, SA1 8AR",254,251,3
W00004016,SA1,"SA1 6ED, SA1 6HE, SA1 6HF, SA1 6HG, SA1 6HH, SA1 6HJ, SA1 6HL, SA1 6HQ, SA1 6XH, SA1 6XJ, SA1 6XL, SA1 6XN, SA1 6XW",235,223,12
W00004017,SA1,"SA1 6XG, SA1 6XP, SA1 6XQ, SA1 6YF, SA1 6YG, SA1 6YP, SA1 6YW",221,201,20
W00004018,SA1,"SA1 1HD, SA1 3DX, SA1 3EG, SA1 3EN, SA1 3EP, SA1 3ER, SA1 3ES, SA1 3EU, SA1 3EW, SA1 3EX, SA1 3EY, SA1 3EZ, SA1 3HA, SA1 3HD, SA1 3HE, SA1 3HH, SA1 3HJ, SA1 5BT, SA1 5BU, SA1 5DD, SA1 5DE, SA1 5DG, SA1 5DH, SA1 5DN, SA1 5DQ, SA1 5EA, SA1 5EG, SA1 5EL, SA1 5JL, SA1 5JY, SA1 5LA, SA1 5LB, SA1 5LE, SA1 5LG, SA1 5SE, SA1 5SF, SA1 5SG, SA1 5SH, SA1 5SJ, SA1 5SZ, SA1 5TU, SA1 5TY, SA1 5TZ, SA1 5UA, SA1 5UE, SA1 5YF, SA1 5YG, SA1 5YP, SA1 5YU, SA1 6AA, SA1 6AB, SA1 6AD, SA1 6EE, SA1 6EF, SA1 6EG, SA1 6EH, SA1 6XB, SA1 6XE",381,356,25
W00004019,SA1,"SA1 6EQ, SA1 6ER, SA1 6EW, SA1 6EZ",264,240,24
W00004020,SA1,"SA1 6EP, SA1 6ES, SA1 6HN, SA1 6HR, SA1 6HW, SA1 6JF, SA1 6JG, SA1 6JP, SA1 6JQ",280,255,25
W00004021,SA1,"SA1 6HP, SA1 6JB, SA1 6JD, SA1 6JE",270,240,30
W00004022,SA1,"SA1 6ET, SA1 6EU, SA1 6JA",240,213,27
W00004015,SA1,"SA1 1HX, SA1 1ND, SA1 1QH, SA1 1QQ, SA1 5BG, SA1 5BJ, SA1 6YA, SA1 6YB, SA1 6YH, SA1 6YJ, SA1 6YL, SA1 6YN",224,216,8
W00004023,SA1,"SA1 6EJ, SA1 6EN, SA1 6HD",186,170,16
W00004003,SA1,"SA1 1HG, SA1 1HW, SA1 2DD, SA1 2DF, SA1 2DG, SA1 2DR, SA1 2DS, SA1 2DT, SA1 2DU, SA1 2DX, SA5 8NJ",241,223,18
W00004001,SA1,"SA1 2AZ, SA1 2BQ, SA1 2BT, SA1 2BU",241,224,17
W00003970,SA1,"SA1 7HH, SA1 7HU, SA1 7HX, SA1 7JD, SA1 7LR",306,281,25
W00003964,SA1,"SA1 7DW, SA1 7JY, SA1 7JZ, SA1 7LA",266,241,25
W00003986,SA1,"SA1 1HS, SA1 1HT, SA1 2BH, SA1 6FA, SA1 6FB, SA1 6FG, SA1 6FU",292,270,22
W00003987,SA1,"SA1 6FD, SA1 6FF, SA1 6FP, SA1 6FR, SA1 6FS, SA1 6UX, SA1 6YZ",233,217,16
W00003988,SA1,"SA1 3HY, SA1 3JE, SA1 3JG, SA1 3JN, SA1 3JY, SA1 4AG, SA1 4AP, SA1 4AY, SA1 4AZ, SA1 4DG",408,381,27
W00003989,SA1,"SA1 3AT, SA1 3JJ, SA1 3JP, SA1 3JS, SA1 3JT, SA1 3JU, SA1 3JW, SA1 3TT, SA1 3TY, SA1 4BQ",415,387,28
W00003990,SA1,"SA1 1AB, SA1 1AD, SA1 1AE, SA1 1AJ, SA1 1AL, SA1 1AN, SA1 1AP, SA1 1AQ, SA1 1AR, SA1 1AS, SA1 1AT, SA1 1AX, SA1 1AY, SA1 1BA, SA1 1BD, SA1 1BG, SA1 1BQ, SA1 1BR, SA1 1BS, SA1 1BT, SA1 1BU, SA1 1BW, SA1 1BX, SA1 1BY, SA1 1BZ, SA1 1ED, SA1 1EE, SA1 1EF, SA1 1EJ, SA1 1HR, SA1 1PQ, SA1 1QJ, SA1 1QS, SA1 1RH, SA1 1RL, SA1 1RN, SA1 1RQ, SA1 1RU, SA1 1SB, SA1 1SE, SA1 1SH, SA1 1SL, SA1 1SN, SA1 1SQ, SA1 1ST, SA1 1SW, SA1 1SY, SA1 1SZ, SA1 1TL, SA1 1TW, SA1 1TY, SA1 1UU, SA1 1WD, SA1 1WE, SA1 1XL, SA1 3NJ, SA1 3RN, SA1 3ST",243,232,11
W00004002,SA1,"SA1 2AY, SA1 2LP, SA1 2LR, SA1 2LS, SA1 2LX, SA1 2YH, SA5 9LE",228,215,13
W00003991,SA1,"SA1 1TU, SA1 1UF, SA1 1UG, SA1 1UH, SA1 1UJ, SA1 1UL, SA1 1UQ, SA1 1UW, SA1 1UZ, SA1 1XA, SA1 1XB, SA1 1XF",250,230,20
W00003993,SA1,"SA1 4BB, SA1 4BD, SA1 4DB, SA1 4DE, SA1 4DF, SA1 4DJ, SA1 4DP, SA1 4HG, SA1 4HL, SA1 4HP, SA1 4HX, SA1 4HZ, SA1 4JR, SA1 4JY, SA1 5NY",206,192,14
W00003995,SA1,"SA1 4BA, SA1 4BE, SA1 4BG, SA1 4BH, SA1 4DA, SA1 4DD, SA1 4DH, SA1 4DL, SA1 4DN, SA1 4DW, SA13 1WY",225,214,11
W00003996,SA1,"SA1 1DR, SA1 1DT, SA1 1DU, SA1 1EH, SA1 1JA, SA1 1LX, SA1 3AD, SA1 3AR, SA1 3AU, SA1 3AW, SA1 3AX, SA1 3AY, SA1 3AZ, SA1 3LE, SA1 3LF, SA1 3LG, SA1 3LL, SA1 3LP, SA1 3LQ, SA1 3LS, SA1 3LU, SA1 3LX, SA1 3NB, SA1 3NF, SA1 3NG, SA1 3NH, SA1 3NL, SA1 3NN, SA1 3NP, SA1 3NQ, SA1 3PA, SA1 3PB, SA1 3PH, SA1 3QF, SA1 3QG, SA1 3QH, SA1 3QJ, SA1 3QN, SA1 3QP, SA1 3QU, SA1 3QW, SA1 3QX, SA1 3QY, SA1 3QZ, SA1 4NU, SA1 5HR, SA1 5HS",225,217,8
W00003997,SA1,"SA1 3QA, SA1 3QS, SA1 3RB, SA1 3SE, SA1 3SR, SA1 3SU, SA1 3SX, SA1 3SY, SA1 3TA, SA1 3TE, SA1 3TJ, SA1 3UX, SA1 3YA, SA1 3YP, SA1 3YR, SA1 3YT",536,507,29
W00003965,SA1,"SA1 7DX, SA1 7EA, SA1 7EB, SA1 7ED, SA1 7EE",287,255,32
W00003998,SA1,"SA1 3QR, SA1 3QT, SA1 3RU, SA1 3RW, SA1 3RX, SA1 3RY, SA1 3SA, SA1 3SB, SA1 3SH, SA1 3SQ",288,270,18
W00003999,SA1,"SA1 1TZ, SA1 1UB, SA1 1XW, SA1 1XX, SA1 1XY, SA1 1XZ, SA1 1YE, SA1 1YF, SA1 3RD, SA1 3XA, SA1 3XB",231,218,13
W00003992,SA1,"SA1 1QU, SA1 1QZ, SA1 1RA, SA1 1RE, SA1 1RG, SA1 1RP, SA1 1RR, SA1 1RY, SA1 1TH, SA1 1UX",166,159,7
W00004025,SA1,"SA1 6EX, SA1 6EY, SA1 6HA, SA1 6HB, SA1 6JJ",246,221,25
W00004011,SA1,"SA1 1PT, SA1 1PU, SA1 1PX, SA1 1PY, SA1 1PZ",132,131,1
W00004239,SA1,"SA1 2NX, SA1 2NY, SA1 2PA, SA1 2PE, SA1 2PF, SA1 2PS",273,263,10
W00004221,SA1,"SA1 2LA, SA1 2PL, SA1 2PN, SA1 2PP, SA1 2PW, SA5 9LN",269,255,14
W00004222,SA1,"SA1 2LU, SA1 2ND, SA1 2NE, SA1 2NF, SA1 2NG, SA1 2NQ",297,287,10
W00004224,SA1,"SA1 2LQ, SA1 2NN, SA1 2NS, SA1 2PU, SA1 2PX, SA1 2PY, SA1 2PZ",246,236,10
W00004225,SA1,"SA1 2PR, SA1 2QA, SA1 2QB, SA5 9LB, SA5 9LD, SA5 9LG, SA5 9LQ",280,270,10
W00004226,SA1,"SA1 1ER, SA1 2BD, SA1 2ET, SA1 2EW, SA1 2FA, SA1 2FB, SA1 2HJ, SA1 2HN, SA1 2HP, SA1 2HX, SA1 2HY, SA1 2HZ, SA1 2JA, SA1 2JH, SA1 2JJ, SA1 2JW, SA1 2LB, SA1 2LD, SA1 2LE, SA1 2LF, SA1 2LG, SA1 2LH, SA1 2LJ, SA1 2LN, SA1 2NJ, SA1 2NL, SA1 5JR",356,319,37
W00004227,SA1,"SA1 2HW, SA1 2LL, SA1 2NA, SA1 2NB",292,275,17
W00004228,SA1,"SA1 2JP, SA1 2LT, SA1 2LW, SA1 2LY, SA1 2LZ, SA1 2YE, SA1 2YL",221,211,10
W00004086,SA1,"SA1 1XE, SA1 1XG, SA5 4NJ, SA5 4SD, SA5 4SF, SA5 4SP, SA5 4SS, SA5 4ST, SA5 4SU, SA5 4TE",282,248,34
W00004229,SA1,"SA1 2ES, SA1 2HE, SA1 2HH, SA1 2HL, SA1 2HQ, SA1 2HR, SA1 2NH, SA1 5NS",324,314,10
W00004237,SA1,"SA1 2NU, SA1 2PB, SA1 2QL, SA1 2QN, SA5 9DS, SA5 9DX, SA6 8JX, SA6 8JY, SA6 8JZ, SA6 8LA, SA6 8NJ",281,259,22
W00004238,SA1,"SA1 2PG, SA1 2PH, SA1 2PJ, SA1 2PQ, SA5 9DY",250,241,9
W00004026,SA1,"SA1 5RS, SA1 6AX, SA1 6AZ, SA1 6BB, SA1 6BD, SA1 6BE, SA1 6BJ, SA1 6BY",188,167,21
W00004240,SA1,"SA1 2JD, SA1 2JE, SA1 2JF, SA1 2JG, SA1 2JR, SA1 2JT, SA1 2JU, SA1 2JX, SA1 2JY, SA1 2NR, SA1 2NT, SA1 2NZ, SA1 2QD, SA1 2QH",275,266,9
W00004285,SA1,"SA1 7DA, SA1 7DB, SA1 7DE, SA1 7ER, SA1 7EY, SA1 7JH, SA1 7JJ, SA1 7JL, SA1 7JN, SA7 9QW, SA7 9UL, SA7 9WG, SA7 9WH, SA7 9WQ",255,233,22
W00003966,SA1,"SA1 7JE, SA1 7JF, SA1 7LL, SA1 7LN, SA1 7LT, SA1 7LW, SA1 7YD",279,244,35
W00003967,SA1,"SA1 7EH, SA1 7EJ, SA1 7EL, SA1 7LS",229,213,16
W00004230,SA1,"SA1 1UR, SA1 2HD, SA1 2HF, SA1 2HG, SA1 2HU",233,226,7
W00004077,SA1,"SA1 6LP, SA1 6LW, SA1 6QS, SA2 0XS, SA2 0XT, SA2 0XX, SA2 0YA, SA2 0YB, SA2 0YZ",242,223,19
W00004223,SA1,"SA1 2JQ, SA1 2JZ, SA1 2PD, SA1 2PT, SA1 2QE, SA1 2QF, SA1 2QG, SA1 2QJ, SA1 2QQ, SA1 2RN",299,268,31
W00004075,SA1,"SA1 6QT, SA1 6RF, SA1 6RG, SA1 6SF, SA1 6SG, SA2 0XR, SA2 0XU, SA2 0XY",534,473,61
W00004073,SA1,"SA1 6SD, SA2 0FE, SA2 0FH, SA2 0FN, SA2 0FP, SA2 0FS, SA2 0FW, SA2 0FX, SA5 5BR, SA5 8HY, SA5 8HZ",534,448,86
W00004028,SA1,"SA1 4DQ, SA1 4DS, SA1 4HD, SA1 4HE, SA1 4HH, SA1 4HJ, SA1 4HN, SA1 4HR, SA1 4HW, SA1 5NF, SA1 5NG, SA1 5NH, SA1 5NL, SA1 5NN, SA1 5NP, SA1 5NQ, SA1 5NR, SA1 5NT, SA1 5NU, SA1 5NX, SA1 5PD, SA1 5PT, SA1 5QB, SA1 5RL, SA1 5RP, SA1 5RR, SA1 5RX, SA1 5SD, SA1 5UF, SA1 5UG, SA1 5UL, SA1 5YE",404,384,20
W00004027,SA1,"SA1 1EB, SA1 3EJ, SA1 4EU, SA1 4EY, SA1 4EZ, SA1 5NE, SA1 5RQ, SA1 5RT, SA1 5RW, SA1 5RZ, SA1 5SN, SA1 5SW, SA1 5SX, SA1 5TA, SA1 5TB, SA1 5TD, SA1 5TE, SA1 5TF, SA1 5TJ, SA1 5TL, SA1 5TN, SA1 5TS, SA1 6AE, SA1 6AF, SA1 6AL, SA1 6AP, SA1 6AQ, SA1 6AR, SA1 6AS, SA1 6AT, SA1 6AU, SA1 6AY, SA1 6BA, SA1 6EL",366,340,26
W00003968,SA1,"SA1 7DZ, SA1 7EN, SA1 7EW, SA1 7HR, SA1 7HT, SA1 7JT",277,253,24
W00004840,SA10,"SA10 8AF, SA10 8AG, SA10 8AH, SA10 8BT, SA10 8BU, SA10 8BY, SA10 8DA, SA10 8DB, SA10 8DD",251,235,16
W00004866,SA10,"SA10 6AQ, SA10 6LZ, SA10 6NF, SA10 6NS, SA10 6YX",298,270,28
W00004841,SA10,"SA10 8AX, SA10 8BP, SA10 8BR, SA10 8BS",230,211,19
W00004914,SA10,"SA10 7BP, SA10 7BS, SA10 7BY, SA10 7DF, SA10 7DG, SA10 7DH, SA10 7DN, SA10 7DP, SA10 7DR, SA10 7DS, SA10 7DW, SA10 7EE, SA10 7FE, SA10 7GA, SA10 7LA, SA10 7LP, SA10 7LU, SA10 7LY, SA10 7NL, SA10 7NN, SA10 7NQ",208,193,15
W00004913,SA10,"SA10 6NU, SA10 6NY, SA10 6PB, SA10 7LR, SA10 7LT, SA10 7NA, SA10 7NB, SA10 7ND, SA10 7NE, SA10 7NF, SA10 7NJ, SA10 7NR, SA10 7NS, SA10 7NT",326,287,39
W00004865,SA10,"SA10 6AA, SA10 6AJ, SA10 6AX, SA10 6BQ, SA10 6NT, SA10 6NZ",355,343,12
W00004864,SA10,"SA10 6NJ, SA10 6YQ, SA10 6YR, SA10 6YS, SA10 6YT",310,286,24
W00004863,SA10,"SA10 6AZ, SA10 6BJ, SA10 6BX, SA10 6BZ, SA10 6DJ, SA10 6DQ, SA10 6YU, SA10 6YY, SA10 6ZD, SA10 6ZE",317,293,24
W00004862,SA10,"SA10 6BD, SA10 6BE, SA10 6BG, SA10 6BH, SA10 6BN, SA10 6BP, SA10 6BS, SA10 6BT, SA10 6BU, SA10 6BW, SA10 6BY, SA10 6DF, SA10 6EX",323,302,21
W00004861,SA10,"SA10 6AB, SA10 6AD, SA10 6BR, SA10 6DP, SA10 6DW, SA10 6LT, SA10 6LU, SA10 6LY, SA10 6NA",247,227,20
W00004860,SA10,"SA10 6AE, SA10 6AH, SA10 6AL, SA10 6AN, SA10 6BB, SA10 6DA, SA10 6DB, SA10 6DD, SA10 6DE",255,237,18
W00004859,SA10,"SA10 6DS, SA10 6YN, SA10 6YP, SA10 6YW",316,288,28
W00004912,SA10,"SA10 7DB, SA10 7DD, SA10 7DL, SA10 7DT, SA10 7ES, SA10 7HQ, SA10 7JA, SA10 7NG, SA10 7NH, SA10 7NP, SA10 7NW",271,226,45
W00004997,SA10,"SA10 6WS, SA10 6WT, SA10 6WU, SA10 6WW, SA10 6WX, SA10 6WY, SA10 6WZ, SA10 6XJ, SA10 6XL, SA10 6XN, SA10 6XS, SA10 6XT, SA10 6XU, SA10 6XY, SA10 6XZ, SA10 6YJ, SA10 6YL, SA10 6YZ, SA10 6ZA, SA10 7WA, SA10 7WW, SA10 7WX, SA10 7WY, SA10 7XA, SA10 7XZ, SA10 7YB, SA10 7YD, SA10 7YE, SA10 7YQ, SA10 7YS, SA10 7YX, SA10 7ZR, SA10 7ZW, SA10 8WZ, SA10 8YB, SA10 8YG, SA10 8YH, SA10 8YL, SA10 8YP, SA10 8YR, SA10 8YS, SA10 8YT, SA10 8YW, SA10 8ZW, SA10 9WY, SA11 1AL, SA11 1BY, SA11 1DA, SA11 1DB, SA11 1DE, SA11 1DF, SA11 1DG, SA11 1DH, SA11 1DL, SA11 1DN, SA11 1DP, SA11 1DR, SA11 1DU, SA11 1DW, SA11 1DY, SA11 1EA, SA11 1EB, SA11 1EE, SA11 1EF, SA11 1EG, SA11 1EH, SA11 1EL, SA11 1EN, SA11 1EP, SA11 1HA, SA11 1HB, SA11 1HF, SA11 1JZ, SA11 1LJ, SA11 1LN, SA11 1LP, SA11 1LS, SA11 1LT, SA11 1LU, SA11 1LW, SA11 1LY, SA11 1NA, SA11 1NB, SA11 1PQ, SA11 1PS, SA11 1PT, SA11 1PU, SA11 1PX, SA11 1PY, SA11 1QP, SA11 1QZ, SA11 1RA, SA11 1RB, SA11 1RD, SA11 1RE, SA11 1RG, SA11 1RL, SA11 1RN, SA11 1RP, SA11 1RR, SA11 1RS, SA11 1RT, SA11 1RU, SA11 1RW, SA11 1RY, SA11 1SA, SA11 1SB, SA11 1SD, SA11 1SE, SA11 1SL, SA11 1SN, SA11 1WD, SA11 1WJ, SA11 1WL, SA11 1WP, SA11 1WW, SA11 1WX, SA11 1WZ, SA11 1XY, SA11 1XZ, SA11 1YP, SA11 1YQ, SA11 1YZ, SA11 1ZD, SA11 2WW, SA11 2WX, SA11 2WY, SA11 2WZ, SA11 2XZ, SA11 2YE, SA11 2YF, SA11 2YQ, SA11 2YS, SA11 2YX, SA11 2ZP, SA11 2ZW, SA11 3LH, SA11 3LR, SA11 3UZ, SA11 3WA, SA11 3WB, SA11 3WH, SA11 3WJ, SA11 3WN, SA11 3WP, SA11 3WQ, SA11 3WR, SA11 3WS, SA11 3WU, SA11 3WW, SA11 3WX, SA11 3WY, SA11 3XG, SA11 3XU, SA11 3ZB, SA11 4WZ, SA11 4YA, SA11 4YB, SA11 4YD, SA11 4YQ, SA11 4YS, SA11 5WA, SA11 5WY, SA11 5WZ, SA11 5YB, SA11 5YE, SA11 5YG, SA11 5YQ, SA11 9AD, SA11 9AG, SA11 9AN, SA11 9AQ, SA11 9AR, SA11 9AS, SA11 9AU, SA11 9AZ, SA11 9BB, SA11 9BD, SA11 9BE, SA11 9BF, SA11 9BG, SA11 9BH, SA11 9BJ, SA11 9BL, SA11 9BN, SA11 9BP, SA11 9BQ, SA11 9BR, SA11 9BS, SA11 9BT, SA11 9BU, SA11 9BW, SA11 9BX, SA11 9BY, SA11 9BZ, SA11 9DA, SA11 9DB, SA11 9DD, SA11 9DE, SA11 9DF, SA11 9DG, SA11 9DH, SA11 9DJ, SA11 9DL, SA11 9DN, SA11 9DP, SA11 9DQ, SA11 9DR, SA11 9DS, SA11 9DT, SA11 9DU, SA11 9DX, SA11 9DY, SA11 9DZ, SA11 9EA, SA11 9EB, SA11 9ED",275,262,13
W00004911,SA10,"SA10 6PD, SA10 6PE, SA10 6PF, SA10 6PG, SA10 6PN, SA10 6PW, SA10 6TT",238,216,22
W00004910,SA10,"SA10 7AX, SA10 7ET, SA10 7EU, SA10 7EY, SA10 7HD, SA10 7HE, SA10 7HG, SA10 7HU, SA10 7HW",252,233,19
W00004909,SA10,"SA10 7HB, SA10 7HF, SA10 7HH, SA10 7LH, SA10 7LL, SA10 7LN",297,260,37
W00004858,SA10,"SA10 6EW, SA10 6LN, SA10 6LP, SA10 6LR, SA10 6LS, SA10 6LW, SA10 6NB, SA10 6UF, SA10 6UG, SA10 6UQ, SA11 1PZ",299,273,26
W00004857,SA10,"SA10 6AR, SA10 6AS, SA10 6AT, SA10 6AU, SA10 6UU, SA10 6UY, SA10 6YA, SA10 6YB, SA10 6YD, SA10 6YE, SA10 6YF",343,311,32
W00004856,SA10,"SA10 6DN, SA10 6EP, SA10 6ER, SA10 6ET, SA10 6EY, SA10 6EZ, SA10 6HA, SA10 6HB, SA10 6HD, SA10 6HE, SA10 6LE, SA10 6LH, SA10 6NE",294,268,26
W00004855,SA10,"SA10 6AF, SA10 6AG, SA10 6AP, SA10 6AW, SA10 6BA, SA10 6UH, SA10 6UL",248,227,21
W00004839,SA10,"SA10 8AJ, SA10 8AW, SA10 8AZ",273,240,33
W00004907,SA10,"SA10 6PP, SA10 6PR, SA10 6PU, SA10 6PX, SA10 6PY",235,218,17
W00004908,SA10,"SA10 6PJ, SA10 7HA, SA10 7HS, SA10 7JZ, SA10 7LB, SA10 7LD, SA10 7LE",217,198,19
W00004810,SA10,"SA10 7TR, SA10 7TT, SA10 7UG, SA10 7UR, SA10 7US",299,265,34
W00004827,SA10,"SA10 7AA, SA10 7AW, SA10 7ER, SA10 7HY, SA10 8DP, SA10 8DR, SA10 8DS, SA10 8DT, SA10 8DU, SA10 8DW, SA10 8DX",277,245,32
W00004812,SA10,"SA10 7AR, SA10 7PA, SA10 8DY, SA10 8EB, SA10 8EF, SA10 8EG",270,238,32
W00004828,SA10,"SA10 7SG, SA10 7SL, SA10 7SW",248,228,20
W00004826,SA10,"SA10 7BB, SA10 7EJ, SA10 7EP, SA10 7EW, SA10 7EX, SA10 7EZ",233,210,23
W00004829,SA10,"SA10 7AH, SA10 7AL, SA10 7RP, SA10 7SF",261,239,22
W00004815,SA10,"SA10 7AQ, SA10 7EQ, SA10 7TB, SA10 7TL, SA10 7TN, SA10 7TP, SA10 7TS, SA10 7TW, SA10 7YU",255,225,30
W00004816,SA10,"SA10 7UF, SA10 7UH, SA10 7UL, SA10 7UN, SA10 7UP, SA10 7UW, SA10 7WZ",232,198,34
W00004830,SA10,"SA10 7QT, SA10 7RQ, SA10 7RW, SA10 7RX, SA10 7XY, SA10 7YJ, SA10 7YL, SA10 7YT, SA10 7YZ, SA10 7ZA, SA10 7ZB",282,260,22
W00004831,SA10,"SA10 7PR, SA10 7PS, SA10 7SD, SA10 7SN, SA10 7SR, SA10 7SS",307,283,24
W00004817,SA10,"SA10 7TD, SA10 7TE, SA10 7TF, SA10 7TG, SA10 7TH, SA10 8EH",247,226,21
W00004832,SA10,"SA10 7QP, SA10 7QR, SA10 7QS, SA10 7RT, SA10 7RU, SA10 7RY, SA10 7SA",273,249,24
W00004818,SA10,"SA10 7AB, SA10 7AE, SA10 7AF, SA10 7AG, SA10 7AN, SA10 7AY, SA10 7BA, SA10 7EN, SA10 7RG, SA10 7ST, SA10 8DH, SA10 8DL, SA10 8DN",247,201,46
W00004833,SA10,"SA10 7DU, SA10 7EG, SA10 7FL, SA10 7QU, SA10 7QW, SA10 7QX",532,465,67
W00004834,SA10,"SA10 7DY, SA10 7EF, SA10 7EH",269,240,29
W00004819,SA10,"SA10 7AP, SA10 7AT, SA10 7AU, SA10 7PB, SA10 7PG, SA10 7PL, SA10 7PN, SA10 7PW, SA10 7SH",265,242,23
W00004820,SA10,"SA10 7BD, SA10 7BE, SA10 7BG, SA10 7BH, SA10 7BL, SA10 7BN, SA10 7BR, SA10 7FB, SA10 7RE, SA10 7RF, SA10 7UT, SA10 7UU",220,194,26
W00004867,SA10,"SA10 6UN, SA10 6UP, SA10 6UR, SA10 6US, SA10 6UT, SA10 6UW, SA10 6UX",279,240,39
W00004821,SA10,"SA10 7PH, SA10 7PP, SA10 7PT, SA10 7SP, SA10 7SQ",287,266,21
W00004822,SA10,"SA10 7EB, SA10 7FF, SA10 7FP, SA10 7SU, SA10 7SZ",294,244,50
W00004823,SA10,"SA10 7RZ, SA10 7SJ",297,265,32
W00004824,SA10,"SA10 7BZ, SA10 7FG, SA10 7FH, SA10 7PZ, SA10 7QA, SA10 7RD, SA10 7SX",412,361,51
W00004825,SA10,"SA10 7EL, SA10 7RA, SA10 7RB, SA10 7RJ, SA10 7SY",226,199,27
W00004836,SA10,"SA10 8AR, SA10 8AS, SA10 8AU, SA10 8AY, SA10 8BD, SA10 8BE",232,187,45
W00004837,SA10,"SA10 8BA, SA10 8BB, SA10 8BG, SA10 8BH, SA10 8BL, SA10 8BN, SA10 8BW, SA10 8ED, SA11 1QE, SA11 1QF, SA11 1QG, SA11 1QJ, SA11 1QL, SA11 1QN, SA11 1QQ, SA11 1QR, SA11 1QS, SA11 1QT, SA11 1QW, SA11 1QX, SA11 1QY",235,205,30
W00004838,SA10,"SA10 7LS, SA10 8AN, SA10 8AP, SA10 8AQ, SA10 8AT, SA10 8DE, SA10 8DF",334,291,43
W00004814,SA10,"SA10 7BX, SA10 7FD, SA10 7TU, SA10 7TY, SA10 7UA, SA10 7UB, SA10 7UD, SA10 7UE, SA10 7YW",264,229,35
W00004813,SA10,"SA10 7DJ, SA10 7DQ, SA10 7DX, SA10 7DZ, SA10 7XW, SA10 7YF, SA10 7YG, SA10 7YH, SA10 7YN, SA10 7YP, SA10 7YR, SA10 8AA, SA10 8AB, SA10 8AD, SA10 8AE",144,123,21
W00004811,SA10,"SA10 7EA, SA10 7ED, SA10 7GB, SA10 7PD, SA10 7PE, SA10 7PF, SA10 7PQ, SA10 7TA",295,242,53
W00005017,SA10,"SA10 9BP, SA10 9BR, SA10 9BS, SA10 9BT, SA10 9BU, SA10 9LF, SA10 9YB, SA10 9YD",244,197,47
W00004885,SA10,"SA10 8RT, SA10 8RU, SA10 8RY, SA10 8SA, SA10 8SB, SA10 8SD, SA10 8SY",289,236,53
W00005019,SA10,"SA10 9HP, SA10 9HR, SA10 9HS, SA10 9HT, SA10 9HU, SA10 9HW, SA10 9HX, SA10 9LB, SA10 9LD, SA10 9LE",388,348,40
W00005155,SA10,"SA10 8ER, SA11 3JB, SA11 3JF, SA11 3JG, SA11 3JL, SA11 3JP, SA11 3JQ",283,262,21
W00005018,SA10,"SA10 9BY, SA10 9DA, SA10 9HG, SA10 9HH, SA10 9HL, SA10 9HN, SA10 9LL, SA10 9LP, SA10 9LR, SA10 9LS, SA10 9LT, SA10 9NH, SA10 9NL",205,164,41
W00009936,SA10,"SA10 8EN, SA10 8EQ, SA10 8LQ, SA10 8LS, SA10 8LZ",344,284,60
W00009937,SA10,"SA10 8AL, SA10 8LF, SA10 8LG, SA10 8LH, SA10 8LN, SA10 8LW, SA10 8NA, SA10 8NQ",252,233,19
W00009938,SA10,"SA10 7RH, SA10 7RL, SA10 7RN, SA10 7SB, SA10 7SE",265,246,19
W00009939,SA10,"SA10 7FJ, SA10 7PU, SA10 7PX, SA10 7PY, SA10 7RR, SA10 7RS",353,298,55
W00004906,SA10,"SA10 7HT, SA10 7LF, SA10 7LG",224,203,21
W00004905,SA10,"SA10 7HL, SA10 7HN, SA10 7HP, SA10 7HR",269,253,16
W00010396,SA10,"SA10 6DX, SA10 6EA, SA10 6ED, SA10 6EG, SA10 6EJ, SA10 6FG, SA10 6FR, SA10 6LQ, SA10 6ND",260,231,29
W00010398,SA10,"SA10 6EE, SA10 6EH",328,290,38
W00010401,SA10,"SA10 6AY, SA10 6FX, SA10 6FY, SA10 6GB, SA10 6NL",310,263,47
W00004730,SA10,"SA10 8ES, SA10 8ET, SA10 8EU, SA10 8EY, SA10 8HA, SA10 8LD, SA10 8LE, SA10 8NL, SA10 8RA",377,333,44
W00004729,SA10,"SA10 8LA, SA10 8LB, SA10 8LY, SA10 8NH, SA10 8NN",239,225,14
W00004887,SA10,"SA10 8RG, SA10 8RH, SA10 8RL, SA10 8RN, SA10 8RP, SA10 8RW, SA10 8TE, SA10 8TF",273,231,42
W00010418,SA10,"SA10 6FS, SA10 6FT, SA10 6FZ",253,203,50
W00010435,SA10,"SA10 6EN, SA10 6FA, SA10 6FF, SA10 6FW, SA10 6GA, SA10 6HZ",279,229,50
W00010437,SA10,"SA10 6DG, SA10 6DH, SA10 6DZ, SA10 6EQ",335,301,34
W00004728,SA10,"SA10 8HB, SA10 8HD, SA10 8HE",322,269,53
W00004726,SA10,"SA10 8HF, SA10 8HG, SA10 8HH, SA10 8HL, SA10 8HN, SA10 8HP, SA10 8HR, SA10 8HS, SA10 8HT, SA10 8HW, SA10 8HY, SA10 8NF, SA10 8YE, SA10 8YF, SA10 8YN",190,162,28
W00010439,SA10,"SA10 6EL, SA10 6FB, SA10 6GE, SA10 6GZ, SA10 6HJ, SA10 6HQ, SA10 6HR, SA10 6JF, SA10 6JN, SA10 6JQ, SA10 6JW, SA10 6JX, SA10 6JY, SA10 6JZ",329,279,50
W00004725,SA10,"SA10 8LT, SA10 8NB, SA10 8ND",299,264,35
W00004724,SA10,"SA10 8LJ, SA10 8LL, SA10 8LP, SA10 8LR, SA10 8LU, SA10 8LX, SA10 8NE, SA10 8NX",293,258,35
W00010440,SA10,"SA10 6EF, SA10 6EU",171,137,34
W00004904,SA10,"SA10 6NN, SA10 6PS, SA10 6PZ, SA10 7AJ, SA10 7AZ, SA10 7BJ, SA10 7BQ, SA10 7YA, SA10 7YY, SA10 7ZX",103,91,12
W00002653,SA10,"SA10 9PG, SA10 9PL, SA10 9PN, SA10 9PP",283,222,61
W00002652,SA10,"SA10 9NS, SA10 9NT, SA10 9NU, SA10 9NY, SA10 9PA, SA10 9PB, SA10 9PD, SA10 9PE, SA10 9PF, SA10 9PT",245,192,53
W00002651,SA10,"SA10 9NA, SA10 9NB, SA10 9ND, SA10 9PH, SA10 9PW, SA10 9WZ, SA9 1FA, SA9 1FB, SA9 1FD, SA9 1FE, SA9 1FG, SA9 1FH, SA9 1FJ, SA9 1FQ, SA9 1GA, SA9 1GB, SA9 1GD, SA9 1GE, SA9 1GF, SA9 1GG, SA9 1GH, SA9 1GJ, SA9 1GL, SA9 1GN, SA9 1GQ, SA9 1TJ, SA9 1UB, SA9 1YG, SA9 1YJ, SA9 1YL, SA9 1YP, SA9 1YQ, SA9 1YR, SA9 1YW, SA9 1YY, SA9 1ZT",281,203,78
W00002649,SA10,"SA10 9NN, SA10 9NP, SA10 9NR, SA10 9NW, SA10 9PR, SA10 9PS, SA9 1TH, SA9 1TL, SA9 1TN, SA9 1TP, SA9 1TR, SA9 1TS, SA9 1TT, SA9 1TU, SA9 1TW, SA9 1TX, SA9 1TY, SA9 1TZ, SA9 1UA, SA9 1UD, SA9 1UE, SA9 1UF, SA9 1UQ, SA9 1YH, SA9 1YN",349,230,119
W00010430,SA10,"SA10 6FD, SA10 6FE, SA10 6FH, SA10 6FJ, SA10 6FL, SA10 6FN, SA10 6JE, SA10 6JG, SA10 6JU",283,242,41
W00005153,SA10,"SA10 8EP, SA11 3JN, SA11 3JR, SA11 3JT, SA11 3JW, SA11 3JX, SA11 3JY, SA11 3JZ, SA11 3LJ, SA11 3NQ",285,265,20
W00004888,SA10,"SA10 8NT, SA10 8NY, SA10 8PA, SA10 8PD, SA10 8PF, SA10 8PX",376,316,60
W00005127,SA10,"SA10 9BD, SA10 9BG, SA10 9BH, SA10 9BN, SA10 9BW, SA10 9DB, SA10 9DG, SA10 9DH, SA10 9DL, SA10 9EA, SA10 9GA",318,281,37
W00004873,SA10,"SA10 6RB, SA10 6RR, SA10 6RS, SA10 6SG, SA10 6SH, SA10 6SN",268,238,30
W00004874,SA10,"SA10 6RD, SA10 6RE, SA10 6RF, SA10 6RG, SA10 6RH, SA10 6RN, SA10 6RP, SA10 6RQ, SA10 6RW, SA10 6SU",274,248,26
W00004875,SA10,"SA10 6RA, SA10 6RT, SA10 6RU, SA10 6RY, SA10 6SA, SA10 6SB, SA10 6SD, SA10 6SE, SA10 6SF, SA10 6SL",283,252,31
W00004877,SA10,"SA10 6DL, SA10 6DR, SA10 6LB, SA10 6LD, SA10 6LG, SA10 6LX, SA10 6XP, SA10 6XR, SA10 6XW, SA10 6YG, SA10 6YH, SA10 6ZB",261,232,29
W00004879,SA10,"SA10 6DT, SA10 6DU, SA10 6DY, SA10 6EB, SA10 6ES, SA10 6HS, SA10 6HT, SA10 6HU",557,491,66
W00004870,SA10,"SA10 6PH, SA10 6PT, SA10 6TR, SA10 6TS, SA10 6TY",305,278,27
W00004869,SA10,"SA10 6NQ, SA10 6PL, SA10 6TA, SA10 6TL, SA10 6TN, SA10 6TQ",237,215,22
W00004886,SA10,"SA10 8NP, SA10 8NW, SA10 8RD, SA10 8RE, SA10 8RF, SA10 8RR, SA10 8RS, SA10 8SE, SA10 8SR, SA10 8TG, SA10 8XB, SA10 8YA, SA10 8YD",326,269,57
W00004882,SA10,"SA10 6HG, SA10 6HH, SA10 6HL, SA10 6HN, SA10 6HP, SA10 6HW, SA10 6HY, SA10 6LA, SA10 6LF, SA10 6LL, SA10 6SJ",290,264,26
W00004883,SA10,"SA10 8NR, SA10 8NS, SA10 8PB, SA10 8PE, SA10 8PG, SA10 8PQ, SA10 8PS, SA10 8PT, SA10 8PU, SA10 8PZ, SA10 8RB, SA10 8SU",354,281,73
W00005125,SA10,"SA10 9ER, SA10 9ES, SA10 9ET, SA10 9EU, SA10 9EX, SA10 9EY, SA10 9HA",306,218,88
W00005126,SA10,"SA10 9DU, SA10 9EB, SA10 9EE, SA10 9EF, SA10 9EH, SA10 9EJ, SA10 9EL, SA10 9EN, SA10 9EP, SA10 9EW",253,196,57
W00004871,SA10,"SA10 6PA, SA10 6TH, SA10 6TP, SA10 6TU, SA10 6TW",296,259,37
W00005128,SA10,"SA10 9AJ, SA10 9AP, SA10 9AR, SA10 9AS, SA10 9AW, SA10 9BA, SA10 9BB, SA10 9BE, SA10 9BL",344,289,55
W00005129,SA10,"SA10 9AB, SA10 9DF, SA10 9DJ, SA10 9DN, SA10 9DP, SA10 9DQ, SA10 9DW, SA10 9DY",214,173,41
W00005130,SA10,"SA10 9AA, SA10 9AE, SA10 9AF, SA10 9AG, SA10 9AH, SA10 9AL, SA10 9AN",234,191,43
W00005131,SA10,"SA10 9AD, SA10 9DE, SA10 9DR, SA10 9DS, SA10 9DT, SA10 9ED, SA10 9EG",302,208,94
W00005148,SA10,"SA10 8HU, SA11 3BZ, SA11 3FA, SA11 3FB, SA11 3FE, SA11 3FF, SA11 3QB, SA11 3QD, SA11 3QE, SA11 3QH",546,476,70
W00004903,SA10,"SA10 7AD, SA10 7AS, SA10 7BT, SA10 7BU, SA10 7BW, SA10 7DA, SA10 7DE, SA10 7JB, SA10 7JD, SA10 7JE, SA10 7JF, SA10 7JG",307,273,34
W00004884,SA10,"SA10 8BJ, SA10 8NG, SA10 8NU, SA10 8PH, SA10 8PL, SA10 8PN, SA10 8PP, SA10 8PR, SA10 8PW, SA10 8PY, SA10 8SF, SA10 8SG, SA10 8SH, SA10 8SL, SA10 8SN, SA10 8SP, SA10 8SS, SA10 8ST, SA10 8SW, SA10 8TA, SA10 8TB, SA10 8TD, SA10 9HB",263,194,69
W00004868,SA10,"SA10 6NP, SA10 6NR, SA10 6NW, SA10 6RL, SA10 6SR, SA10 6ST, SA10 6SY",330,303,27
W00005020,SA10,"SA10 9HY, SA10 9LA, SA10 9LG, SA10 9LH, SA10 9LN, SA10 9LW",308,264,44
W00004872,SA10,"SA10 6HF, SA10 6SP, SA10 6SS, SA10 6TB, SA10 6TD, SA10 6TE, SA10 6TF, SA10 6TG",251,230,21
W00004926,SA11,"SA11 5DW, SA11 5DZ, SA11 5ED, SA11 5EE, SA11 5EG, SA11 5EH",298,233,65
W00004927,SA11,"SA11 5EA, SA11 5EB, SA11 5RP, SA11 5RT, SA11 5RY",327,275,52
W00004928,SA11,"SA11 5DP, SA11 5DR, SA11 5DS, SA11 5DT, SA11 5DU, SA11 5DX, SA11 5DY, SA11 5EP, SA11 5ER, SA11 5EW, SA11 5HR, SA11 5HS, SA11 5RR, SA11 5RS, SA11 5SB, SA11 5SQ, SA11 5YA",279,236,43
W00004929,SA11,"SA11 5BR, SA11 5BS, SA11 5BT, SA11 5BU, SA11 5DA, SA11 5DH, SA11 5DL, SA11 5DN",240,188,52
W00004923,SA11,"SA11 5DG, SA11 5LE, SA11 5LF, SA11 5LG, SA11 5LH, SA11 5LL, SA11 5LN, SA11 5LP, SA11 5LR, SA11 5LS, SA11 5LT, SA11 5LU, SA11 5LY",275,225,50
W00004924,SA11,"SA11 5EN, SA11 5RG, SA11 5RN, SA11 5RW, SA11 5SA, SA11 5SE",273,255,18
W00004917,SA11,"SA11 4NL, SA13 3AA, SA13 3AH, SA13 3AW, SA13 3AY, SA13 3BA, SA13 3BG, SA13 3BH, SA13 3BL, SA13 3BN, SA13 3BP, SA13 3BR, SA13 3BS, SA13 3BT, SA13 3BU, SA13 3BW, SA13 3BY, SA13 3DA, SA13 3DB, SA13 3DD, SA13 3DE, SA13 3DN, SA13 3EA",279,268,11
W00004919,SA11,"SA11 5AU, SA11 5BD, SA11 5BG, SA11 5BH, SA11 5LD, SA11 5NR, SA11 5NS, SA11 5NT, SA11 5TY, SA11 5UB, SA11 5UD, SA11 5UE",234,176,58
W00004920,SA11,"SA11 5AR, SA11 5AS, SA11 5BA, SA11 5TU",228,178,50
W00004921,SA11,"SA11 5AP, SA11 5AQ, SA11 5AY, SA11 5BB, SA11 5HY, SA11 5LA, SA11 5LB",266,194,72
W00004922,SA11,"SA11 5AF, SA11 5AL, SA11 5AN, SA11 5AW, SA11 5BE, SA11 5DB, SA11 5DD, SA11 5DE, SA11 5DF",255,201,54
W00004925,SA11,"SA11 5AA, SA11 5AB, SA11 5AD, SA11 5AE, SA11 5AG, SA11 5AH, SA11 5AX, SA11 5BY, SA11 5EF",300,235,65
W00004930,SA11,"SA11 4DB, SA11 4DT, SA11 4DU, SA11 4DY, SA11 4DZ, SA11 5AJ, SA11 5AT, SA11 5PX, SA11 5PY, SA11 5RA, SA11 5RB, SA11 5RE, SA11 5RF, SA11 5RH, SA11 5RL, SA11 5RU, SA11 5SD, SA11 5UA",310,260,50
W00005008,SA11,"SA11 3NP, SA11 3NR, SA11 3NS, SA11 3NT, SA11 3NU",279,238,41
W00004965,SA11,"SA11 2AH, SA11 2AL, SA11 2AN, SA11 2AR, SA11 2AS, SA11 2AU, SA11 2BH, SA11 2FD, SA11 2FF, SA11 2HW",300,276,24
W00005005,SA11,"SA11 1HZ, SA11 3PH, SA11 3PL, SA11 3PS, SA11 3QU, SA11 3RX, SA11 3RZ, SA11 3SU, SA11 3SY",301,256,45
W00005006,SA11,"SA11 3NN, SA11 3NW, SA11 3TP, SA11 3TR, SA11 3TW",301,264,37
W00005007,SA11,"SA11 1DQ, SA11 1DX, SA11 1ED, SA11 1EX, SA11 1EZ",241,217,24
W00005009,SA11,"SA11 1JS, SA11 1JT, SA11 1JU, SA11 1JW, SA11 3TS, SA11 3TT, SA11 3TU, SA11 3UB",307,285,22
W00005010,SA11,"SA11 1AZ, SA11 1BQ, SA11 1BX, SA11 1BZ, SA11 1DJ, SA11 1QB, SA11 1TG, SA11 1TL, SA11 1TN, SA11 1TP, SA11 1TR, SA11 1TW, SA11 1TX",255,229,26
W00005011,SA11,"SA11 1JN, SA11 3PB, SA11 3TY, SA11 3UA, SA11 3UD, SA11 3UE, SA11 3UF",284,247,37
W00005012,SA11,"SA11 1JL, SA11 3NY, SA11 3PA, SA11 3PD, SA11 3PE, SA11 3PF, SA11 3UG, SA11 3UH",277,251,26
W00005013,SA11,"SA11 1UA, SA11 1UB, SA11 1UE, SA11 1YD, SA11 1YF, SA11 1YG, SA11 1YL, SA11 1YN, SA11 1YW, SA11 2AW, SA11 3QT",287,267,20
W00005014,SA11,"SA11 1TS, SA11 1UF, SA11 1UG, SA11 1UL, SA11 1YH",262,235,27
W00005015,SA11,"SA11 1GA, SA11 1GB, SA11 1UH, SA11 1UN, SA11 1UP, SA11 1UR, SA11 1US, SA11 1UW, SA11 1WF, SA11 1WG, SA11 1WH, SA11 1WN, SA11 1WQ, SA11 1YA, SA11 1YB, SA11 1YE",441,412,29
W00005016,SA11,"SA11 1GQ, SA11 1JB, SA11 1JF, SA11 1JG, SA11 1JH, SA11 1JJ, SA11 1JQ",309,288,21
W00005022,SA11,"SA11 3QN, SA11 3QP, SA12 9SJ, SA12 9SL, SA12 9SN, SA12 9UF, SA12 9UG, SA12 9UH, SA12 9UL, SA12 9UN",330,296,34
W00005060,SA11,"SA11 4AP, SA11 4AS, SA11 4AT, SA11 4AU, SA11 4AY, SA11 4BA, SA11 4BB, SA11 4BD, SA11 4BE, SA11 4EG",222,207,15
W00005061,SA11,"SA11 4AX, SA11 4BG, SA11 4BH, SA11 4BJ, SA11 4BL, SA11 4BN, SA11 4BQ, SA11 4BR, SA11 4BT, SA11 4BW, SA11 4BX, SA11 4EN, SA11 4EW",248,227,21
W00005062,SA11,"SA11 4BP, SA11 4BS, SA11 4EH, SA11 4EL, SA11 4EP, SA11 4ER, SA11 4ES, SA11 4ET, SA11 4EU",283,254,29
W00005063,SA11,"SA11 4BU, SA11 4LP, SA11 4LR, SA11 4LS, SA11 4LT",249,228,21
W00005064,SA11,"SA11 4HB, SA11 4HF, SA11 4HU, SA11 4HY, SA11 4LH, SA11 4LL, SA11 4LN, SA11 4LU, SA11 4LW, SA11 4LY",278,235,43
W00002655,SA11,"SA11 5NB, SA11 5ND, SA11 5NE, SA11 5NH, SA11 5NJ, SA11 5NL, SA11 5NN, SA11 5NP, SA11 5NU, SA11 5NW, SA11 5NX, SA11 5UF, SA11 5UG, SA11 5UJ, SA11 5UL, SA11 5UN, SA11 5UW, SA11 5XU, SA11 5YD",370,302,68
W00009946,SA11,"SA11 2BL, SA11 2EJ, SA11 2EP, SA11 2EW",266,237,29
W00009942,SA11,"SA11 2HX, SA11 2JL, SA11 2JR, SA11 2LQ",264,241,23
W00009935,SA11,"SA11 2HB, SA11 2HD, SA11 2HR, SA11 2JF, SA11 2JY",242,197,45
W00005154,SA11,"SA11 3JH, SA11 3LQ, SA11 3NZ, SA11 3PJ, SA11 3PQ, SA11 3PX, SA11 3PZ",265,235,30
W00005152,SA11,"SA11 3JS, SA11 3LX, SA11 3LZ, SA11 3NJ, SA11 3NX",250,232,18
W00005004,SA11,"SA11 3RU, SA11 3RY, SA11 3SA, SA11 3SF",256,231,25
W00005151,SA11,"SA11 3DJ, SA11 3DQ, SA11 3ER, SA11 3EU, SA11 3FD, SA11 3FH, SA11 3LE",389,338,51
W00005070,SA11,"SA11 4DD, SA11 4DE, SA11 4DF, SA11 4DG, SA11 4DH, SA11 4DJ, SA11 4DL, SA11 4DN, SA11 4DP, SA11 4DR, SA11 4DS, SA11 4DW, SA11 4EA",223,193,30
W00005069,SA11,"SA11 4AH, SA11 4AN, SA11 4AR, SA11 4BY, SA11 4EB, SA11 4ED, SA11 4EE, SA11 4EF, SA11 4NG, SA11 4NH, SA11 4NW, SA11 4SP",309,278,31
W00005068,SA11,"SA11 4AA, SA11 4AB, SA11 4AL, SA11 4AW, SA11 4NA, SA11 4NB, SA11 4ND, SA11 4NE, SA11 4NJ, SA11 4NN, SA11 4NR",280,242,38
W00005067,SA11,"SA11 4AD, SA11 4AE, SA11 4AF, SA11 4AG, SA11 4AZ, SA11 4BZ, SA11 4HG, SA11 4HL, SA11 4HN, SA11 4HW, SA11 4SR",275,257,18
W00005066,SA11,"SA11 4HT, SA11 4LA, SA11 4LB, SA11 4LD, SA11 4LE, SA11 4LF, SA11 4LG",243,217,26
W00005065,SA11,"SA11 4HD, SA11 4HE, SA11 4HH, SA11 4HR, SA11 4HS",259,225,34
W00005150,SA11,"SA11 3DX, SA11 3DZ, SA11 3EJ, SA11 3EQ, SA11 3EX, SA11 3EZ, SA11 3GZ",259,225,34
W00005003,SA11,"SA11 1JA, SA11 3SB, SA11 3SD, SA11 3SE",277,258,19
W00005002,SA11,"SA11 1JD, SA11 1JE, SA11 1JP, SA11 1JR, SA11 1UT, SA11 1UU, SA11 1UY",312,286,26
W00005001,SA11,"SA11 3PT, SA11 3PU, SA11 3PY, SA11 3RN, SA11 3RS, SA11 3RT, SA11 3RW",275,251,24
W00004980,SA11,"SA11 1AA, SA11 1AD, SA11 1AF, SA11 1AP, SA11 1AR, SA11 1AW, SA11 1BG, SA11 1BH, SA11 1BR, SA11 1NY, SA11 1PD, SA11 1PR, SA11 1SU",273,252,21
W00004979,SA11,"SA11 1AS, SA11 1AT, SA11 1AY, SA11 1BA, SA11 1BB, SA11 1BD, SA11 1BE, SA11 1BT, SA11 1DD",298,278,20
W00004978,SA11,"SA11 1AB, SA11 1AE, SA11 1DZ, SA11 1EJ, SA11 1EQ, SA11 1HH, SA11 1HQ, SA11 1HX, SA11 1LA, SA11 1LL, SA11 1QH, SA11 1QU, SA11 1WA, SA11 1WE, SA11 1WR, SA11 1WS, SA11 1WT, SA11 1WU, SA11 1WY, SA11 1YJ, SA11 1YR, SA11 1YS, SA11 1YX",188,171,17
W00004977,SA11,"SA11 1AG, SA11 1AH, SA11 1AN, SA11 1PH, SA11 1PL",235,209,26
W00004976,SA11,"SA11 1BN, SA11 1BP, SA11 1BU, SA11 1BW",194,180,14
W00004975,SA11,"SA11 1HN, SA11 1HY, SA11 1LB, SA11 1ND, SA11 1NT, SA11 1NU, SA11 1PA, SA11 1PB, SA11 1PE, SA11 1PF",257,233,24
W00004981,SA11,"SA11 1SR, SA11 1SS, SA11 1ST, SA11 1SY, SA11 1TA, SA11 1TD, SA11 1TT, SA11 1TU, SA11 1TY",252,235,17
W00004974,SA11,"SA11 1NP, SA11 1PG, SA11 1PN, SA11 1PW, SA11 1SW",226,210,16
W00004972,SA11,"SA11 1AJ, SA11 1AQ, SA11 1AX, SA11 1BJ, SA11 1YT, SA11 1YU, SA11 1YY, SA11 1ZB",260,232,28
W00004971,SA11,"SA11 1HL, SA11 1HP, SA11 1HR, SA11 1HS, SA11 1HT, SA11 1HU, SA11 1LF, SA11 1LG, SA11 3PN, SA11 3PR",246,235,11
W00004970,SA11,"SA11 2HE, SA11 2HF, SA11 2HG, SA11 2HH, SA11 2HP",217,193,24
W00004969,SA11,"SA11 2AY, SA11 2BA, SA11 2BB, SA11 2BD, SA11 2BE, SA11 2BG",250,240,10
W00004968,SA11,"SA11 2AA, SA11 2AB, SA11 2AG, SA11 2AP, SA11 2AT, SA11 2LX",296,277,19
W00004966,SA11,"SA11 2BN, SA11 2DD, SA11 2DE, SA11 2DF, SA11 2DG, SA11 2EA, SA11 2EF, SA11 2EL, SA11 2FA",246,226,20
W00004973,SA11,"SA11 1LR, SA11 1LX, SA11 1LZ, SA11 1NE, SA11 1NF, SA11 1NH, SA11 1NL, SA11 1NN, SA11 1NR, SA11 1NW, SA11 1PP",287,268,19
W00004964,SA11,"SA11 1AU, SA11 1BS, SA11 1NJ, SA11 1NQ, SA11 1NX, SA11 1NZ, SA11 1PJ, SA11 1QA, SA11 2EE, SA11 2EG, SA11 2EH, SA11 2EN, SA11 2HL, SA11 2HN",209,198,11
W00004982,SA11,"SA11 1TB, SA11 1TE, SA11 1UD, SA11 2AD, SA11 2AE, SA11 2AF",245,236,9
W00004984,SA11,"SA11 2DA, SA11 2DB, SA11 2DR, SA11 2DS, SA11 2DW, SA11 2EB",252,229,23
W00005000,SA11,"SA11 1BL, SA11 1ER, SA11 1ES, SA11 1ET, SA11 1EW, SA11 1EY, SA11 1GD, SA11 1LD, SA11 1LE, SA11 1NG, SA11 1NS",291,268,23
W00004999,SA11,"SA11 3AE, SA11 3TD, SA11 3TE, SA11 3TF, SA11 3TG, SA11 3TH, SA11 3TL, SA11 3TN",332,278,54
W00004998,SA11,"SA11 3AB, SA11 3AD, SA11 3AF, SA11 3AG, SA11 3AH, SA11 3AL, SA11 3AU, SA11 3BN, SA11 3BP, SA11 3PP, SA11 3QZ",310,263,47
W00004996,SA11,"SA11 1DS, SA11 1DT, SA11 1HD, SA11 1HE, SA11 1HG, SA11 1HW, SA11 3AA, SA11 3AY, SA11 3BA, SA11 3BB, SA11 3BD, SA11 3BE, SA11 3BH, SA11 3EG, SA11 3EH, SA11 3EL, SA11 3EN, SA11 3EP, SA11 3EY, SA11 3FJ, SA11 3PW",198,183,15
W00004995,SA11,"SA11 3BR, SA11 3DU, SA11 3DY, SA11 3QJ, SA11 3TQ",198,174,24
W00004994,SA11,"SA11 1RF, SA11 3AP, SA11 3AR, SA11 3AS, SA11 3AT, SA11 3BG, SA11 3BL, SA11 3BT, SA11 3BW, SA11 3BY, SA11 3DA, SA11 3DB, SA11 3DE, SA11 3ES, SA11 3ET, SA11 3HA, SA11 3HB, SA11 3HE",203,185,18
W00004983,SA11,"SA11 1TF, SA11 2BS, SA11 2BT, SA11 2BU, SA11 2BY, SA11 2DU",238,211,27
W00004993,SA11,"SA11 3AN, SA11 3AW, SA11 3BU, SA11 3DN, SA11 3DP, SA11 3DR, SA11 3DW, SA11 3EA, SA11 3EB, SA11 3FG",232,208,24
W00004991,SA11,"SA11 3DD, SA11 3DG, SA11 3DH, SA11 3DL, SA11 3HW",276,255,21
W00004990,SA11,"SA11 3DS, SA11 3DT, SA11 3HP, SA11 3HY",215,198,17
W00004989,SA11,"SA11 3HH, SA11 3HL, SA11 3HN, SA11 3LB, SA11 3LD",215,201,14
W00004988,SA11,"SA11 1RH, SA11 1RJ, SA11 1RZ, SA11 3DF, SA11 3EW, SA11 3HF, SA11 3HG",208,190,18
W00004986,SA11,"SA11 3HR, SA11 3HS, SA11 3HT, SA11 3HU, SA11 3LA",272,240,32
W00004985,SA11,"SA11 2DH, SA11 2DL, SA11 2DN, SA11 2DP, SA11 2ED, SA11 2EQ",175,158,17
W00004992,SA11,"SA11 1RQ, SA11 1RX, SA11 3GA, SA11 3HD, SA11 3LL, SA11 3LN, SA11 3LP, SA11 3LS, SA11 3LT, SA11 3LU, SA11 3LW, SA11 3LY, SA11 3NA, SA11 3NB, SA11 3ND, SA11 3NE, SA11 3NF",153,142,11
W00005149,SA11,"SA11 3HJ, SA11 3HQ, SA11 3HX, SA11 3HZ, SA11 3JA, SA11 3JD, SA11 3JE, SA11 3JJ, SA11 3JU",300,268,32
W00004987,SA11,"SA11 3BS, SA11 3ED, SA11 3EE, SA11 3EF, SA11 3WD, SA11 3WE, SA11 3WG, SA11 3WL, SA11 3WZ, SA11 3YZ",329,305,24
W00004785,SA11,"SA11 2LE, SA11 2LH, SA11 2LN, SA11 2LS, SA11 2LU, SA11 2LW",301,276,25
W00004763,SA11,"SA11 5RX, SA11 5SL, SA11 5SN, SA11 5ST, SA11 5SU, SA11 5SY",201,189,12
W00004764,SA11,"SA11 5ES, SA11 5ET, SA11 5EU, SA11 5EY, SA11 5EZ, SA11 5HA, SA11 5HB, SA11 5HD, SA11 5HE",276,240,36
W00004765,SA11,"SA11 5HH, SA11 5HL, SA11 5HN, SA11 5HP, SA11 5RD, SA11 5SF",270,232,38
W00004766,SA11,"SA11 5HF, SA11 5HG, SA11 5HW, SA11 5SG",271,238,33
W00004767,SA11,"SA11 2DJ, SA11 2DZ, SA11 2EX, SA11 2SF, SA11 2SG, SA11 2SH",147,145,2
W00004768,SA11,"SA11 2BZ, SA11 2RP, SA11 2RS, SA11 2RU, SA11 2RY, SA11 2RZ, SA11 2SA, SA11 2SB",235,209,26
W00004769,SA11,"SA11 2AQ, SA11 2DQ, SA11 2DX, SA11 2EZ, SA11 2HQ, SA11 2JS, SA11 2NL, SA11 2RL, SA11 2SD, SA11 2SE, SA11 2YR, SA11 2YT, SA11 2YU, SA11 2YW, SA11 2YY",235,219,16
W00004770,SA11,"SA11 2ER, SA11 2ES, SA11 2ET, SA11 2EU, SA11 2TG, SA11 2TH, SA11 2TP",380,347,33
W00004771,SA11,"SA11 2HS, SA11 2TL, SA11 2TN, SA11 2TR, SA11 2TS, SA11 2TT, SA11 2TU, SA11 2TW, SA11 2TY, SA11 3QS",253,229,24
W00004772,SA11,"SA11 2SL, SA11 2SP, SA11 2SR, SA11 2SS, SA11 2ST, SA11 2SU, SA11 2SW",269,242,27
W00004760,SA11,"SA11 5PB, SA11 5PD, SA11 5PE, SA11 5PR, SA11 5PW, SA11 5PZ",250,215,35
W00004762,SA11,"SA11 5LW, SA11 5SW, SA11 5TA, SA11 5TB, SA11 5TD, SA11 5TE, SA11 5TP, SA11 5TW",322,294,28
W00004759,SA11,"SA11 2YJ, SA12 8LA, SA12 8LD, SA12 8LE, SA12 8LF, SA12 8LH, SA12 8LL, SA12 8LN, SA12 8LW, SA12 8TU",287,266,21
W00004774,SA11,"SA11 2AX, SA11 2HA, SA11 2NR, SA11 2NS, SA11 2SN, SA11 2TE, SA11 2TF, SA11 2TJ",260,238,22
W00004775,SA11,"SA11 2AZ, SA11 2NU, SA11 2NY, SA11 2PA, SA11 2PB",275,247,28
W00004787,SA11,"SA11 2LT, SA11 2LY, SA11 2NA, SA11 2NB, SA11 2ND, SA11 2NG, SA11 2NH, SA11 2PU, SA11 2PX",243,223,20
W00004786,SA11,"SA11 2HT, SA11 2NE, SA11 2NF, SA11 2NT, SA11 2UE",273,245,28
W00004776,SA11,"SA11 2AJ, SA11 2BJ, SA11 2BQ, SA11 2PD, SA11 2PE, SA11 2PF",250,232,18
W00004784,SA11,"SA11 2LF, SA11 2LG, SA11 2LL",270,245,25
W00004783,SA11,"SA11 2HU, SA11 2LA, SA11 2LB, SA11 2LD",306,279,27
W00004782,SA11,"SA11 2HY, SA11 2UF, SA11 2UG, SA11 2UH, SA11 2YG",315,281,34
W00004781,SA11,"SA11 2UL, SA11 2UN, SA11 2UP, SA11 2UQ, SA11 2UR, SA11 2US, SA11 2UT, SA11 2UU, SA11 2UW, SA11 2UY, SA11 2WA, SA11 2YA, SA11 2YB, SA11 2YD, SA11 2YH",332,288,44
W00004780,SA11,"SA11 2JA, SA11 2PL, SA11 2PN, SA11 2PY, SA11 2PZ, SA11 2RA, SA11 2RD, SA11 2RE, SA11 2RF",266,237,29
W00004779,SA11,"SA11 2FP, SA11 2GA, SA11 2GG, SA11 2HJ, SA11 2HZ, SA11 2JB, SA11 2JD, SA11 2JE, SA11 2JG, SA11 2JH, SA11 2JJ, SA11 2JN, SA11 2JP, SA11 2JQ, SA11 2JU, SA11 2JW",272,266,6
W00004773,SA11,"SA11 2EY, SA11 2SY, SA11 2TA, SA11 2TB, SA11 2TD, SA11 2YL, SA11 2YN, SA11 2YP, SA11 2YZ",269,248,21
W00004778,SA11,"SA11 2JT, SA11 2JX, SA11 2LP, SA11 2LR, SA11 2NP, SA11 2PP, SA11 2PR, SA11 2PS, SA11 2PT, SA11 2PW, SA11 2RB",221,201,20
W00004777,SA11,"SA11 2BX, SA11 2PG, SA11 2PH, SA11 2RN, SA11 2RR, SA11 2RT, SA11 2RW",279,255,24
W00004846,SA11,"SA11 2DT, SA11 2QA, SA11 3XE",212,191,21
W00004849,SA11,"SA11 2BP, SA11 3QF, SA11 3SN, SA11 3SP, SA11 3SR, SA11 3SW",241,226,15
W00004848,SA11,"SA11 3RA, SA11 3RB, SA11 3RD, SA11 3RE, SA11 3RF, SA11 3RG, SA11 3RH",339,323,16
W00004850,SA11,"SA11 3QG, SA11 3QQ, SA11 3QX, SA11 3RP, SA11 3TA",238,223,15
W00004851,SA11,"SA11 3RJ, SA11 3RL, SA11 3RR, SA11 3SG, SA11 3SH, SA11 3SJ, SA11 3SL, SA11 3SX",377,326,51
W00004852,SA11,"SA11 3QR, SA11 3QW, SA11 3XA, SA11 3XB, SA11 3XD, SA11 3XF, SA11 3XH",305,265,40
W00004854,SA11,"SA11 3BJ, SA11 3YB, SA11 3YE, SA11 3YG, SA11 3YH",258,230,28
W00004853,SA11,"SA11 3AZ, SA11 3BQ, SA11 3QL, SA11 3ST, SA11 3UP, SA11 3UR, SA11 3US, SA11 3UT, SA11 3UU, SA11 3WF, SA11 3WT",288,261,27
W00004847,SA11,"SA11 1QD, SA11 3UY, SA11 3YA, SA11 3YD, SA11 3YF",273,246,27
W00004842,SA11,"SA11 2BR, SA11 2BW, SA11 2DY",270,243,27
W00004843,SA11,"SA11 3BX, SA11 3YJ, SA11 3YQ",271,237,34
W00004844,SA11,"SA11 3YL, SA11 3YN, SA11 3YP, SA11 3YR, SA11 3YT, SA11 3YW",290,262,28
W00004845,SA11,"SA11 3AJ, SA11 3AQ, SA11 3AX, SA11 3SS, SA11 3XW, SA11 3YS, SA11 3YU, SA11 3YX, SA11 3YY, SA11 3ZX",249,233,16
W00005123,SA12,"SA12 7NE, SA12 7RU, SA12 7RX, SA12 7SE, SA12 7SG, SA12 7SQ, SA12 7SZ",247,236,11
W00005053,SA12,"SA12 8RB, SA12 8RD, SA13 2EB, SA13 2ES, SA13 2ET, SA13 2EU, SA13 2EX, SA13 2EY, SA13 2HA, SA13 2HB",428,372,56
W00005124,SA12,"SA12 7AQ, SA12 7DL, SA12 7DN, SA12 7DP, SA12 7DR, SA12 7DW, SA12 7DX, SA12 7HN",249,235,14
W00005054,SA12,"SA12 8RA, SA12 8RE, SA12 8RF, SA13 1AX, SA13 1BJ, SA13 1BQ, SA13 1BX, SA13 1YB, SA13 1YD",280,257,23
W00005058,SA12,"SA12 8SD, SA13 1AQ, SA13 1NY, SA13 1PA, SA13 1PH, SA13 1US, SA13 1UU, SA13 1UY, SA13 1XR, SA13 1XW, SA13 1YA, SA13 1YE, SA13 1YF, SA13 1YG, SA13 1YL",256,228,28
W00004758,SA12,"SA12 8DR, SA12 8DX, SA12 8HL, SA12 8HN, SA12 8HR, SA12 8HW",263,243,20
W00005106,SA12,"SA12 7AS, SA12 7AT, SA12 7AU, SA12 7AW, SA12 7AY, SA12 7BA, SA12 7BB, SA12 7BG, SA12 7EN, SA12 7YG, SA12 7YH, SA12 7YP, SA12 7YR, SA12 7YT",277,254,23
W00004756,SA12,"SA12 8AH, SA12 8EH, SA12 8EL, SA12 8ET, SA12 8EU, SA12 8EY, SA12 8EZ",402,376,26
W00005113,SA12,"SA12 7NA, SA12 7NB, SA12 7NN, SA12 7NU",271,253,18
W00004754,SA12,"SA12 8AF, SA12 8AG, SA12 8AL, SA12 8DU, SA12 8DY, SA12 8EA, SA12 8HY, SA12 8YG, SA12 9YA",329,294,35
W00005024,SA12,"SA12 9SH, SA12 9SW, SA12 9TU, SA12 9TW, SA12 9TY, SA12 9UA, SA12 9UB, SA12 9UD, SA12 9UE, SA12 9UT, SA12 9UY",281,255,26
W00005023,SA12,"SA12 9RP, SA12 9RS, SA12 9SG, SA12 9TF, SA12 9TG, SA12 9TH, SA12 9TL, SA12 9TN, SA12 9TP, SA12 9TR, SA12 9TS, SA12 9TT",250,212,38
W00005021,SA12,"SA12 9SP, SA12 9SR, SA12 9SS, SA12 9ST, SA12 9SU, SA12 9SY, SA12 9TA, SA12 9UP, SA12 9UR, SA12 9US, SA12 9UU, SA12 9UW, SA12 9UX",270,231,39
W00005114,SA12,"SA12 7HP, SA12 7HY, SA12 7LB, SA12 7LD, SA12 7LG, SA12 7LH",292,282,10
W00005115,SA12,"SA12 7NW, SA12 7NY, SA12 7RF, SA12 7RH, SA12 7RS",295,276,19
W00005116,SA12,"SA12 7GA, SA12 7HB, SA12 7HD, SA12 7HF, SA12 7HG, SA12 7HH, SA12 7LA",372,327,45
W00005117,SA12,"SA12 7HE, SA12 7HL, SA12 7LE, SA12 7LF, SA12 7LN",334,317,17
W00005118,SA12,"SA12 7NP, SA12 7NS, SA12 7PB, SA12 7PF, SA12 7PG, SA12 7RG",314,284,30
W00005119,SA12,"SA12 7LY, SA12 7NH, SA12 7NL, SA12 7NR, SA12 7NT, SA12 7NX, SA12 7QA",302,279,23
W00005120,SA12,"SA12 7AG, SA12 7AH, SA12 7BH, SA12 7BL, SA12 7BN, SA12 7BQ, SA12 7BU, SA12 7SU, SA12 7SY, SA12 7TB, SA12 7TD",272,254,18
W00004757,SA12,"SA12 8AA, SA12 8AB, SA12 8AD, SA12 8AE, SA12 8DS, SA12 8DT, SA12 8HP",310,273,37
W00004755,SA12,"SA12 8AS, SA12 8AY, SA12 8EB, SA12 8ED, SA12 8EE, SA12 8EF, SA12 8EG",241,222,19
W00005111,SA12,"SA12 7HR, SA12 7LL, SA12 7ND, SA12 7NG, SA13 1WG, SA13 1WP",282,264,18
W00005107,SA12,"SA12 7RP, SA12 7RR, SA12 7RY, SA12 7SA, SA12 7SB, SA12 7SD, SA12 7SF",308,273,35
W00005105,SA12,"SA12 7PH, SA12 7PL, SA12 7PN, SA12 7PP, SA12 7PR, SA12 7PU, SA12 7PW, SA12 7PY, SA12 7RA, SA12 7RB, SA12 7TG, SA12 7TH",236,213,23
W00005104,SA12,"SA12 7TJ, SA12 7TP, SA12 7TR, SA12 7TS, SA12 7TT, SA12 7TU, SA12 7TX, SA12 7UG, SA12 7YD, SA12 7YE",277,262,15
W00005103,SA12,"SA12 7PQ, SA12 7PS, SA12 7PT, SA12 7SS, SA12 7SW, SA12 7TA, SA12 7TF, SA12 7TZ, SA12 7UA, SA12 7UB, SA12 7UD, SA12 7UE, SA12 7UF",405,375,30
W00005102,SA12,"SA12 7RT, SA12 7SH, SA12 7SL, SA12 7SN, SA12 7SP, SA12 7SR, SA12 7SX, SA12 7TE, SA12 7TY",259,240,19
W00005101,SA12,"SA12 6RP, SA12 6RR, SA12 6TG, SA12 6TH, SA12 6TQ",289,271,18
W00005100,SA12,"SA12 6SU, SA12 6TE, SA12 6TF",344,322,22
W00005099,SA12,"SA12 6PJ, SA12 6PX, SA12 6PZ, SA12 6QA, SA12 6RN, SA12 6RS, SA12 6RW, SA12 6TR, SA12 6TS, SA12 6TW",276,261,15
W00005098,SA12,"SA12 6BB, SA12 6BD, SA12 6BE, SA12 6BH, SA12 6BP, SA12 6DN",343,323,20
W00005097,SA12,"SA12 6AH, SA12 6BL, SA12 6BN, SA12 6BS, SA12 6BT, SA12 6BW",292,268,24
W00005096,SA12,"SA12 6AF, SA12 6AL, SA12 6AP, SA12 6AR, SA12 6AT, SA12 6AW, SA12 6BG",241,227,14
W00005095,SA12,"SA12 6JD, SA12 6JE, SA12 6JF, SA12 6QJ",249,241,8
W00005094,SA12,"SA12 6JB, SA12 6JG, SA12 6JH, SA12 6JJ, SA12 6JP, SA12 6JQ, SA12 6JR, SA12 6LJ, SA12 6SB, SA12 7PE",186,177,9
W00005093,SA12,"SA12 6AD, SA12 6PG, SA12 6QQ",302,285,17
W00005112,SA12,"SA12 7DS, SA12 7HS, SA12 7HT, SA12 7HU, SA12 7HW",287,260,27
W00005092,SA12,"SA12 6DE, SA12 6DF, SA12 6DG",163,154,9
W00005090,SA12,"SA12 6AE, SA12 6AG, SA12 6BU, SA12 6BY",249,239,10
W00005089,SA12,"SA12 6AB, SA12 6DB, SA12 6HJ, SA12 6HQ, SA12 6HZ, SA12 6PF, SA12 6QF, SA12 6QG, SA12 6QL",330,310,20
W00005088,SA12,"SA12 6DP, SA12 6HX, SA12 6PD, SA12 6PE, SA12 6PL, SA12 6PN, SA12 6PP, SA12 6PS, SA12 6PW, SA12 6YJ, SA12 6YZ",390,356,34
W00005108,SA12,"SA12 7AA, SA12 7AB, SA12 7AD, SA12 7DT, SA12 7DU, SA12 7EF, SA12 7EG",287,260,27
W00005086,SA12,"SA12 6JT, SA12 6JU, SA12 6JW, SA12 6JX, SA12 6JY, SA12 6QP, SA12 6QW, SA12 6SP, SA12 6SQ, SA12 6SW, SA12 6TT",187,180,7
W00005085,SA12,"SA12 6JL, SA12 6JN, SA12 6JS, SA12 6JZ, SA12 6LQ, SA12 6RA",216,199,17
W00005084,SA12,"SA12 6ST, SA12 7LS, SA12 7LT, SA12 7LU, SA12 7LX, SA12 7LZ",317,306,11
W00005083,SA12,"SA12 6BA, SA12 6JA, SA12 6NJ, SA12 6NX, SA12 6NZ, SA12 6PQ",267,241,26
W00005082,SA12,"SA12 6QB, SA12 6RH, SA12 6RT, SA12 6RU, SA12 6RX, SA12 6SF",265,237,28
W00005081,SA12,"SA12 6SY, SA12 6TA, SA12 6TB, SA12 6TD, SA12 6TL, SA12 6TN, SA12 6TP",288,269,19
W00005080,SA12,"SA12 6PU, SA12 6RF, SA12 6RG, SA12 6SG, SA12 6SH, SA12 6SL, SA12 6SN, SA12 6SR, SA12 6SS",239,230,9
W00005109,SA12,"SA12 7RD, SA12 7RE, SA12 7TL, SA12 7TN, SA12 7TW",285,266,19
W00005110,SA12,"SA12 7ED, SA12 7EH, SA12 7EL, SA12 7EP, SA12 7ER, SA12 7ES, SA12 7ET, SA12 7EW",237,215,22
W00005091,SA12,"SA12 6LB, SA12 6LX, SA12 6PH, SA12 6PR, SA12 6QH",285,271,14
W00005087,SA12,"SA12 6PT, SA12 6PY, SA12 6RB, SA12 6RD, SA12 6RE, SA12 6SA",211,200,11
W00005122,SA12,"SA12 7AE, SA12 7AF, SA12 7AL, SA12 7DY, SA12 7EA, SA12 7EE",240,223,17
W00004750,SA12,"SA12 8NS, SA12 8NT, SA12 8NU, SA12 8NY, SA12 8TG, SA12 8TH, SA12 8TL, SA12 8YX",297,277,20
W00004718,SA12,"SA12 6DH, SA12 6LL, SA12 6LW, SA12 6LY, SA12 6NA, SA12 6NG, SA12 6NH, SA12 6NN, SA12 6NP, SA12 6NR, SA12 6NW",339,327,12
W00004719,SA12,"SA12 6BJ, SA12 6BX, SA12 6BZ, SA12 6DD, SA12 6DJ, SA12 6DQ, SA12 6DX, SA12 6NE, SA12 6NF, SA12 6NL, SA12 6NS",308,289,19
W00004720,SA12,"SA12 7BW, SA12 7DD, SA12 7PA",238,222,16
W00004721,SA12,"SA12 7DE, SA12 7PD, SA12 7PJ",273,258,15
W00004753,SA12,"SA12 8AJ, SA12 8ES, SA12 8ST, SA12 8SU, SA12 8SY, SA12 8TA, SA12 8TB, SA12 8TD, SA12 8TE, SA12 8TF, SA12 8TN, SA12 8TW",340,308,32
W00004752,SA12,"SA12 8NH, SA12 8NL, SA12 8NN, SA12 8NR, SA12 8NW, SA12 8PT, SA12 8SS, SA12 8UN, SA12 8YB, SA12 8YH",313,296,17
W00004751,SA12,"SA12 8AP, SA12 8AR, SA12 8AT, SA12 8AU, SA12 8AW, SA12 8BA, SA12 8NP, SA12 8SR",226,210,16
W00005121,SA12,"SA12 7AN, SA12 7AP, SA12 7AR, SA12 7BD, SA12 7BE, SA12 7EB, SA12 7EQ, SA12 7NF, SA12 7ST",257,230,27
W00004749,SA12,"SA12 8UL, SA12 8UP, SA12 8UU, SA12 8UW",252,231,21
W00004748,SA12,"SA12 8EN, SA12 8EP, SA12 8EQ, SA12 8ER, SA12 8EW",219,199,20
W00004747,SA12,"SA12 7AX, SA12 7AZ, SA12 7BP, SA12 7BR, SA12 7BS, SA12 7BT, SA12 7GE, SA12 8BE, SA12 8BG, SA12 8BH, SA12 8BL, SA12 8TP, SA12 8TY, SA12 8UA, SA12 8UB, SA12 8UD",256,235,21
W00004746,SA12,"SA12 8UH, SA12 8UR, SA12 8US, SA12 8UT, SA12 8UY",283,243,40
W00004745,SA12,"SA12 8YA, SA12 8YD, SA12 8YE, SA12 8YP, SA12 8YT, SA12 8YU, SA12 8YW",296,276,20
W00004744,SA12,"SA12 8UE, SA12 8UF, SA12 8YF, SA12 8YL, SA12 8YN",415,381,34
W00004743,SA12,"SA12 8LU, SA12 8PL, SA12 8PN, SA12 8PR, SA12 8PW",266,242,24
W00004742,SA12,"SA12 8BU, SA12 8DB, SA12 8DD, SA12 8DH, SA12 8DL",265,237,28
W00004741,SA12,"SA12 8LS, SA12 8LX, SA12 8LY, SA12 8PA, SA12 8PB, SA12 8PD, SA12 8PE, SA12 8PS",427,390,37
W00009940,SA12,"SA12 6BR, SA12 6DL",194,164,30
W00009941,SA12,"SA12 6AN, SA12 6AS, SA12 6AU, SA12 6AY, SA12 6QN, SA12 6QR",368,334,34
W00004740,SA12,"SA12 8BT, SA12 8DF, SA12 8DG, SA12 8NB, SA12 8ND",265,251,14
W00004722,SA12,"SA12 7LP, SA12 7LR, SA12 7RL",195,186,9
W00004723,SA12,"SA12 7EU, SA12 7LW, SA12 7RN",210,194,16
W00004739,SA12,"SA12 8BN, SA12 8BY, SA12 8DA, SA12 8DE, SA12 8TR, SA12 8TS, SA12 8TT",304,272,32
W00010379,SA12,"SA12 6UX, SA12 6UY, SA12 6YH, SA12 6YL, SA12 6YN, SA12 6YP, SA12 6YQ, SA12 6YR, SA12 6YS, SA12 6YW, SA12 6YX, SA12 7BX, SA12 7BY, SA12 7DJ",252,244,8
W00010388,SA12,"SA12 6RL, SA12 6WX, SA12 6WY, SA12 6WZ, SA12 6XA, SA12 6XQ, SA12 6XW, SA12 6XX, SA12 6XY, SA12 6XZ, SA12 6ZT, SA12 7WZ, SA12 7YA, SA12 7YB, SA12 7YL, SA12 7YN, SA12 7YS, SA12 7ZT, SA12 7ZX, SA12 8WH, SA12 8YJ, SA12 8YQ, SA12 8YR, SA12 8YS, SA12 8YY, SA12 8YZ, SA12 8ZH, SA12 9WZ, SA12 9YF, SA12 9YP, SA12 9YR, SA12 9YS, SA12 9YU, SA13 1BS, SA13 1BY, SA13 1DA, SA13 1DD, SA13 1DE, SA13 1DF, SA13 1DH, SA13 1DJ, SA13 1DL, SA13 1DN, SA13 1DT, SA13 1EJ, SA13 1EX, SA13 1EZ, SA13 1HF, SA13 1HG, SA13 1HH, SA13 1HJ, SA13 1HL, SA13 1HN, SA13 1HW, SA13 1HX, SA13 1HZ, SA13 1JA, SA13 1JB, SA13 1JD, SA13 1JF, SA13 1JH, SA13 1JL, SA13 1JN, SA13 1JP, SA13 1JW, SA13 1NG, SA13 1NH, SA13 1NJ, SA13 1NN, SA13 1NP, SA13 1NR, SA13 1NS, SA13 1NT, SA13 1NW, SA13 1PL, SA13 1PQ, SA13 1QX, SA13 1SR, SA13 1UJ, SA13 1UR, SA13 1UT, SA13 1WA, SA13 1WE, SA13 1WF, SA13 1WN, SA13 1WR, SA13 1WT, SA13 1WU, SA13 1WW, SA13 1WX, SA13 1WZ, SA13 1XA, SA13 1XB, SA13 1XH, SA13 1XL, SA13 1XN, SA13 1XS, SA13 1XT, SA13 1XU, SA13 1XX, SA13 1XZ, SA13 1YZ, SA13 1ZB, SA13 1ZE, SA13 1ZH, SA13 1ZL, SA13 1ZN, SA13 1ZU, SA13 1ZX, SA13 2NH, SA13 2WA, SA13 2WD, SA13 2WE, SA13 2WF, SA13 2WH, SA13 2WL, SA13 2WQ, SA13 2WR, SA13 2WS, SA13 2WT, SA13 2WW, SA13 2WX, SA13 2WY, SA13 2WZ, SA13 2XA, SA13 2XS, SA13 2XT, SA13 2XU, SA13 2YJ, SA13 2YS, SA13 2YU, SA13 2YX, SA13 2ZG, SA13 2ZS, SA13 2ZU, SA13 2ZW, SA13 2ZX, SA13 3WA, SA13 3WB, SA13 3ZQ, SA13 9AA, SA13 9AB, SA13 9AE, SA13 9AF, SA13 9AG, SA13 9AH, SA13 9AJ, SA13 9AL, SA13 9AN, SA13 9AP, SA13 9AQ, SA13 9AR, SA13 9AS, SA13 9AT, SA13 9AU, SA13 9AW, SA13 9AX, SA13 9AY, SA13 9AZ, SA13 9BA, SA13 9BB, SA13 9BD, SA13 9BE, SA13 9BF, SA13 9BG, SA13 9BH, SA13 9BJ, SA13 9BL, SA13 9BN, SA13 9BP, SA13 9BQ, SA13 9BR, SA13 9BS, SA13 9BT, SA13 9DA, SA13 9DB, SA13 9DD, SA13 9DE, SA13 9DF, SA13 9DG, SA13 9DH, SA13 9DJ, SA13 9DL, SA13 9DN, SA13 9DP, SA13 9DQ, SA13 9DR, SA13 9DS, SA13 9DT, SA13 9DU, SA13 9DW, SA13 9DX, SA13 9DZ, SA13 9EA, SA13 9EB, SA13 9ED, SA13 9EE, SA13 9EF, SA13 9EG, SA13 9EH, SA13 9EJ, SA13 9EN, SA13 9EP, SA13 9EQ, SA13 9ES, SA13 9ET, SA13 9EU, SA13 9EW, SA13 9EX, SA13 9EY, SA13 9EZ, SA13 9FA, SA13 9FB, SA13 9FD, SA13 9FE",236,218,18
W00004717,SA12,"SA12 6EL, SA12 6EP, SA12 6HR, SA12 6HU, SA12 6HY, SA12 6LA, SA12 6LD, SA12 6LE, SA12 6LF, SA12 6LG, SA12 6LH, SA12 6LN, SA12 6LZ, SA12 6NT, SA12 6NU, SA12 6UA, SA12 6UB, SA12 6UD, SA12 6UE",336,314,22
W00004716,SA12,"SA12 6LP, SA12 6UF, SA12 6UG, SA12 6UH, SA12 6UJ, SA12 6UQ, SA12 6WA",214,201,13
W00004715,SA12,"SA12 6EH, SA12 6EN, SA12 6EW",251,230,21
W00004809,SA12,"SA12 9AN, SA12 9AX, SA12 9AZ, SA12 9BT, SA12 9BX",396,349,47
W00004706,SA12,"SA12 7BJ, SA12 7BZ, SA12 7DA, SA12 7DB, SA12 7DF, SA12 7DG, SA12 7DH, SA12 7DZ, SA12 7EX, SA12 7EY",384,359,25
W00004707,SA12,"SA12 6AQ, SA12 6AX, SA12 6AZ, SA12 6BQ, SA12 6UT, SA12 6UU, SA12 6YT, SA12 6YU, SA12 6YY",326,306,20
W00004791,SA12,"SA12 9HU, SA12 9LE, SA12 9LL, SA12 9LU, SA12 9LW",271,241,30
W00004792,SA12,"SA12 9BJ, SA12 9BL, SA12 9BN, SA12 9BW, SA12 9BZ, SA12 9DJ, SA12 9DQ, SA12 9HH, SA12 9HL, SA12 9LQ, SA12 9LT, SA12 9NB, SA12 9NE, SA12 9NG, SA12 9NQ",554,474,80
W00004793,SA12,"SA12 9AA, SA12 9AF, SA12 9AG, SA12 9AH, SA12 9AJ, SA12 9AL, SA12 9AQ, SA12 9AW, SA12 9BU, SA12 9DB, SA12 9DE, SA12 9HN, SA13 2PY, SA13 2RX",323,285,38
W00004709,SA12,"SA12 6HB, SA12 6HE, SA12 6HF, SA12 6HG, SA12 6HH, SA12 8SF, SA12 8SG",291,283,8
W00004710,SA12,"SA12 6ES, SA12 6ET, SA12 6EU, SA12 6EY, SA12 6HA, SA12 6HD, SA13 1WH",326,300,26
W00004711,SA12,"SA12 6DR, SA12 6DS, SA12 6DU, SA12 6DY, SA12 6DZ, SA12 6EA, SA12 6EB, SA12 6HP, SA12 6HS, SA12 6HT, SA12 8HD, SA12 8HE, SA12 8HF, SA12 8HG, SA12 8HH, SA12 8RN, SA12 8RS, SA12 8RT, SA12 8RU, SA12 8RW, SA12 8SA, SA12 8SB, SA12 8SE, SA12 8SH, SA12 8SL, SA13 1BU, SA13 1HE, SA13 1JT, SA13 1NQ, SA13 1PB, SA13 1PJ, SA13 1PN, SA13 1UP, SA13 1ZP, SA13 9AD, SA13 9SA, SA13 9SB, SA13 9ZZ",321,293,28
W00004712,SA12,"SA12 6UL, SA12 6UN, SA12 6UP, SA12 6UR, SA12 6US, SA12 6UW, SA12 6YA, SA12 6YB, SA12 6YD, SA12 6YE, SA12 6YF, SA12 6YG",309,294,15
W00004713,SA12,"SA12 6ED, SA12 6EE, SA12 6EF, SA12 6EG, SA12 6ER",292,273,19
W00004714,SA12,"SA12 6AJ, SA12 6DW, SA12 6EJ, SA12 6LR, SA12 6LS, SA12 6LT, SA12 6LU, SA12 6NB, SA12 6ND",329,317,12
W00004794,SA12,"SA12 9RR, SA12 9RU, SA12 9SA, SA12 9SB, SA12 9SD, SA12 9SE, SA12 9SF, SA12 9SQ, SA12 9SZ, SA12 9YE, SA12 9YH, SA12 9YJ, SA12 9YL, SA12 9YN, SA12 9YW",275,239,36
W00004738,SA12,"SA12 8NA, SA12 8PF, SA12 8PG, SA12 8PH, SA12 8PJ, SA12 8PP, SA12 8PY",320,290,30
W00004795,SA12,"SA12 9LG, SA12 9LJ, SA12 9PN, SA12 9PP, SA12 9PR, SA12 9PS, SA12 9PW",227,214,13
W00004797,SA12,"SA12 9NT, SA12 9PD, SA12 9PT",270,223,47
W00004798,SA12,"SA12 9EA, SA12 9EH, SA12 9EL, SA12 9EP, SA12 9ER, SA12 9EW, SA12 9EX, SA12 9YB, SA12 9YD, SA12 9YT, SA12 9YX",280,215,65
W00004799,SA12,"SA12 9LB, SA12 9LD, SA12 9PB, SA12 9PE, SA12 9PF, SA12 9PG, SA12 9PH, SA12 9PL",276,236,40
W00004800,SA12,"SA12 9NH, SA12 9NR, SA12 9NS, SA12 9NU, SA12 9NY, SA12 9PA, SA12 9TB",221,197,24
W00004801,SA12,"SA12 9EE, SA12 9EF, SA12 9EG, SA12 9EJ, SA12 9EN",271,235,36
W00004802,SA12,"SA12 9BA, SA12 9BE, SA12 9BG, SA12 9BH, SA12 9DA, SA12 9HS, SA12 9HT, SA12 9HY, SA12 9LA, SA12 9PU",302,267,35
W00004803,SA12,"SA12 9AY, SA12 9DD, SA12 9DF, SA12 9DG, SA12 9DH, SA12 9DL, SA12 9DN, SA12 9DP, SA12 9DW, SA12 9EB, SA12 9EQ, SA12 9NN, SA12 9PY",262,237,25
W00004804,SA12,"SA12 9LF, SA12 9LH, SA12 9LN, SA12 9LP, SA12 9LR, SA12 9LS, SA12 9NA",297,267,30
W00004805,SA12,"SA12 9DR, SA12 9DU, SA12 9ED, SA12 9NW, SA12 9TD",220,205,15
W00004806,SA12,"SA12 9NL, SA12 9NP",227,204,23
W00004807,SA12,"SA12 9AB, SA12 9AD, SA12 9AE, SA12 9AP, SA12 9AR, SA12 9AS, SA12 9AT, SA12 9AU, SA12 9BB, SA12 9BD, SA12 9BY",274,235,39
W00004808,SA12,"SA12 9BP, SA12 9BR, SA12 9BS, SA12 9LY, SA12 9ND, SA12 9NF",289,244,45
W00004796,SA12,"SA12 9ES, SA12 9ET, SA12 9EU, SA12 9EY, SA12 9HA, SA12 9HB, SA12 9HD, SA12 9RY, SA12 9YG, SA13 2RA",261,204,57
W00010409,SA12,"SA12 6DA, SA12 6DT",306,268,38
W00005138,SA13,"SA13 2UE, SA13 2WG, SA13 2XZ, SA13 2YB, SA13 2YD, SA13 2YE, SA13 2YF, SA13 2YG, SA13 2YH, SA13 2YL, SA13 2YN, SA13 2YP, SA13 2YQ, SA13 2YR, SA13 2YT, SA13 2YW, SA13 2YY, SA13 2YZ, SA13 2ZE, SA13 2ZH",417,379,38
W00004898,SA13,"SA13 3ER, SA13 3ES, SA13 3ET, SA13 3EU, SA13 3EY, SA13 3HA, SA13 3HB, SA13 3HD, SA13 3HE, SA13 3HG, SA13 3HH, SA13 3HL",341,310,31
W00005139,SA13,"SA13 1SU, SA13 1SY, SA13 1TB, SA13 2TT, SA13 2UD, SA13 2UF, SA13 2UG, SA13 2UW",237,217,20
W00005140,SA13,"SA13 1LQ, SA13 1TD, SA13 1TG, SA13 1TH",264,253,11
W00005137,SA13,"SA13 2TU, SA13 2TY, SA13 2UB, SA13 2UH, SA13 2UL, SA13 2UN",269,245,24
W00005136,SA13,"SA13 2AR, SA13 2AU, SA13 2AY, SA13 2BA, SA13 2BB",235,219,16
W00005135,SA13,"SA13 1WS, SA13 2BG, SA13 2BR, SA13 2BT, SA13 2LH, SA13 2LN, SA13 2LP, SA13 2LR, SA13 2LS, SA13 2LT, SA13 2LW, SA13 2LX, SA13 2LY",409,365,44
W00005134,SA13,"SA13 2AB, SA13 2BU, SA13 2BY, SA13 2DA, SA13 2DJ",283,262,21
W00005133,SA13,"SA13 1NE, SA13 1NL, SA13 2BP, SA13 2BW, SA13 2HR, SA13 2LU, SA13 2LZ",363,342,21
W00010426,SA13,"SA13 1BT, SA13 1JJ, SA13 1JQ, SA13 1JR, SA13 1JS, SA13 1JY, SA13 1JZ, SA13 1LJ, SA13 1LX, SA13 1LY, SA13 1LZ, SA13 1NF, SA13 1NU, SA13 1PD, SA13 1PE, SA13 1RD, SA13 1WB, SA13 1WD",262,238,24
W00005132,SA13,"SA13 2HL, SA13 2HS, SA13 2HT, SA13 2HU, SA13 2HW, SA13 2HY",301,286,15
W00005142,SA13,"SA13 1DP, SA13 1TL, SA13 1TP, SA13 1TR, SA13 1TS, SA13 1TU, SA13 1TW, SA13 1UA, SA13 1UB",231,220,11
W00005143,SA13,"SA13 1LG, SA13 1LH, SA13 1LL, SA13 1LN, SA13 1LP, SA13 1LR, SA13 1LW, SA13 1PZ, SA13 1TT, SA13 1TY, SA13 1TZ",194,189,5
W00005144,SA13,"SA13 1LS, SA13 1LT, SA13 1LU, SA13 1NA, SA13 1NB, SA13 1ND, SA13 2BL, SA13 2BN, SA13 2HN, SA13 2HP",247,234,13
W00005145,SA13,"SA13 2AZ, SA13 2LA, SA13 2LB, SA13 2LD, SA13 2LE, SA13 2LF, SA13 2LJ, SA13 2WN",490,446,44
W00005146,SA13,"SA13 2AA, SA13 2AQ, SA13 2BD, SA13 2BE, SA13 2BS",253,231,22
W00005147,SA13,"SA13 2AS, SA13 2AT, SA13 2AX, SA13 2LG",236,214,22
W00009945,SA13,"SA13 2TE, SA13 2UP, SA13 2UX",324,278,46
W00005141,SA13,"SA13 1TA, SA13 1TE, SA13 1TF, SA13 1TN, SA13 1UD, SA13 1UE, SA13 1UF",247,223,24
W00004899,SA13,"SA13 3PN, SA13 3PP, SA13 3PR, SA13 3PW, SA13 3RH, SA13 3RL",269,246,23
W00004897,SA13,"SA13 3HS, SA13 3NH, SA13 3NS, SA13 3NT, SA13 3NU, SA13 3NY, SA13 3PA, SA13 3PB, SA13 3PE, SA13 3RB",317,304,13
W00005057,SA13,"SA13 1AS, SA13 1AT, SA13 1AU, SA13 1AY, SA13 1BA, SA13 1BB, SA13 1BD, SA13 1BG, SA13 1DG, SA13 1EQ, SA13 1PF, SA13 1PG",291,270,21
W00004961,SA13,"SA13 2AD, SA13 2AE, SA13 2AF, SA13 2AH, SA13 2AW, SA13 2NN",248,220,28
W00004960,SA13,"SA13 2AG, SA13 2AJ, SA13 2AL, SA13 2AN, SA13 2AP, SA13 2DE, SA13 2DH, SA13 2ND, SA13 2NF, SA13 2SP, SA13 2SR, SA13 2ST",321,287,34
W00004900,SA13,"SA13 3PY, SA13 3RF, SA13 3RW, SA13 3SP, SA13 3SR",182,173,9
W00004901,SA13,"SA13 3PD, SA13 3PF, SA13 3PG, SA13 3PH, SA13 3PL, SA13 3RG, SA13 3RN",249,239,10
W00004902,SA13,"SA13 3RP, SA13 3RR, SA13 3RS, SA13 3SB, SA13 3SE, SA13 3SF, SA13 3SN",230,222,8
W00004896,SA13,"SA13 3HF, SA13 3LD, SA13 3LE, SA13 3LG, SA13 3LH, SA13 3LJ, SA13 3LL, SA13 3LY, SA13 3NA, SA13 3NB, SA13 3ND, SA13 3NL, SA13 3NN, SA13 3NP, SA13 3NR",317,293,24
W00004895,SA13,"SA13 3EE, SA13 3EF, SA13 3EG, SA13 3EN, SA13 3HR",229,219,10
W00004894,SA13,"SA13 3ED, SA13 3EW, SA13 3HT, SA13 3HU, SA13 3HY, SA13 3LA, SA13 3LB, SA13 3LN, SA13 3LP, SA13 3LR, SA13 3LS, SA13 3LT, SA13 3LU, SA13 3LW",265,249,16
W00004962,SA13,"SA13 2DB, SA13 2DD, SA13 2DG, SA13 2DL, SA13 2EA",258,242,16
W00004893,SA13,"SA13 3EH, SA13 3EL, SA13 3EP, SA13 3PQ, SA13 3RA, SA13 3RD, SA13 3RE, SA13 3RT, SA13 3RU, SA13 3RY, SA13 3SA, SA13 3SD, SA13 3SG, SA13 3SH, SA13 3SL, SA13 3SW",159,149,10
W00004916,SA13,"SA13 3AB, SA13 3AD, SA13 3AE, SA13 3AU, SA13 3BB, SA13 3BE",233,219,14
W00004918,SA13,"SA13 3AL, SA13 3AN, SA13 3AT, SA13 3BD, SA13 3BJ, SA13 3DF, SA13 3DG, SA13 3DH, SA13 3DL",223,207,16
W00004951,SA13,"SA13 3SY, SA13 3TA, SA13 3TH, SA13 3TJ, SA13 3TQ, SA13 3TS, SA13 3TW",248,238,10
W00004950,SA13,"SA13 3AJ, SA13 3AQ, SA13 3AX, SA13 3TE, SA13 3TF, SA13 3TG, SA13 3TT, SA13 3TU, SA13 3TY, SA13 3UA, SA13 3UB, SA13 3UD, SA13 3UE, SA13 3UF, SA13 3UG, SA13 3UH, SA13 3UP, SA13 3UR, SA13 3YY",320,299,21
W00004949,SA13,"SA13 3YF, SA13 3YG, SA13 3YN, SA13 3YP, SA13 3YT, SA13 3YU, SA13 3YW",141,128,13
W00004948,SA13,"SA13 3UY, SA13 3YA, SA13 3YB, SA13 3YD, SA13 3YE, SA13 3YH, SA13 3YL, SA13 3YR, SA13 3YS",144,136,8
W00004947,SA13,"SA13 3TB, SA13 3TD, SA13 3TL, SA13 3TN, SA13 3TP, SA13 3TR, SA13 3UL, SA13 3UN, SA13 3UT, SA13 3UU",260,249,11
W00005059,SA13,"SA13 1BH, SA13 1BL, SA13 1BP, SA13 1BR",334,308,26
W00004915,SA13,"SA13 3AF, SA13 3AG, SA13 3DP, SA13 3DR, SA13 3DS, SA13 3DT, SA13 3DU",198,196,2
W00004963,SA13,"SA13 1DB, SA13 1DW, SA13 1HP, SA13 1HR, SA13 1HS, SA13 1HT, SA13 1JG, SA13 1JU, SA13 1NZ, SA13 1PW, SA13 1QB, SA13 1QD, SA13 1QE, SA13 1QG, SA13 1QN, SA13 1QP, SA13 1QR, SA13 1QS, SA13 1QT, SA13 1QU, SA13 1RA, SA13 1RB, SA13 1RE, SA13 1RF, SA13 1RG, SA13 1RH, SA13 1RL, SA13 1RN, SA13 1RP, SA13 1RR, SA13 1RS, SA13 1RT, SA13 1RU, SA13 1RW, SA13 1RY, SA13 1RZ, SA13 1SA, SA13 1SB, SA13 1SD, SA13 1SE, SA13 1UN, SA13 1UW, SA13 2DP, SA13 2DR, SA13 2DS, SA13 2DT, SA13 2DU, SA13 2DW, SA13 2DY, SA13 2NG",266,254,12
W00004956,SA13,"SA13 2BZ, SA13 2DF, SA13 2DN, SA13 2DX, SA13 2EZ, SA13 2NE, SA13 2PT",230,215,15
W00005047,SA13,"SA13 1AD, SA13 1AE, SA13 1AF, SA13 1AG, SA13 1AH, SA13 1EE, SA13 1EF",271,251,20
W00005052,SA13,"SA13 1LD, SA13 1LE, SA13 1LF, SA13 1PP, SA13 1PR, SA13 1PS, SA13 1PT, SA13 1PU, SA13 1PY",282,267,15
W00005050,SA13,"SA13 1EH, SA13 1EN, SA13 1ES, SA13 1ET, SA13 1JX, SA13 1NX, SA13 1QA, SA13 1UX, SA13 1WJ, SA13 1WL, SA13 1XD, SA13 1XE, SA13 1XF, SA13 1XG, SA13 1XJ, SA13 1XP, SA13 1XY, SA13 1YJ, SA13 1YX, SA13 1ZD",332,301,31
W00005055,SA13,"SA13 1DQ, SA13 1DX, SA13 1DZ, SA13 1YR, SA13 2HD",313,293,20
W00005049,SA13,"SA13 1DR, SA13 1DU, SA13 1DY, SA13 1EP, SA13 1ER, SA13 1EW, SA13 1HQ, SA13 1HU, SA13 1HY, SA13 1LA, SA13 1SF, SA13 1SG, SA13 1SL",355,328,27
W00004790,SA13,"SA13 2RU, SA13 2SA, SA13 2SB, SA13 2SD, SA13 2SE, SA13 2SF",280,252,28
W00004788,SA13,"SA13 2BJ, SA13 2RB, SA13 2RD, SA13 2RH, SA13 2RL, SA13 2RN, SA13 2RP, SA13 2RR, SA13 2RS, SA13 2RT, SA13 2RW, SA13 2SH, SA13 2SL, SA13 2SN, SA13 2SS",273,253,20
W00005036,SA13,"SA13 1ZF, SA13 1ZG, SA13 1ZJ, SA13 1ZQ, SA8 4NF, SA8 4NG, SA8 4NP, SA8 4NX, SA8 4NY, SA8 4PG",348,265,83
W00004789,SA13,"SA13 2RE, SA13 2RF, SA13 2RG, SA13 2RJ, SA13 2RQ, SA13 2RY, SA13 2RZ, SA13 2SG, SA13 2SJ",332,292,40
W00005044,SA13,"SA13 2BQ, SA13 2EG, SA13 2EH, SA13 2EN, SA13 2UR, SA13 2US, SA13 2UT, SA13 2UU, SA13 2YA",270,238,32
W00005045,SA13,"SA13 1AL, SA13 1AN, SA13 1AP, SA13 1AR, SA13 1AW, SA13 1BE, SA13 1BN, SA13 1BW",309,273,36
W00005046,SA13,"SA13 1YP, SA13 1YS, SA13 1YW, SA13 2EL, SA13 2EP, SA13 2ER, SA13 2EW, SA13 2HE",278,259,19
W00005056,SA13,"SA13 1AJ, SA13 1AZ, SA13 1BZ, SA13 1DS, SA13 1YH, SA13 1YN, SA13 1YT, SA13 1YU, SA13 1YY",257,236,21
W00005048,SA13,"SA13 1EG, SA13 1EU, SA13 1EY, SA13 1SP, SA13 1SS, SA13 1ST, SA13 1SW, SA13 2UY, SA13 2WB, SA13 2WP, SA13 2WU",278,256,22
W00005042,SA13,"SA13 1AA, SA13 1AB, SA13 1EA, SA13 1EB, SA13 1ED, SA13 1EL, SA13 1FA",306,284,22
W00005051,SA13,"SA13 1HA, SA13 1HB, SA13 1HD, SA13 1LB, SA13 1SH, SA13 1SN",243,218,25
W00003419,SA14,"SA14 9AD, SA14 9AE, SA14 9AJ, SA14 9AW, SA14 9AX, SA14 9ES, SA14 9EW",296,206,90
W00003573,SA14,"SA14 6DJ, SA14 6EG, SA14 6RH, SA14 6RL, SA14 6RR, SA14 6RS, SA14 6RT, SA14 6RU, SA14 6SG, SA14 7LA",588,243,345
W00003384,SA14,"SA14 9RE, SA14 9RL, SA14 9SD, SA14 9US, SA14 9UT, SA14 9UU, SA14 9UY, SA15 1GT, SA15 1HU, SA15 1JE, SA15 1JF, SA15 1JT, SA15 1JU, SA15 1JZ, SA15 1LL",384,278,106
W00003414,SA14,"SA14 9LH, SA14 9LJ, SA14 9LL, SA14 9LN, SA14 9LW, SA14 9SG, SA14 9SP, SA14 9SQ, SA14 9SS, SA14 9SW",274,183,91
W00003415,SA14,"SA14 9LP, SA14 9LR, SA14 9LS, SA14 9LT, SA14 9LU, SA14 9PR, SA14 9PS",332,244,88
W00003572,SA14,"SA14 7BG, SA14 7BJ, SA14 7BL, SA14 7DA, SA14 7DD",187,89,98
W00003416,SA14,"SA14 9HT, SA14 9LD, SA14 9LE, SA14 9LF, SA14 9LG, SA14 9LZ, SA14 9NH, SA14 9NU, SA14 9NY",251,182,69
W00003418,SA14,"SA14 9AF, SA14 9AG, SA14 9AH, SA14 9AL, SA14 9AQ, SA14 9AR, SA14 9AS",280,223,57
W00003423,SA14,"SA14 9DZ, SA14 9EQ, SA14 9EX, SA14 9EZ, SA14 9GA, SA14 9HP, SA14 9HR, SA14 9HS, SA14 9HU, SA14 9NF, SA14 9NG, SA14 9NL, SA14 9YD, SA14 9YE, SA14 9YF, SA14 9YG, SA14 9YL",561,407,154
W00003571,SA14,"SA14 7AA, SA14 7AU, SA14 7AY, SA14 7BA, SA14 7BB, SA14 7BD, SA14 7BE, SA14 7BQ",322,93,229
W00003567,SA14,"SA14 6TE, SA14 6TF, SA14 6TG, SA14 6TN, SA14 7DF, SA14 7DG, SA14 7DH, SA14 7DJ, SA14 7DQ, SA14 7EA, SA14 7EB, SA14 7EG",498,197,301
W00003566,SA14,"SA14 7BH, SA14 7BN, SA14 7BS, SA14 7BW, SA14 7BY, SA15 5AT",242,93,149
W00003524,SA14,"SA14 8BB, SA14 8BH, SA14 8HY, SA14 8LA, SA15 4LL, SA15 4LN, SA15 4LP, SA15 4LR, SA15 4LW, SA15 4LY, SA15 4NY, SA15 4PA, SA15 4PB, SA15 4PE",288,204,84
W00003523,SA14,"SA14 8AP, SA14 8AS, SA14 8AW, SA15 3PZ, SA15 3QA, SA15 3SS, SA15 3SU",249,184,65
W00003522,SA14,"SA14 8AN, SA14 8AR, SA14 8AT, SA14 8AU",268,219,49
W00003520,SA14,"SA14 8AL, SA14 8BD, SA14 8BE, SA14 8BG, SA14 8EU, SA14 8GG, SA14 8HU, SA14 8LD, SA14 8QD, SA14 8QG, SA14 8QN",304,212,92
W00003519,SA14,"SA14 8LB, SA15 3QB, SA15 3QE, SA15 3QF, SA15 3TB, SA15 4LT",154,120,34
W00003513,SA14,"SA14 6WB, SA14 6WY, SA14 6WZ, SA14 6YA, SA14 6YB, SA14 6YD, SA14 6YE, SA14 6YG, SA14 6YH, SA14 6YJ, SA14 6YL, SA14 6YN, SA14 6YP, SA14 6YQ, SA14 6ZG, SA14 6ZP, SA14 7WS, SA14 7WT, SA14 7WW, SA14 7WX, SA14 7WY, SA14 7WZ, SA14 7YA, SA14 7YE, SA14 7YF, SA14 7ZW, SA14 8WP, SA14 8WQ, SA14 8WS, SA14 8WT, SA14 8WU, SA14 8WW, SA14 8WX, SA14 8WY, SA14 8WZ, SA14 8XA, SA14 8XB, SA14 8XD, SA14 8XE, SA14 8XF, SA14 8XL, SA14 8XN, SA14 8XR, SA14 8XU, SA14 8XX, SA14 9WW, SA14 9WX, SA14 9WY, SA14 9WZ, SA14 9YA, SA14 9YH, SA14 9YN, SA14 9YP, SA14 9YQ, SA14 9YR, SA14 9YS, SA14 9YU, SA14 9YW, SA15 1DR, SA15 1WX, SA15 1WY, SA15 1WZ, SA15 1XA, SA15 1XB, SA15 1XD, SA15 1XE, SA15 1XF, SA15 1XH, SA15 1XJ, SA15 1YH, SA15 1YQ, SA15 1ZD, SA15 1ZE, SA15 1ZW, SA15 2SF, SA15 2SG, SA15 2SR, SA15 2WA, SA15 2WD, SA15 2WE, SA15 2WF, SA15 2WT, SA15 2WU, SA15 2WW, SA15 2WX, SA15 2WY, SA15 2WZ, SA15 2XZ, SA15 2YA, SA15 2YD, SA15 2YG, SA15 2YP, SA15 2YX, SA15 2ZJ, SA15 2ZW, SA15 3AE, SA15 3AG, SA15 3AH, SA15 3BG, SA15 3BN, SA15 3BU, SA15 3BW, SA15 3BY, SA15 3DA, SA15 3DB, SA15 3DE, SA15 3WA, SA15 3WX, SA15 3WY, SA15 3WZ, SA15 3XE, SA15 3XF, SA15 3XG, SA15 3XH, SA15 3XN, SA15 3XP, SA15 3XR, SA15 3XU, SA15 3XW, SA15 3XZ, SA15 3YH, SA15 3YQ, SA15 3YR, SA15 4WB, SA15 4WX, SA15 4WY, SA15 4WZ, SA15 4YD, SA15 4YF, SA15 4YG, SA15 4ZW, SA15 5WZ, SA15 5YB, SA15 5YP, SA15 5YX, SA15 5ZA, SA15 5ZX, SA15 9AD, SA15 9AQ, SA15 9AR, SA15 9AS, SA15 9AU, SA15 9AY, SA15 9BA, SA15 9BB, SA15 9BD, SA15 9BE, SA15 9BF, SA15 9BG, SA15 9BH, SA15 9BJ, SA15 9BL, SA15 9BN, SA15 9BP, SA15 9BQ, SA15 9BR, SA15 9BS, SA15 9BT, SA15 9BU, SA15 9BW, SA15 9BX, SA15 9BY, SA15 9BZ, SA15 9DA, SA15 9DB, SA15 9DD, SA15 9DE, SA15 9DF, SA15 9DG, SA15 9DH, SA15 9DJ, SA15 9DL, SA15 9DN, SA15 9DP, SA15 9DQ, SA15 9DR, SA15 9DS, SA15 9DT, SA15 9DU, SA15 9DW, SA15 9DX, SA15 9DY, SA15 9DZ, SA15 9EA, SA15 9EB, SA15 9ED, SA15 9EE, SA15 9EF, SA15 9EG, SA15 9EH, SA15 9EJ, SA15 9EL, SA15 9EN, SA15 9EQ, SA15 9ER, SA15 9ES, SA15 9ET, SA16 0WX, SA16 0WY, SA16 0WZ, SA16 0XA, SA16 0XG, SA16 0XW, SA16 0XY, SA16 0XZ, SA16 0YJ, SA16 0YX, SA16 0ZH, SA16 0ZQ",253,176,77
W00003507,SA14,"SA14 8LN, SA14 8SE, SA14 8SF, SA14 8SG, SA14 8SH",274,208,66
W00003506,SA14,"SA14 8AA, SA14 8AB, SA14 8AD, SA14 8AY, SA14 8PL",201,164,37
W00003505,SA14,"SA14 8PG, SA14 8PH, SA14 8PN",273,237,36
W00003504,SA14,"SA14 8LP, SA14 8LW, SA14 8NT, SA14 8PA, SA14 8PE, SA14 8PR, SA14 8SQ",292,216,76
W00003503,SA14,"SA14 8AE, SA14 8AF, SA14 8AG, SA14 8PF, SA14 8RP",367,240,127
W00003502,SA14,"SA14 8BX, SA14 8LQ, SA14 8LU, SA14 8LX, SA14 8NA, SA14 8ND, SA14 8NR, SA14 8NS, SA14 8PB, SA14 8PD, SA14 8QR, SA14 8QT, SA14 8QW, SA14 8QX, SA14 8QZ, SA14 8XG, SA14 8XH, SA14 8XS",279,200,79
W00003501,SA14,"SA14 8LG, SA14 8LH, SA14 8LL, SA14 8PP, SA14 8PW, SA14 8QF, SA14 8RZ",338,287,51
W00003500,SA14,"SA14 8SP, SA14 8SR, SA14 8SS, SA14 8ST, SA14 8SW",277,227,50
W00003499,SA14,"SA14 8SA, SA14 8SB, SA14 8SD, SA15 1HQ, SA15 1QD",380,250,130
W00003498,SA14,"SA14 8DX, SA14 8LR, SA14 8LS, SA14 8LY, SA14 8NP, SA14 8NW, SA14 8QE",218,164,54
W00003497,SA14,"SA14 8GJ, SA14 8NU, SA14 8NY, SA14 8QU, SA14 8QY, SA14 8UT, SA14 8WE, SA14 8WG, SA14 8WR",295,234,61
W00003422,SA14,"SA14 9NT, SA14 9PA, SA14 9PB, SA14 9PD, SA14 9PF, SA14 9TS",268,196,72
W00003569,SA14,"SA14 7HP, SA14 7LB, SA14 7LD, SA14 7LE, SA14 7LL, SA14 7LN, SA14 7LP, SA14 7LW, SA14 7NB, SA14 7NE, SA14 7NF, SA14 7NG, SA14 7NN",437,197,240
W00003898,SA14,"SA14 8DA, SA14 8DN, SA14 8DS, SA14 8ED, SA14 8HN, SA14 8LE, SA14 8LF, SA14 8PS",367,265,102
W00003379,SA14,"SA14 9RA, SA14 9YB, SA15 1JP, SA15 1JR, SA15 1JW, SA15 1RB, SA15 1RD",294,252,42
W00003900,SA14,"SA14 8EG, SA14 8EL, SA14 8EN, SA14 8EP, SA14 8ES, SA14 8ET, SA14 8EW",224,168,56
W00003808,SA14,"SA14 9BE, SA14 9BP, SA14 9BR, SA14 9BS, SA14 9BY, SA14 9DA, SA14 9DL",289,249,40
W00003809,SA14,"SA14 9DB, SA14 9DH, SA14 9DT, SA14 9HL",250,198,52
W00003831,SA14,"SA14 7DX, SA14 7DY, SA14 7PR, SA14 7PS, SA14 7PT, SA14 7PU, SA14 7RF, SA14 7RJ",338,138,200
W00003832,SA14,"SA14 7RL, SA14 7RN, SA14 7RQ, SA14 7RS, SA14 7RT, SA14 7RY, SA14 7RZ",350,169,181
W00003833,SA14,"SA14 7NP, SA14 7NR, SA14 7NS, SA14 7NU, SA14 7NY, SA14 7PA, SA14 7PB, SA14 7PF, SA14 7RP, SA14 7RR, SA14 7RX",244,102,142
W00003834,SA14,"SA14 7NT, SA14 7PG, SA14 7PH, SA14 7PJ, SA14 7PL, SA14 7PN, SA14 7PP, SA14 7PW, SA18 3LU",346,147,199
W00003835,SA14,"SA14 6SA, SA14 6SQ, SA14 6SW, SA14 7LF, SA14 7LG, SA14 7LH, SA14 7RU",348,161,187
W00003836,SA14,"SA14 7ND, SA14 7PX, SA14 7PY, SA14 7PZ, SA14 7RA, SA14 7RB, SA14 7RD, SA14 7RE, SA14 7RG, SA14 7RH",478,226,252
W00003837,SA14,"SA14 6RY, SA14 6SB, SA14 6SD, SA14 6SE, SA14 6SF, SA14 6SJ, SA14 6SL, SA14 6SN, SA14 6SS, SA14 7NW, SA14 7PD, SA14 7PE",468,179,289
W00003848,SA14,"SA14 7BP, SA14 7BR, SA14 7BT, SA14 7BU, SA15 5AD, SA15 5AF, SA15 5AG, SA15 5AH, SA15 5AL, SA15 5AN, SA15 5AP, SA15 5AR, SA15 5AS, SA15 5AW, SA15 5BP, SA15 5BU, SA15 5BX, SA15 5HA, SA15 5LG",500,185,315
W00003892,SA14,"SA14 6AQ, SA14 6DZ, SA14 6PH, SA14 6PP, SA14 6PR, SA14 6PS, SA14 6PT, SA14 6PU, SA14 6PX, SA14 6PY, SA18 3RN, SA18 3RR, SA18 3RS, SA18 3RW",416,223,193
W00003895,SA14,"SA14 8BR, SA14 8BS, SA14 8BT, SA14 8BW, SA14 8BZ, SA14 8DD, SA14 8DE, SA14 8EE",352,236,116
W00003896,SA14,"SA14 8BL, SA14 8BN, SA14 8BP, SA14 8DG, SA14 8DY, SA14 8EA, SA14 8EB, SA14 8HT",308,210,98
W00003897,SA14,"SA14 8EJ, SA14 8EX, SA14 8EZ, SA14 8HJ, SA14 8HQ, SA14 8HZ, SA14 8JA, SA14 8JB, SA14 8JD, SA14 8JF, SA14 8LZ, SA14 8NJ, SA14 8NQ, SA14 8NX, SA14 8NZ, SA14 8QA, SA14 8QB",162,90,72
W00003901,SA14,"SA14 8HP, SA14 8HR, SA14 8HS, SA14 8HW",213,161,52
W00003902,SA14,"SA14 8DH, SA14 8DL, SA14 8DP, SA14 8DT, SA14 8DW, SA14 8HG, SA14 8HL",224,153,71
W00003903,SA14,"SA14 8EH, SA14 8ER, SA14 8EY, SA14 8HA, SA14 8HB, SA14 8HD, SA14 8HE, SA14 8HF, SA14 8HH",265,192,73
W00003807,SA14,"SA14 9BN, SA14 9BW, SA14 9DS, SA14 9DU, SA14 9EA, SA14 9HF, SA14 9HW",270,216,54
W00003378,SA14,"SA14 9RB, SA14 9RD, SA15 1JG, SA15 1JJ, SA15 1JL, SA15 1JN, SA15 1JX",279,234,45
W00003899,SA14,"SA14 8BU, SA14 8BY, SA14 8DB, SA14 8DF, SA14 8DR, SA14 8DU, SA14 8EQ",314,231,83
W00003793,SA14,"SA14 8RR, SA14 8RS, SA14 8RT, SA14 8RU, SA15 1ED, SA15 3BZ, SA15 3DJ, SA15 3DQ, SA15 3DX, SA15 3EJ, SA15 3EX, SA15 3PA, SA15 3PB, SA15 3PG, SA15 3QD",408,309,99
W00003795,SA14,"SA14 9DD, SA14 9DF, SA14 9DG, SA14 9DQ, SA14 9DX, SA14 9SB",228,177,51
W00010695,SA14,"SA14 6RN, SA14 6RP, SA14 6RQ, SA14 6RW, SA14 6SH",188,75,113
W00003796,SA14,"SA14 9BD, SA14 9BT, SA14 9BU, SA14 9DE, SA14 9DR, SA14 9UX, SA14 9UZ, SA14 9WA",404,332,72
W00003797,SA14,"SA14 8PU, SA14 8PY, SA14 8PZ, SA14 8RA, SA14 8RB, SA14 9AB",330,250,80
W00003568,SA14,"SA14 7DE, SA14 7DL, SA14 7DN, SA14 7DP, SA14 7ED, SA14 7GA, SA14 7GB, SA14 7HN",421,158,263
W00003798,SA14,"SA14 9BQ, SA14 9DJ, SA14 9DN, SA14 9DP, SA14 9DW, SA14 9HY, SA14 9LA, SA14 9LB, SA14 9SE, SA14 9SF, SA14 9SH, SA14 9SL",292,221,71
W00003800,SA14,"SA14 8NN, SA14 8RJ, SA14 8RQ, SA14 9BA, SA14 9BB",320,247,73
W00003801,SA14,"SA14 8LT, SA14 8NF, SA14 8RW, SA14 8TA, SA14 8TB, SA14 8TD, SA14 9BX",274,198,76
W00003802,SA14,"SA14 8NH, SA14 8PT, SA14 8RD, SA14 8RE, SA14 8RF, SA14 8RG, SA14 8RL, SA14 8RN, SA14 9DY, SA14 9ED, SA14 9EE",279,223,56
W00003803,SA14,"SA14 9AA, SA14 9EF, SA14 9EG, SA14 9EH, SA14 9EN",272,204,68
W00003804,SA14,"SA14 9AT, SA14 9BG, SA14 9BH, SA14 9BL, SA14 9EB",248,189,59
W00003805,SA14,"SA14 9EP, SA14 9ER, SA14 9EU, SA14 9EY, SA14 9HA, SA14 9HE",220,173,47
W00003806,SA14,"SA14 9EL, SA14 9HB, SA14 9HD, SA14 9HG, SA14 9HH, SA14 9HQ",292,226,66
W00003799,SA14,"SA14 8NB, SA14 8NE, SA14 8NG, SA14 8NL, SA14 8RH",259,200,59
W00010674,SA14,"SA14 6DQ, SA14 6TB, SA14 6TD, SA14 7DR, SA14 7DS, SA14 7DT, SA14 7DU",288,108,180
W00003717,SA14,"SA14 8GA, SA14 8GD, SA14 8GE, SA14 8GF, SA14 9RG, SA14 9RH",310,206,104
W00003682,SA14,"SA14 7SF, SA14 7SH, SA14 7SL, SA14 7SN, SA14 7SR, SA14 7SS, SA14 7ST, SA14 7SU, SA14 7SW, SA14 7SY, SA14 7TH, SA14 7UB, SA14 7UD, SA14 7UE, SA14 7UF, SA14 7UG, SA14 7UH, SA18 3JX, SA32 8JJ, SA32 8JL, SA32 8JN, SA32 8JP, SA32 8JR, SA32 8LS, SA32 8NB, SA32 8ND",295,160,135
W00003714,SA14,"SA14 8RX, SA14 8TL, SA14 8TQ, SA14 8UF, SA14 8UU, SA14 8UY, SA14 9RS, SA14 9RT, SA14 9RU",201,141,60
W00003713,SA14,"SA14 8UD, SA14 8UG, SA14 8UH, SA14 8UX, SA14 8UZ",274,176,98
W00003575,SA14,"SA14 7AQ, SA14 7DW, SA14 7EL, SA14 7EP, SA14 7ET, SA14 7EW, SA14 7EX, SA14 7EY, SA14 7HB, SA14 7HD, SA14 7HE, SA14 7HF, SA14 7HH, SA14 7HL, SA14 7NH, SA14 7NL, SA14 7SP",353,155,198
W00003712,SA14,"SA14 8XY, SA14 8XZ, SA14 8YB",355,215,140
W00003711,SA14,"SA14 9RW, SA14 9TU, SA14 9UB, SA14 9UD, SA14 9UE, SA14 9UF, SA14 9UG, SA14 9UJ",513,380,133
W00003782,SA14,"SA14 8RY, SA14 8SL, SA14 8SN, SA14 8SU, SA14 8SY, SA15 1PX, SA15 1PZ, SA15 3HQ",315,248,67
W00003745,SA14,"SA14 6AA, SA14 6AB, SA14 6AD, SA14 6AE, SA14 6AL, SA14 6AN, SA14 6AX, SA14 6AY, SA14 6AZ, SA14 6BB, SA14 6BE, SA14 6BG, SA14 8JH, SA14 8JJ, SA14 8JL, SA14 8JN, SA14 8JT",370,188,182
W00003746,SA14,"SA14 6AF, SA14 6AG, SA14 6AH, SA14 6AP, SA14 6AW, SA14 6BU, SA14 6BY, SA14 6DA, SA14 6DB, SA14 6DD, SA14 6DE, SA14 6DF, SA14 6DG, SA14 6DH, SA14 6EB, SA14 6EE, SA14 6PA, SA14 6PB, SA14 6PD, SA14 6PE, SA14 6PF, SA14 6PG, SA14 6PL, SA14 6PN, SA14 6PW, SA14 6RA, SA14 6SX, SA14 6YF, SA14 8JP, SA14 8JR, SA14 8JS, SA14 8JW, SA15 5LP, SA15 5LR, SA15 5LS, SA15 5NG, SA4 0FP, SA4 0FR, SA4 0FS, SA4 0FU, SA4 1FP, SA4 1FR, SA4 1FS",326,192,134
W00003747,SA14,"SA14 6AR, SA14 6AS, SA14 6AT, SA14 6AU, SA14 6BA, SA14 6BD, SA14 6BH, SA14 6BJ, SA14 6BL, SA14 6BQ, SA14 8HX, SA14 8JE, SA14 8JG, SA14 8JQ, SA14 8JU, SA14 8JY, SA14 8JZ, SA15 5NL",439,234,205
W00003748,SA14,"SA14 6DU, SA14 6DY, SA14 6EA, SA14 6ED, SA14 6LY, SA14 6TL",287,92,195
W00003749,SA14,"SA14 6EH, SA14 6EJ, SA14 6LU, SA14 6NB, SA14 6RD, SA14 6RG, SA14 6ST, SA14 6SU, SA14 6SY, SA14 6SZ, SA14 6TA",456,189,267
W00003715,SA14,"SA14 8QS, SA14 8TE, SA14 8UP, SA14 8UQ, SA14 8WA, SA14 8WB, SA14 8WD, SA14 8WF, SA14 9RF, SA14 9RR",386,234,152
W00003750,SA14,"SA14 6NA, SA14 6ND, SA14 6NF, SA14 6NG, SA14 6NH, SA14 6NJ, SA14 6NL, SA14 6NN, SA14 6NR, SA14 6SP, SA14 6SR",306,144,162
W00003752,SA14,"SA14 6AJ, SA14 6HF, SA14 6HG, SA14 6HH, SA14 6HL, SA14 6HN, SA14 6HP, SA14 6HR, SA14 6HS, SA14 6HT, SA14 6HU",357,159,198
W00003753,SA14,"SA14 6HJ, SA14 6HY, SA14 6LA, SA14 6LB",277,112,165
W00003583,SA14,"SA14 8JX, SA14 8YF, SA14 8YH, SA14 8YL, SA14 8YN, SA14 8YQ, SA4 0NL, SA4 0XY, SA4 0XZ, SA4 0YA, SA4 0YD, SA4 0YJ, SA4 0YL, SA4 1NL, SA4 1XD, SA4 1XY, SA4 1XZ, SA4 1YA, SA4 1YD, SA4 1YH, SA4 1YJ, SA4 1YL, SA4 1YN",204,132,72
W00003577,SA14,"SA14 7AX, SA14 7HR, SA14 7HS, SA14 7HT, SA14 7HU, SA14 7HY, SA14 7YB, SA14 7YD",411,200,211
W00003754,SA14,"SA14 6LD, SA14 6LE, SA14 6LF",273,142,131
W00003755,SA14,"SA14 6DR, SA14 6DS, SA14 6DT, SA14 6DX",301,109,192
W00009994,SA14,"SA14 9AN, SA14 9AP, SA14 9AU, SA14 9ET, SA14 9GD",327,251,76
W00009995,SA14,"SA14 9EJ, SA14 9NN, SA14 9NP, SA14 9NR, SA14 9NS, SA14 9NW",313,225,88
W00003756,SA14,"SA14 6DW, SA14 6EL, SA14 6EN, SA14 6ER, SA14 6EW, SA14 6HD, SA14 6HE",231,107,124
W00003576,SA14,"SA14 6TH, SA14 7AP, SA14 7EE, SA14 7EF, SA14 7EH, SA14 7EN, SA14 7EQ, SA14 7ER, SA14 7ES, SA14 7EU, SA32 8BT",322,157,165
W00003759,SA14,"SA14 6BP, SA14 6BR, SA14 6BW, SA14 6DP, SA14 6EQ",279,92,187
W00003751,SA14,"SA14 6LR, SA14 6LS, SA14 6LT, SA14 6NE, SA14 6NS, SA14 6NT, SA14 6NU, SA14 6NY, SA14 6RB, SA14 6RE, SA14 6RF, SA14 6RJ, SA14 6RX, SA14 6RZ",314,141,173
W00003758,SA14,"SA14 6BN, SA14 6BS, SA14 6BT, SA14 6BX, SA14 6BZ, SA14 6DL, SA14 6DN",390,131,259
W00003716,SA14,"SA14 8AH, SA14 8GB, SA14 8SJ, SA14 8SX, SA14 8SZ, SA14 8TF, SA14 8TG, SA14 8TJ, SA14 8TZ, SA14 9RY",415,245,170
W00003720,SA14,"SA14 9UH, SA14 9UL, SA14 9UN, SA14 9UP, SA14 9UW",232,141,91
W00010663,SA14,"SA14 9NB, SA14 9PJ, SA14 9PY, SA14 9PZ",231,191,40
W00010358,SA14,"SA14 7AZ, SA14 7BX, SA14 7BZ",244,130,114
W00003725,SA14,"SA14 8TN, SA14 8TP, SA14 8TW, SA14 8UE",252,157,95
W00003724,SA14,"SA14 8UL, SA14 8UN, SA14 8US, SA14 8UW, SA14 8XT, SA14 8YE",285,175,110
W00010362,SA14,"SA14 9PL, SA14 9PN, SA14 9PT, SA14 9UQ",244,170,74
W00003574,SA14,"SA14 7AB, SA14 7AD, SA14 7AE, SA14 7AF, SA14 7AG, SA14 7AH, SA14 7AJ, SA14 7AL, SA14 7AN, SA14 7AR, SA14 7AS, SA14 7AT, SA14 7AW, SA14 7DB",409,147,262
W00003723,SA14,"SA14 8DJ, SA14 8EF, SA14 8TR, SA14 8UA, SA14 8YP, SA14 8YR, SA14 8YS, SA14 8YT, SA14 8YU, SA14 8YW, SA14 8YX",372,213,159
W00003722,SA14,"SA14 8DZ, SA14 8QP, SA14 8TS, SA14 8TT, SA14 8TU, SA14 8TY, SA14 8UB, SA14 8XP, SA14 8XW, SA14 8YA, SA14 8YJ, SA14 8YZ",387,237,150
W00003721,SA14,"SA14 8AJ, SA14 8AQ, SA14 8AX, SA14 8AZ, SA14 8BA, SA14 8BJ, SA14 8BQ, SA14 8PJ, SA14 8PQ, SA14 8PX, SA14 8YD, SA14 8YG, SA14 8YY, SA14 8ZE, SA4 0YB, SA4 0YQ, SA4 1YB, SA4 1YQ",389,215,174
W00010666,SA14,"SA14 9PE, SA14 9PG, SA14 9PH, SA14 9PU, SA14 9QA",305,245,60
W00003718,SA14,"SA14 8TH, SA14 8TX, SA14 8UJ, SA14 8UR",301,179,122
W00010102,SA14,"SA14 9AZ, SA14 9LY, SA14 9NA, SA14 9PP, SA14 9PQ, SA14 9PW, SA14 9PX, SA14 9SN, SA14 9TG, SA14 9TH, SA14 9TL, SA14 9TN, SA14 9TW",373,284,89
W00003757,SA14,"SA14 6EP, SA14 6ES, SA14 6EU, SA14 6EY, SA14 6HA",281,96,185
W00010100,SA14,"SA14 9SA, SA14 9SJ, SA14 9SR, SA14 9SX, SA14 9SY, SA14 9SZ, SA14 9TA, SA14 9TD, SA14 9TE, SA14 9TF, SA14 9TP, SA14 9TQ",219,162,57
W00003680,SA14,"SA14 7SA, SA14 7SE, SA14 7SG, SA14 7TG, SA14 7TL, SA14 7TN, SA14 7TP, SA14 7TR, SA14 7TS, SA14 7TU, SA14 7TW, SA14 7UA, SA14 7UL, SA14 7WH, SA18 3JP, SA18 3JS, SA18 3JT, SA18 3JW",276,145,131
W00003679,SA14,"SA14 7LR, SA14 7LS, SA14 7LT, SA14 7LU, SA14 7LX, SA14 7LY, SA14 7NA, SA14 7RW, SA14 7SD, SA14 7TY",329,161,168
W00003658,SA14,"SA14 7TT, SA18 3AX, SA18 3AZ, SA18 3HJ, SA18 3HY, SA18 3JA, SA18 3JB, SA18 3JD, SA18 3JE, SA18 3JF, SA18 3JG, SA18 3JH, SA18 3JQ",404,211,193
W00010099,SA14,"SA14 9AY, SA14 9BJ, SA14 9ST, SA14 9SU, SA14 9TB, SA14 9TJ, SA14 9TR",321,248,73
W00003632,SA14,"SA14 7HA, SA32 8BD, SA32 8BN, SA32 8BP, SA32 8BS, SA32 8HP, SA32 8PG, SA32 8PJ, SA32 8PL, SA32 8PN, SA32 8PP, SA32 8PR, SA32 8PS, SA32 8PT, SA32 8PW",391,157,234
W00003631,SA14,"SA14 7HG, SA14 7TA, SA14 7TB, SA32 8DF, SA32 8HG, SA32 8HJ, SA32 8HR, SA32 8HS, SA32 8HT, SA32 8HU, SA32 8HW, SA32 8HX, SA32 8HY, SA32 8HZ, SA32 8JD, SA32 8JE, SA32 8JF, SA32 8JG, SA32 8JH, SA32 8JQ, SA32 8JU, SA32 8JX, SA32 8LA, SA32 8LB",365,152,213
W00003719,SA14,"SA14 8DQ, SA14 8QH, SA14 8QJ, SA14 8QL, SA14 8QQ, SA14 9RP, SA14 9RQ, SA14 9TT, SA14 9TY, SA14 9UA, SA14 9UR",356,269,87
W00003744,SA14,"SA14 6ET, SA14 6HB, SA14 6LG, SA14 6LH, SA14 6LL, SA15 5LL, SA15 5LN, SA15 5LW",331,116,215
W00003791,SA15,"SA15 3LL, SA15 3RH, SA15 3RL, SA15 3RN, SA15 3RT, SA15 3RW, SA15 3XL, SA15 3XS, SA15 3XT, SA15 3YG, SA15 3YU",321,233,88
W00010009,SA15,"SA15 2BT, SA15 2BY, SA15 2DA, SA15 2DP, SA15 2ED, SA15 2ER",272,223,49
W00003792,SA15,"SA15 3NA, SA15 3PD, SA15 3PE, SA15 3PF, SA15 3RF, SA15 3RR, SA15 3RU, SA15 3SD",253,194,59
W00003734,SA15,"SA15 5SG, SA15 5SN, SA15 5SP, SA15 5SW, SA15 5TA, SA15 5TW",299,136,163
W00003377,SA15,"SA15 1LN, SA15 1LP, SA15 1LW, SA15 1LY, SA15 1NA, SA15 1NS",293,226,67
W00003794,SA15,"SA15 3PU, SA15 3RB, SA15 3RD, SA15 3RE, SA15 3RG, SA15 3RY, SA15 3SB, SA15 3SF",284,215,69
W00010668,SA15,"SA15 4BQ, SA15 4BS, SA15 4DA, SA15 4DQ",282,188,94
W00009988,SA15,"SA15 2JW, SA15 2LD, SA15 2LF, SA15 2LX, SA15 2LY",197,153,44
W00003635,SA15,"SA15 5AU, SA15 5AY, SA15 5BA, SA15 5BB, SA15 5BD, SA15 5BE, SA15 5BG, SA15 5BH, SA15 5BL, SA15 5BN, SA15 5BY, SA32 8PU, SA32 8PX",294,153,141
W00003910,SA15,"SA15 4RN, SA15 4RR, SA15 4RS, SA15 4SB, SA15 4SD, SA15 4SE, SA15 4YA, SA17 4EN, SA17 4EP, SA17 4ES, SA17 4ET, SA17 4EU, SA17 4EW, SA17 4EY",301,165,136
W00003911,SA15,"SA15 4RF, SA15 4RG, SA15 4RH, SA15 4RL, SA15 4RP, SA15 4RW, SA17 4AS, SA17 4AU, SA17 4AY, SA17 4DE, SA17 4DH, SA17 4DN, SA17 4DP, SA17 4DW, SA17 4DY, SA17 4GL, SA17 4LA, SA17 4LB, SA17 4LD, SA17 4LE",332,196,136
W00003925,SA15,"SA15 1AL, SA15 1AN, SA15 1BJ, SA15 1DZ, SA15 2PY, SA15 2TP, SA15 2TR, SA15 2TT, SA15 2UF",307,239,68
W00003926,SA15,"SA15 1BT, SA15 1BY, SA15 1DA, SA15 1DE, SA15 1DL, SA15 1DP, SA15 1DQ, SA15 1DS, SA15 1EQ",253,209,44
W00003927,SA15,"SA15 1DH, SA15 1DN, SA15 1DW, SA15 1NU, SA15 1NY, SA15 1PJ, SA15 1RU, SA15 1SD, SA15 1TB, SA15 1TD, SA15 1TJ, SA15 1TW",290,242,48
W00003928,SA15,"SA15 2RA, SA15 2TY, SA15 2UA, SA15 2UD, SA15 2UE",235,191,44
W00003601,SA15,"SA15 4DH, SA15 4DN, SA15 4DP, SA15 4EJ, SA15 4EL, SA15 4EN, SA15 4EP, SA15 4NA, SA15 4PH, SA15 4PL, SA15 4YB",274,179,95
W00003930,SA15,"SA15 2RD, SA15 2RG, SA15 2RH, SA15 2UB",235,187,48
W00003932,SA15,"SA15 2RE, SA15 2RF, SA15 2TS, SA15 2TU",225,183,42
W00003933,SA15,"SA15 1DB, SA15 1DD, SA15 1DF, SA15 1DG, SA15 1PB, SA15 1PL, SA15 1RP, SA15 1RR",333,273,60
W00003934,SA15,"SA15 1AR, SA15 1AS, SA15 1AT, SA15 1BU",239,207,32
W00003935,SA15,"SA15 1AU, SA15 1AY, SA15 1BA, SA15 1BB, SA15 1YS, SA15 1YU, SA15 2RW",277,217,60
W00003937,SA15,"SA15 1BD, SA15 1BE, SA15 1BG, SA15 1BH, SA15 1BN, SA15 1BW",241,200,41
W00003938,SA15,"SA15 1AW, SA15 1BX, SA15 1DJ, SA15 1RY, SA15 1SA, SA15 1SB, SA15 1TR, SA15 1TT, SA15 1TU, SA15 1TY, SA15 1UA",295,234,61
W00003939,SA15,"SA15 1AG, SA15 1TE, SA15 1TL, SA15 1TN, SA15 1TP, SA15 1TQ, SA15 1TS, SA15 1TX, SA15 1UD, SA15 1UE",259,210,49
W00003931,SA15,"SA15 2RB, SA15 2RS, SA15 2RT, SA15 2RU",263,220,43
W00003600,SA15,"SA15 2SS, SA15 3UL, SA15 4AG, SA15 4BA, SA15 4BB, SA15 4BP, SA15 4DR, SA15 4DS, SA15 4DU, SA15 4DY, SA15 4EA, SA15 4ED, SA15 4SL, SA15 4SS, SA15 4WS, SA16 0YF",226,164,62
W00003599,SA15,"SA15 4BY, SA15 4DB, SA15 4DF, SA15 4DL",344,221,123
W00003598,SA15,"SA15 4AD, SA15 4AF, SA15 4BD, SA15 4BE, SA15 4BG, SA15 4BH",255,156,99
W00003735,SA15,"SA15 5SB, SA15 5SH, SA15 5SL, SA15 5SS, SA15 5TP",306,147,159
W00003589,SA15,"SA15 4AX, SA15 4DT, SA15 4SG, SA15 4SH, SA15 4SJ, SA15 4SN, SA15 4SR",247,170,77
W00003590,SA15,"SA15 4EH, SA15 4HD, SA15 4ND, SA15 4NE, SA15 4NF, SA15 4NG, SA15 4NH, SA15 4NL, SA15 4NN, SA15 4NQ, SA15 4NU, SA15 4PD, SA15 4PN, SA15 4PP, SA15 4PR, SA15 4PS, SA15 4PT, SA15 4PU, SA15 4PW, SA15 4RA, SA15 4RB, SA15 4RD, SA15 4RE, SA15 4RU, SA15 4RY, SA15 4SA, SA16 0TD",340,230,110
W00003591,SA15,"SA15 4EE, SA15 4EY, SA15 4HA, SA15 4HB, SA15 4HE, SA15 4HF, SA15 4HG, SA15 4HH, SA15 4HL, SA15 4HN, SA15 4HW",251,158,93
W00003592,SA15,"SA15 4AH, SA15 4AL, SA15 4AN, SA15 4AR, SA15 4AU, SA15 4AW, SA15 4BW",276,192,84
W00003594,SA15,"SA15 4BT, SA15 4DD, SA15 4DG, SA15 4DJ, SA15 4EW",371,235,136
W00003595,SA15,"SA15 4ER, SA15 4ES, SA15 4ET, SA15 4EU, SA15 4HR, SA15 4HS, SA15 4HT, SA15 4HU, SA15 4LD",243,168,75
W00003596,SA15,"SA15 4AJ, SA15 4AP, SA15 4AS, SA15 4AT, SA15 4AY, SA15 4BL, SA15 4PY",279,225,54
W00003847,SA15,"SA15 5BR, SA15 5DL, SA15 5DN, SA15 5DP, SA15 5DR, SA15 5DS, SA15 5DW, SA15 5FA",350,144,206
W00003597,SA15,"SA15 4AA, SA15 4AB, SA15 4AE, SA15 4BN",245,162,83
W00003849,SA15,"SA15 5BS, SA15 5BT, SA15 5DA, SA15 5DB, SA15 5DD, SA15 5DE, SA15 5DH",317,102,215
W00003850,SA15,"SA15 5EH, SA15 5EL, SA15 5ER, SA15 5ES, SA15 5ET, SA15 5EU, SA15 5EW",267,105,162
W00003851,SA15,"SA15 5AA, SA15 5AE, SA15 5HG, SA15 5LA, SA15 5LE, SA15 5LF, SA15 5NA, SA15 5ND, SA15 5NE, SA15 5NF, SA15 5NH, SA15 5NN, SA15 5NW, SA15 5NX",274,113,161
W00003852,SA15,"SA15 5DF, SA15 5DG, SA15 5EB, SA15 5EF, SA15 5EG, SA15 5EP",255,115,140
W00003853,SA15,"SA15 5AB, SA15 5EN, SA15 5EY, SA15 5HT, SA15 5LB, SA15 5LD",217,97,120
W00003854,SA15,"SA15 5EA, SA15 5ED, SA15 5EE, SA15 5HF, SA15 5HL, SA15 5HN, SA15 5HP, SA15 5HW, SA15 5HY",274,106,168
W00003855,SA15,"SA15 5HU, SA15 5LU, SA15 5LY, SA15 5NB",323,125,198
W00010007,SA15,"SA15 2GD, SA15 2LG, SA15 2LH, SA15 2LJ, SA15 2LL, SA15 2LQ, SA15 2LZ",163,135,28
W00003736,SA15,"SA15 5RT, SA15 5SE, SA15 5SJ, SA15 5SU, SA15 5SY",266,117,149
W00003785,SA15,"SA15 3NT, SA15 3NU, SA15 3NY, SA15 3ST, SA15 3TA",245,185,60
W00003381,SA15,"SA15 1LG, SA15 1LH, SA15 1NR",150,125,25
W00003552,SA15,"SA15 2AP, SA15 2AR, SA15 2AS, SA15 2AT, SA15 2AU, SA15 2AY, SA15 2BA",317,280,37
W00003550,SA15,"SA15 2AF, SA15 2AL, SA15 2BP",286,236,50
W00003549,SA15,"SA15 2AE, SA15 2BX, SA15 2HN, SA15 2HP, SA15 2HW",266,235,31
W00003548,SA15,"SA15 2BB, SA15 2BE, SA15 2BG, SA15 2BJ, SA15 2BQ, SA15 2DU, SA15 2DY, SA15 2EA",223,171,52
W00010696,SA15,"SA15 2DX, SA15 2EX",204,153,51
W00003547,SA15,"SA15 2HL, SA15 2HS, SA15 2HT, SA15 2HU",301,239,62
W00003546,SA15,"SA15 1BL, SA15 2AB, SA15 2AD, SA15 2HR, SA15 2HY",278,237,41
W00003545,SA15,"SA15 2AG, SA15 2AH, SA15 2AW, SA15 2EE",220,177,43
W00003544,SA15,"SA15 2NN, SA15 2NU, SA15 2NW, SA15 2NY, SA15 2PA, SA15 2PB, SA15 2PS",249,202,47
W00003543,SA15,"SA15 2AA, SA15 2EF, SA15 2EG, SA15 2EL, SA15 2EP, SA15 2EW, SA15 2ND, SA15 2NF, SA15 2NH, SA15 2SE, SA15 2YF, SA15 2YH, SA15 2YL, SA15 2YR, SA15 2YS, SA15 2YT, SA15 2YU",298,256,42
W00003525,SA15,"SA15 4HP, SA15 4LG, SA15 4LH, SA15 4NR, SA15 4NS, SA15 4PG",331,237,94
W00003784,SA15,"SA15 3NJ, SA15 3NX, SA15 3SN, SA15 3SW",269,171,98
W00003783,SA15,"SA15 3NZ, SA15 3PJ, SA15 3PQ, SA15 3PX, SA15 4HY, SA15 4LA, SA15 4LB, SA15 4LE, SA15 4LS",267,160,107
W00003521,SA15,"SA15 3TE, SA15 3TF, SA15 4LF, SA15 4PF",254,203,51
W00003781,SA15,"SA15 1DU, SA15 1DY, SA15 1EB, SA15 3AQ, SA15 3AZ, SA15 3BJ, SA15 3BX",298,224,74
W00003553,SA15,"SA15 2BL, SA15 2BR, SA15 2BS, SA15 2BU, SA15 2DB, SA15 2DD",283,240,43
W00003780,SA15,"SA15 3AJ, SA15 3AX, SA15 3BQ, SA15 3YP, SA15 3YT, SA15 3YW, SA15 3YY",259,209,50
W00003554,SA15,"SA15 2AN, SA15 2BD, SA15 2BH, SA15 2BN, SA15 2BW, SA15 2DQ",262,224,38
W00003556,SA15,"SA15 2LE, SA15 2LN, SA15 2LP, SA15 2LR, SA15 2PE",256,192,64
W00010671,SA15,"SA15 4BR, SA15 4BU, SA15 4DW, SA15 4DZ, SA15 4EB, SA15 4EF, SA15 4EG",303,219,84
W00010673,SA15,"SA15 2DG, SA15 2DT, SA15 2DZ, SA15 2EJ, SA15 2EN, SA15 2EQ",245,166,79
W00010682,SA15,"SA15 2AJ, SA15 2AQ, SA15 2AZ, SA15 2BZ, SA15 2DH, SA15 2DJ, SA15 2DL, SA15 2DN, SA15 2DR, SA15 2DS, SA15 2DW, SA15 2GA, SA15 2GB, SA15 2HA",308,220,88
W00010685,SA15,"SA15 2EB, SA15 2EH, SA15 2ES, SA15 2ET, SA15 2EU, SA15 2EY, SA15 2HB, SA15 2HD, SA15 2HE, SA15 2HF, SA15 2HH, SA15 2NZ",261,222,39
W00010657,SA15,"SA15 2AX, SA15 2DE, SA15 2DF",341,235,106
W00010656,SA15,"SA15 1GW, SA15 1GX, SA15 1GZ, SA15 1HP, SA15 1HR, SA15 1HS, SA15 1TF, SA15 1TG, SA15 1TH, SA15 1YR, SA15 1YX, SA15 1YY, SA15 1YZ, SA15 2RL, SA15 2RN, SA15 2RP, SA15 2RR, SA15 2RY, SA15 2SA, SA15 2SB, SA15 2SD",312,270,42
W00003565,SA15,"SA15 5PG, SA15 5PN, SA15 5PP, SA15 5PT, SA15 5PU, SA15 5PW, SA15 5PY, SA15 5RA, SA15 5RB, SA15 5RD, SA15 5TY",316,130,186
W00003564,SA15,"SA15 5NP, SA15 5NS, SA15 5NT, SA15 5PH, SA15 5PL, SA15 5PR, SA15 5PS, SA15 5RP",327,111,216
W00003563,SA15,"SA15 4NB, SA15 4RT, SA15 5AJ, SA15 5AQ, SA15 5AZ, SA15 5DU, SA15 5DX, SA15 5DY, SA15 5EJ, SA15 5EQ, SA15 5EX, SA15 5YR, SA15 5YW, SA15 5YY, SA15 5ZD",337,195,142
W00003562,SA15,"SA15 5AX, SA15 5BJ, SA15 5BQ, SA15 5DQ, SA15 5DT, SA15 5HX, SA15 5HZ, SA15 5JA, SA15 5JF, SA15 5JG, SA15 5JQ, SA15 5PB, SA15 5PE, SA15 5PF, SA15 5UP, SA15 5UR, SA15 5UT, SA15 5YA, SA15 5YD, SA15 5YE, SA15 5YF, SA15 5YG, SA15 5YH, SA15 5YL, SA15 5YN, SA17 4AT, SA17 4HU",221,116,105
W00003561,SA15,"SA15 5NU, SA15 5NY, SA15 5PA, SA15 5PD, SA15 5UH, SA15 5UN",308,119,189
W00003560,SA15,"SA15 5TU, SA15 5TX, SA15 5UA, SA15 5UB, SA15 5UD, SA15 5UE, SA15 5UF, SA15 5UG, SA15 5UJ, SA15 5UQ, SA15 5UU, SA15 5UW",309,148,161
W00003559,SA15,"SA15 5DJ, SA15 5DZ, SA15 5EZ, SA15 5HB, SA15 5HH, SA15 5HJ, SA15 5HQ, SA15 5UL, SA15 5YS, SA15 5YT, SA15 5YU",289,148,141
W00003558,SA15,"SA15 2LA, SA15 2LB, SA15 2LS, SA15 2NA, SA15 2NR, SA15 2NS",148,130,18
W00003557,SA15,"SA15 2PH, SA15 2PJ, SA15 2PL, SA15 2PN, SA15 2PP, SA15 2PQ, SA15 2PR",221,174,47
W00003555,SA15,"SA15 2LW, SA15 2PD, SA15 2PF, SA15 2PG, SA15 2PW",232,191,41
W00003380,SA15,"SA15 1GA, SA15 1LF, SA15 1SN, SA15 1SP, SA15 1SS, SA15 1ST, SA15 1SU, SA15 1SW, SA15 1TA, SA15 1UB",287,254,33
W00003518,SA15,"SA15 3DU, SA15 3DY, SA15 3ED, SA15 3EE, SA15 3EF, SA15 3EG, SA15 3EH",243,148,95
W00003516,SA15,"SA15 2TF, SA15 2TG, SA15 2TH, SA15 2UG, SA15 2UL, SA15 2YE, SA15 2YN, SA15 2YW",271,212,59
W00003389,SA15,"SA15 1PN, SA15 1PS, SA15 1PT, SA15 1PU, SA15 1PY, SA15 1RA",335,292,43
W00003388,SA15,"SA15 1PH, SA15 1RH, SA15 1RL, SA15 1RN, SA15 1RS",275,239,36
W00003387,SA15,"SA15 1AX, SA15 1BP, SA15 1BR, SA15 1BS, SA15 1RE, SA15 1RF, SA15 1RG, SA15 1RW",333,275,58
W00003386,SA15,"SA15 1JH, SA15 1JQ, SA15 1JY, SA15 1PP, SA15 1PR, SA15 1PW",253,212,41
W00003385,SA15,"SA15 1LR, SA15 1NT, SA15 1PA, SA15 1PD, SA15 1PE",299,228,71
W00003383,SA15,"SA15 1GY, SA15 1HZ, SA15 1JA, SA15 1JB, SA15 1JD",237,165,72
W00003382,SA15,"SA15 1LJ, SA15 1LQ, SA15 1LS, SA15 1LT, SA15 1LU, SA15 1LX, SA15 1LZ, SA15 1PF, SA15 1PG, SA15 1XG, SA15 1XS, SA15 1XT, SA15 1XZ, SA15 1YJ, SA15 1YT, SA15 1ZA, SA15 1ZB",293,214,79
W00003786,SA15,"SA15 3NP, SA15 3NQ, SA15 3NS, SA15 3NW, SA15 3SP, SA15 3SR, SA15 3SY",266,200,66
W00003787,SA15,"SA15 3JT, SA15 3JU, SA15 3JX, SA15 3LN, SA15 3LR, SA15 3LS, SA15 3LW, SA15 3SL",268,188,80
W00003743,SA15,"SA15 5BW, SA15 5RE, SA15 5RG, SA15 5RH, SA15 5RN, SA15 5RW, SA15 5SD, SA15 5SF, SA17 5BU, SA17 5BY, SA17 5DA, SA17 5DB, SA17 5DD, SA17 5DE, SA17 5DF, SA17 5DN, SA17 5DP, SA17 5DR, SA17 5DS, SA17 5DT, SA17 5DU, SA17 5DW, SA17 5DY, SA17 5EA, SA17 5EB, SA17 5LG, SA17 5LL, SA17 5LN, SA17 5LW, SA32 8PY",377,175,202
W00003788,SA15,"SA15 3LP, SA15 3LT, SA15 3LU, SA15 3LY, SA15 3NL, SA15 3NN, SA15 3RP, SA15 3RS",268,193,75
W00003789,SA15,"SA15 3NB, SA15 3ND, SA15 3NE, SA15 3NF, SA15 3NG, SA15 3NH, SA15 3NR",306,246,60
W00003739,SA15,"SA15 4RQ, SA15 5RS, SA15 5RU, SA15 5RY, SA15 5SA, SA15 5TB, SA15 5TD, SA15 5TE, SA15 5TR, SA15 5TS, SA15 5TT",266,101,165
W00003790,SA15,"SA15 3DG, SA15 3DH, SA15 3DL, SA15 3HP, SA15 3HW, SA15 3JJ, SA15 3JN, SA15 3JP, SA15 3JW",271,194,77
W00003738,SA15,"SA15 5RL, SA15 5SR, SA15 5ST, SA15 5TF, SA15 5TG, SA15 5TH, SA15 5TL, SA15 5TN, SA17 4NH, SA17 4NN, SA17 4RU, SA17 4RY, SA17 4SA, SA17 4SB, SA17 4SD, SA17 4SE, SA17 4SF, SA17 4SL, SA17 4SN, SA17 4SQ, SA17 5LE, SA17 5LU",294,169,125
W00003390,SA15,"SA15 1ER, SA15 1ES, SA15 1ET, SA15 1EU, SA15 1EX, SA15 1EY, SA15 1HA, SA15 1HB, SA15 1HD, SA15 1HH, SA15 1HL, SA15 1NE, SA15 3DZ",276,226,50
W00003517,SA15,"SA15 3DS, SA15 3DT, SA15 3EA, SA15 3EB, SA15 3HU, SA15 3HY, SA15 3LA, SA15 3LB",337,214,123
W00003391,SA15,"SA15 1HE, SA15 1HF, SA15 1HG, SA15 1HN, SA15 1HW, SA15 1QA, SA15 1QB, SA15 1QE, SA15 3EQ, SA15 3EZ, SA15 3FD",286,222,64
W00003393,SA15,"SA15 1AJ, SA15 1NB, SA15 1ND, SA15 1NJ, SA15 1NQ, SA15 1NX, SA15 1NZ, SA15 1PQ",313,253,60
W00003515,SA15,"SA15 2SP, SA15 2SU, SA15 2SW, SA15 2SY, SA15 2TA, SA15 2TB, SA15 2TJ",263,201,62
W00003514,SA15,"SA15 2SN, SA15 2ST, SA15 2TD, SA15 2TW, SA15 3EY, SA15 3HA",291,232,59
W00003779,SA15,"SA15 1SF, SA15 1SG, SA15 1YD, SA15 1YG, SA15 3AR, SA15 3JA, SA15 3JB, SA15 3JD, SA15 3JF, SA15 3LG, SA15 3PH, SA15 3PL, SA15 3PN, SA15 3PP, SA15 3PR, SA15 3PS, SA15 3PT, SA15 3PW, SA15 3QG, SA15 3SA, SA15 3SE, SA15 3SG, SA15 3YE, SA15 3YF, SA15 3YL, SA15 3YN, SA15 3YS",297,260,37
W00003512,SA15,"SA15 1AA, SA15 1AB, SA15 1AD, SA15 1AE, SA15 1AF, SA15 1AH, SA15 1AP, SA15 1AQ, SA15 1AZ, SA15 1BQ, SA15 1BZ, SA15 1SH, SA15 1UH, SA15 1UL, SA15 1UN, SA15 1UP, SA15 1UR, SA15 1UT, SA15 1UU, SA15 1UW, SA15 1UY, SA15 1WT, SA15 1XL, SA15 1XP, SA15 1XR, SA15 1XW, SA15 1XX, SA15 1XY, SA15 1YA, SA15 1YB, SA15 1YE, SA15 1YF, SA15 1YL, SA15 1YN, SA15 1YP, SA15 1YW, SA15 2PT, SA15 2PU, SA15 2SH, SA15 2SL, SA15 2TE, SA15 2TL, SA15 2TN, SA15 2UH, SA15 3AA, SA15 3AB, SA15 3AD, SA15 3AF, SA15 3AL, SA15 3AN, SA15 3AP, SA15 3AU, SA15 3AW, SA15 3BA, SA15 3BB, SA15 3DD, SA15 3GA, SA15 3QQ, SA15 3TG, SA15 3TH, SA15 3TN, SA15 3TP, SA15 3TR, SA15 3TS, SA15 3TT, SA15 3TU, SA15 3TW, SA15 3UA, SA15 3UB, SA15 3UG, SA15 3UH, SA15 3UN, SA15 3UP, SA15 3UR, SA15 3US, SA15 3UT, SA15 3UW, SA15 3UX, SA15 3WW, SA15 3XY, SA15 3YA, SA15 3YB, SA15 3YD",286,222,64
W00003511,SA15,"SA15 3DP, SA15 3DR, SA15 3DW, SA15 3EP, SA15 3EW, SA15 3HB, SA15 3HS, SA15 3LD, SA15 3LF",317,212,105
W00003510,SA15,"SA15 3AS, SA15 3BD, SA15 3BE, SA15 3BH, SA15 3DN, SA15 3HD, SA15 3HF, SA15 3HG, SA15 3HH, SA15 3HL, SA15 3HN, SA15 3HR, SA15 3HT, SA15 3JE, SA15 3JH, SA15 3LE, SA15 3LH, SA15 3TY, SA15 3UD, SA15 3UE, SA15 3UF",282,201,81
W00003509,SA15,"SA15 3BR, SA15 3DF, SA15 3EL, SA15 3EN, SA15 3ER, SA15 3ES, SA15 3ET, SA15 3EU",246,173,73
W00003508,SA15,"SA15 3BL, SA15 3BP, SA15 3BS, SA15 3BT",256,193,63
W00003778,SA15,"SA15 3JG, SA15 3JL, SA15 3JQ, SA15 3JR, SA15 3LJ, SA15 3PY, SA15 3RA",304,230,74
W00003777,SA15,"SA15 3JS, SA15 3JY, SA15 3JZ, SA15 3LQ, SA15 4NP",271,166,105
W00003398,SA15,"SA15 1HT, SA15 1HY, SA15 1LA, SA15 1LB, SA15 1LD, SA15 1LE, SA15 1SR",281,231,50
W00003397,SA15,"SA15 1DT, SA15 1NN, SA15 1NW, SA15 1SE, SA15 1SL",281,215,66
W00003396,SA15,"SA15 1EZ, SA15 1HJ, SA15 1HX, SA15 1JS",310,226,84
W00003395,SA15,"SA15 1DX, SA15 1EE, SA15 1EH, SA15 1EJ, SA15 1EL, SA15 1EN",301,209,92
W00003394,SA15,"SA15 1EA, SA15 1EF, SA15 1EG, SA15 1EP",300,220,80
W00003392,SA15,"SA15 1EW, SA15 1NF, SA15 1NG, SA15 1NH, SA15 1NL, SA15 1NP, SA15 3HJ",334,277,57
W00003542,SA15,"SA15 2LT, SA15 2LU, SA15 2NB, SA15 2NE, SA15 2NG, SA15 2NP, SA15 2NT, SA15 2NX",338,295,43
W00010697,SA15,"SA15 4BX, SA15 4BZ, SA15 4DE, SA15 4DX",248,183,65
W00003412,SA16,"SA16 0ED, SA16 0FB, SA16 0RG, SA16 0RN, SA16 0RP, SA16 0RW, SA16 0SR, SA16 0SS, SA16 0ST, SA16 0TA, SA16 0TB",319,226,93
W00003404,SA16,"SA16 0SA, SA16 0SB, SA16 0SF, SA16 0SG, SA16 0SH, SA16 0TF",207,132,75
W00003405,SA16,"SA16 0BH, SA16 0BN, SA16 0FA, SA16 0LP, SA16 0LR, SA16 0LS, SA16 0LT, SA16 0LU, SA16 0LY, SA16 0NA, SA16 0NB, SA16 0NE, SA16 0NR, SA16 0NS, SA16 0NW, SA16 0RZ",326,234,92
W00010001,SA16,"SA16 0AU, SA16 0BA, SA16 0BR, SA16 0FD, SA16 0FZ, SA16 0YZ",283,186,97
W00003818,SA16,"SA16 0EG, SA16 0EH, SA16 0ES, SA16 0HA, SA16 0LF",315,226,89
W00003407,SA16,"SA16 0GJ, SA16 0HG, SA16 0HH, SA16 0HL, SA16 0HN, SA16 0HP, SA16 0HR, SA16 0HW",247,189,58
W00003408,SA16,"SA16 0DA, SA16 0DD, SA16 0DE, SA16 0DS",220,163,57
W00003413,SA16,"SA16 0SL, SA16 0SN, SA16 0SP, SA16 0SU, SA16 0SW, SA16 0SY, SA16 0TG, SA16 0TJ",277,194,83
W00003409,SA16,"SA16 0EE, SA16 0RA, SA16 0RD, SA16 0RE, SA16 0RF, SA16 0RL",266,169,97
W00003411,SA16,"SA16 0RB, SA16 0RH, SA16 0RR, SA16 0RS, SA16 0TE",204,142,62
W00003410,SA16,"SA16 0NU, SA16 0PL, SA16 0PP, SA16 0PS, SA16 0PT, SA16 0PU, SA16 0PW, SA16 0PY",249,166,83
W00003819,SA16,"SA16 0UH, SA16 0UJ, SA16 0UN, SA16 0US, SA16 0UU, SA16 0UY, SA16 0YA, SA16 0YB",349,271,78
W00003820,SA16,"SA16 0DZ, SA16 0EJ, SA16 0HS, SA16 0HT, SA16 0HU, SA16 0TR, SA16 0TS, SA16 0TT, SA16 0TX, SA16 0UA, SA16 0UP, SA16 0UR, SA16 0UT, SA16 0UW",271,194,77
W00003821,SA16,"SA16 0BS, SA16 0BT, SA16 0BY, SA16 0DB, SA16 0DF, SA16 0DG, SA16 0DH, SA16 0DL, SA16 0DN, SA16 0DP, SA16 0DR, SA16 0DT, SA16 0DU, SA16 0DW, SA16 0DY, SA16 0FG, SA16 0FW, SA16 0FX",326,229,97
W00003823,SA16,"SA16 0JY, SA16 0UF, SA16 0UL",255,201,54
W00003824,SA16,"SA16 0AQ, SA16 0TU, SA16 0TY, SA16 0UB, SA16 0UD, SA16 0UE, SA16 0UG",202,134,68
W00003825,SA16,"SA16 0HY, SA16 0TH, SA16 0TL, SA16 0TN, SA16 0TP, SA16 0TW",320,258,62
W00010000,SA16,"SA16 0AB, SA16 0FT",175,93,82
W00003829,SA16,"SA16 0BJ, SA16 0BQ, SA16 0BX, SA16 0BZ, SA16 0EA, SA16 0EB, SA16 0EX, SA16 0EZ, SA16 0HJ, SA16 0HQ, SA16 0HX, SA16 0HZ, SA16 0JA, SA16 0JB, SA16 0JD, SA16 0JG, SA16 0JR, SA16 0JS, SA16 0JT, SA16 0JU, SA16 0JX, SA16 0JZ, SA16 0YE, SA16 0YS, SA17 4ER",235,160,75
W00003828,SA16,"SA16 0AH, SA16 0AL, SA16 0AR, SA16 0AS, SA16 0AT, SA16 0AW",266,216,50
W00003827,SA16,"SA16 0AA, SA16 0AE, SA16 0AF, SA16 0AG, SA16 0AN, SA16 0AY, SA16 0EL",248,179,69
W00010003,SA16,"SA16 0BU, SA16 0DX, SA16 0EF, SA16 0FY, SA16 0RX, SA16 0YP, SA16 0YQ, SA16 0YW",238,163,75
W00003403,SA16,"SA16 0NT, SA16 0NY, SA16 0PE, SA16 0PF, SA16 0RT, SA16 0RU, SA16 0SD, SA16 0SE",260,197,63
W00003402,SA16,"SA16 0ND, SA16 0NF, SA16 0NG, SA16 0NH, SA16 0NL, SA16 0NN, SA16 0RY, SA16 0SZ",298,218,80
W00003406,SA16,"SA16 0EN, SA16 0EP, SA16 0EQ, SA16 0ER, SA16 0ET, SA16 0EU, SA16 0EW, SA16 0EY, SA16 0FE, SA16 0HB, SA16 0HD, SA16 0HE, SA16 0HF, SA16 0LD, SA16 0LW",251,170,81
W00003826,SA16,"SA16 0AP, SA16 0DQ, SA16 0LA, SA16 0LB, SA16 0YG, SA16 0YH, SA16 0YN",266,203,63
W00003817,SA16,"SA16 0AJ, SA16 0AX, SA16 0AZ, SA16 0DJ, SA16 0LE, SA16 0LJ, SA16 0LQ, SA16 0LZ, SA16 0NQ, SA16 0YD, SA16 0YL, SA16 0YR, SA16 0YT, SA16 0YU, SA16 0YY, SA16 0ZA, SA16 0ZB",352,205,147
W00003400,SA16,"SA16 0AD, SA16 0BB, SA16 0BD, SA16 0BW",324,217,107
W00003401,SA16,"SA16 0BE, SA16 0BG, SA16 0BL, SA16 0GX, SA16 0LG, SA16 0LH, SA16 0LL, SA16 0LN, SA16 0PA, SA16 0PB, SA16 0PD",250,172,78
W00003399,SA16,"SA16 0BP, SA16 0PG, SA16 0PH, SA16 0PJ, SA16 0PN, SA16 0PR",264,188,76
W00003915,SA16,"SA16 0JE, SA16 0JF, SA16 0JH, SA16 0JJ, SA16 0JL, SA16 0JN, SA16 0JP, SA16 0JQ, SA16 0JW, SA17 4BN, SA17 4DL, SA17 4DR, SA17 4DS, SA17 4DT, SA17 4EB, SA17 4ED, SA17 4EE, SA17 4EF, SA17 4EG, SA17 4EH, SA17 4EL, SA17 4HA, SA17 4HB, SA17 4RN, SA17 4RW, SA17 4YL",296,208,88
W00003917,SA17,"SA17 4AB, SA17 4AD, SA17 4AE",333,175,158
W00003914,SA17,"SA17 4BE, SA17 4BG, SA17 4BH, SA17 4BL, SA17 4BQ, SA17 4BW",252,139,113
W00003913,SA17,"SA17 4AP, SA17 4AW, SA17 4BP, SA17 4BR, SA17 4BS",304,128,176
W00003881,SA17,"SA17 5TA, SA17 5TE, SA17 5TF, SA17 5TG, SA17 5TH, SA17 5TJ, SA17 5TQ, SA17 5TT",334,215,119
W00003912,SA17,"SA17 4AF, SA17 4AG, SA17 4AH, SA17 4AL, SA17 4AN, SA17 4AQ, SA17 4AR",305,171,134
W00003737,SA17,"SA17 4SG, SA17 4SH, SA17 5BG, SA17 5BS, SA17 5HP, SA17 5HR, SA17 5HS, SA17 5HT, SA17 5HU, SA17 5HY, SA17 5LA, SA17 5LB, SA17 5LD, SA17 5LF, SA17 5LH, SA17 5LP, SA17 5LR, SA17 5LS, SA17 5LT, SA17 5LY, SA17 5NA, SA17 5NB, SA17 5PE, SA17 5PF, SA17 5PG",311,149,162
W00003741,SA17,"SA17 4HL, SA17 4HN, SA17 4HP, SA17 4HQ, SA17 4HR, SA17 4HS, SA17 4HT, SA17 4HZ, SA17 4JA, SA17 4JB, SA17 4JF",454,255,199
W00003612,SA17,"SA17 4AJ, SA17 4AZ, SA17 4LF, SA17 4SY, SA17 4TF, SA17 4TH, SA17 4TL, SA17 4TQ, SA17 4TW, SA17 4UE, SA17 4UF, SA17 4UG, SA17 4UW, SA17 4WA",302,173,129
W00003611,SA17,"SA17 4UL, SA17 4UN, SA17 4UP, SA17 4UQ, SA17 4UR, SA17 4UX, SA17 4UZ, SA17 4WE, SA17 5EF, SA17 5EG, SA17 5EH, SA17 5EJ, SA17 5EQ",447,273,174
W00003610,SA17,"SA17 4UU, SA17 4YA, SA17 4YB, SA17 5AJ, SA17 5AQ, SA17 5BD, SA17 5BJ, SA17 5DQ, SA17 5JT",271,170,101
W00003609,SA17,"SA17 5AA, SA17 5AX, SA17 5AZ, SA17 5BQ, SA17 5BX, SA17 5BZ",243,152,91
W00003916,SA17,"SA17 4AA, SA17 4DA, SA17 4DB, SA17 4DD, SA17 4DF, SA17 4DG, SA17 4DJ",307,158,149
W00003607,SA17,"SA17 4LP, SA17 4LT, SA17 4LU, SA17 4NL, SA17 4NP, SA17 4NR, SA17 4NS, SA17 4NT, SA17 4NU, SA17 4NW, SA17 4NY, SA17 4PA, SA17 4PB, SA17 4RA, SA17 4RH, SA17 4RP, SA17 4RR, SA17 4RS, SA17 4RT, SA17 4SW",309,185,124
W00003880,SA17,"SA17 5EX, SA17 5HJ, SA17 5HQ, SA17 5JA, SA17 5JE, SA17 5JF, SA17 5JG, SA17 5JH, SA17 5JL, SA17 5JN, SA17 5JQ, SA17 5JS, SA17 5JU, SA17 5JX, SA17 5UH, SA17 5UL",200,120,80
W00003605,SA17,"SA17 4SJ, SA17 4SU, SA17 4UH, SA17 4UJ, SA17 4US, SA17 4UT, SA17 4UY, SA17 4WD, SA17 4WF, SA17 4WG, SA17 4WW, SA17 4WX, SA17 4WY, SA17 4WZ, SA17 4XZ, SA17 4YD, SA17 4YE, SA17 4YG, SA17 4YH, SA17 5WA, SA17 5WW, SA17 5WX, SA17 5WY, SA17 5WZ, SA17 5YQ, SA17 5YS, SA17 5YT, SA17 5YY, SA17 5YZ, SA17 5ZA, SA17 5ZD, SA17 5ZE, SA17 5ZF",261,156,105
W00003879,SA17,"SA17 5AR, SA17 5AT, SA17 5AU, SA17 5AY, SA17 5BA, SA17 5EZ, SA17 5HX, SA17 5HZ, SA17 5JB, SA17 5JD, SA17 5JJ, SA17 5JP, SA17 5JR, SA17 5JW, SA17 5TL, SA17 5TN, SA17 5UA, SA17 5UB, SA17 5UD, SA17 5UE, SA17 5UF, SA17 5UG, SA17 5UN, SA17 5US, SA17 5UT, SA17 5UU, SA17 5UY, SA17 5YB, SA17 5YD, SA17 5YE, SA17 5YF, SA17 5YG, SA17 5YH, SA17 5YJ, SA17 5YL, SA17 5YN, SA17 5YP, SA17 5YR, SA17 5YW",289,160,129
W00003877,SA17,"SA17 4LY, SA17 4NA, SA17 4NB, SA17 4ND, SA17 4NE, SA17 4NF, SA17 4NG, SA17 4NZ, SA17 5AN, SA17 5AP, SA17 5AS, SA17 5AW, SA17 5BE, SA17 5ND, SA17 5NE, SA17 5NH, SA17 5NP, SA17 5NR, SA17 5NS, SA17 5NT, SA17 5NU, SA17 5NY, SA17 5PA, SA17 5PB, SA17 5PD, SA17 5PH, SA17 5PP, SA17 5PR, SA17 5PS, SA17 5PT, SA17 5PU, SA17 5PW, SA17 5PY, SA17 5RA, SA17 5RB, SA17 5RD, SA17 5RE, SA17 5RF, SA17 5TP, SA17 5TR, SA17 5TW, SA17 5YA, SA17 5YU, SA17 5YX, SA17 5ZB, SA32 8DX, SA32 8DY, SA32 8DZ, SA32 8EA",353,158,195
W00003875,SA17,"SA17 5HG, SA17 5HH, SA17 5NF, SA17 5NG, SA17 5NL, SA31 2LP, SA31 2LR, SA31 2LU, SA31 2LX, SA31 2NB, SA31 2ND, SA32 8EB, SA32 8ED",343,156,187
W00003882,SA17,"SA17 5RL, SA17 5RN, SA17 5RP, SA17 5RT, SA17 5RU, SA17 5RW, SA17 5RY, SA17 5SA, SA17 5SB, SA17 5SD, SA17 5SE, SA17 5SF, SA17 5SG, SA17 5SH, SA17 5SL, SA17 5SN, SA17 5SW, SA17 5TB, SA17 5TD",233,157,76
W00003883,SA17,"SA17 5RR, SA17 5RS, SA17 5RX, SA17 5SP, SA17 5SR, SA17 5SS, SA17 5ST, SA17 5SU, SA17 5SY, SA17 5TS, SA17 5TU, SA17 5TY, SA17 5UR",286,187,99
W00003606,SA17,"SA17 4TA, SA17 4TB, SA17 4TD, SA17 4TE, SA17 4TG",285,204,81
W00010361,SA17,"SA17 4GA, SA17 4HD, SA17 4HE, SA17 4HF, SA17 4HG",298,164,134
W00003608,SA17,"SA17 4LN, SA17 4LR, SA17 4LS, SA17 4LW, SA17 4LX, SA17 4PD, SA17 4PE, SA17 4PF, SA17 4PG, SA17 4PH, SA17 4PJ, SA17 4PR, SA17 4PS, SA17 4PT, SA17 4PU, SA17 4PY, SA17 4RB, SA17 4RD, SA17 4RE, SA17 4RF, SA17 4RG, SA17 4RJ, SA17 4RL, SA17 4SP, SA17 5AB, SA17 5AD, SA17 5AE, SA17 5AF, SA17 5AG, SA17 5AH, SA17 5AL, SA17 5BB",593,385,208
W00010664,SA17,"SA17 4GB, SA17 4GH, SA17 4JG, SA17 4JH",269,175,94
W00010665,SA17,"SA17 4AX, SA17 4HH, SA17 4HJ, SA17 4HW, SA17 4HX, SA17 4HY, SA17 4JJ",316,195,121
W00003742,SA17,"SA17 5BH, SA17 5BL, SA17 5BN, SA17 5BP, SA17 5BR, SA17 5BT, SA17 5BW, SA17 5DG, SA17 5ED, SA17 5EE, SA17 5EL, SA17 5EN, SA17 5EP, SA17 5ER, SA17 5ES, SA17 5ET, SA17 5EU, SA17 5EW, SA17 5EY, SA17 5HA, SA17 5HB, SA17 5HD, SA17 5HE, SA17 5HF, SA17 5HL, SA32 8BX",316,128,188
W00003602,SA17,"SA17 4LG, SA17 4PP, SA17 4SR, SA17 4SS, SA17 4ST, SA17 4SX, SA17 4TJ, SA17 4TY, SA17 4UA, SA17 4UB",437,284,153
W00003603,SA17,"SA17 4TS, SA17 4TT, SA17 4TU",246,147,99
W00003604,SA17,"SA17 4TN, SA17 4TP, SA17 4TR, SA17 4UD",228,124,104
W00003681,SA18,"SA18 3JU, SA18 3LJ, SA18 3LX, SA18 3LZ, SA18 3NJ, SA18 3NQ, SA18 3NX, SA18 3NZ, SA18 3PQ, SA19 6PB, SA19 6PG, SA19 6PS, SA32 8LP, SA32 8LR, SA32 8LT, SA32 8LU, SA32 8LX, SA32 8LY, SA32 8NA, SA32 8NE, SA32 8NG, SA32 8NH, SA32 8NJ, SA32 8NL",336,196,140
W00003667,SA18,"SA18 3BN, SA18 3UR, SA18 3YB, SA18 3YD, SA18 3YR, SA18 3YT",307,120,187
W00003666,SA18,"SA18 3BU, SA18 3HX, SA18 3HZ, SA18 3UL, SA18 3UP, SA18 3UW, SA18 3YE, SA18 3YF",279,124,155
W00003665,SA18,"SA18 2TH, SA18 2TL, SA18 2TN, SA18 2TQ, SA18 3UN",377,191,186
W00003664,SA18,"SA18 2LJ, SA18 2LQ, SA18 2LX, SA18 2NJ, SA18 2NQ, SA18 2NX, SA18 2NZ, SA18 2PQ, SA18 2TP, SA18 2TR, SA18 2TS, SA18 2TT, SA18 2TW, SA18 3GY, SA18 3JJ, SA18 3JL, SA18 3JN, SA18 3JR, SA18 3JY, SA18 3JZ, SA18 3LQ",222,104,118
W00003669,SA18,"SA18 3UF, SA18 3UG, SA18 3UY, SA18 3YA, SA18 3YJ, SA18 3YL, SA18 3YP",277,129,148
W00003668,SA18,"SA18 3AJ, SA18 3AQ, SA18 3YN, SA18 3YS, SA18 3YU, SA18 3ZQ, SA18 3ZW",289,139,150
W00003830,SA18,"SA18 3BQ, SA18 3BX, SA18 3BZ, SA18 3DJ, SA18 3DQ, SA18 3DX, SA18 3DZ, SA18 3EJ, SA18 3EQ",401,178,223
W00003839,SA18,"SA18 2GX, SA18 2JB, SA18 2JD, SA18 2JE, SA18 2JL, SA18 2JR, SA18 2JW",393,193,200
W00003886,SA18,"SA18 3LF, SA18 3NN, SA18 3RJ, SA18 3RP, SA18 3RT, SA18 3SA, SA18 3SB, SA18 3SD, SA18 3SJ, SA18 3SQ, SA18 3SX",422,205,217
W00003887,SA18,"SA18 3RU, SA18 3RY, SA18 3SF, SA18 3SG",302,155,147
W00003888,SA18,"SA18 3HP, SA18 3HR, SA18 3HS, SA18 3QP, SA18 3QR, SA18 3QS, SA18 3QX, SA18 3QZ",396,196,200
W00003889,SA18,"SA18 3BL, SA18 3LA, SA18 3LB, SA18 3LD, SA18 3QW, SA18 3TU, SA18 3UA, SA18 3UB, SA18 3UE",350,166,184
W00003890,SA18,"SA18 3BJ, SA18 3FA, SA18 3LE, SA18 3LG, SA18 3LH, SA18 3LL, SA18 3LR, SA18 3SE",365,204,161
W00003891,SA18,"SA18 3RQ, SA18 3RX, SA18 3SR, SA18 3SS, SA18 3TT",385,232,153
W00003885,SA18,"SA18 3HT, SA18 3LT, SA18 3LY, SA18 3NA, SA18 3NB, SA18 3TA, SA18 3TB, SA18 3TE, SA18 3TG, SA18 3TJ, SA18 3TL, SA18 3TS, SA18 3TX",350,180,170
W00003893,SA18,"SA18 2LG, SA18 2LP, SA18 2LW, SA18 2NU, SA18 2QB, SA18 2QE",248,150,98
W00003923,SA18,"SA18 3PA, SA18 3QD, SA18 3QE, SA18 3QJ, SA18 3QT",276,154,122
W00003922,SA18,"SA18 3NH, SA18 3NW, SA18 3NY, SA18 3PB, SA18 3QF, SA18 3QH",342,180,162
W00003921,SA18,"SA18 3PG, SA18 3PH, SA18 3PL, SA18 3PN, SA18 3PP, SA18 3PW, SA18 3RD, SA18 3RE, SA18 3RF, SA18 3RG, SA18 3RH, SA18 3RL, SA18 3SH, SA18 3SL, SA18 3SN, SA18 3UJ, SA4 0FE, SA4 0FH, SA4 1FE, SA4 1FH",278,189,89
W00003920,SA18,"SA18 3NT, SA18 3NU, SA18 3PR, SA18 3PS, SA18 3PT, SA18 3PU, SA18 3PY, SA18 3QG, SA18 3QQ",371,213,158
W00003919,SA18,"SA18 3PD, SA18 3PJ, SA18 3QA, SA18 3QB",324,182,142
W00003918,SA18,"SA18 3GA, SA18 3NR, SA18 3NS, SA18 3QL, SA18 3QN, SA18 3UH",476,275,201
W00003924,SA18,"SA18 3PE, SA18 3PF, SA18 3RA, SA18 3SP, SA18 3SW",268,157,111
W00003838,SA18,"SA18 2AS, SA18 2HJ, SA18 2HX, SA18 2HZ, SA18 2JA, SA18 2JT, SA18 2JU, SA18 2QA",273,122,151
W00003884,SA18,"SA18 3LN, SA18 3LP, SA18 3LS, SA18 3LW, SA18 3SZ, SA18 3TN, SA18 3TP, SA18 3TY, SA18 3TZ",522,270,252
W00003862,SA18,"SA18 1AG, SA18 1AH, SA18 1AL, SA18 1BT, SA18 1BU, SA18 1BY",257,95,162
W00003840,SA18,"SA18 2ND, SA18 2NH",292,152,140
W00003841,SA18,"SA18 2BH, SA18 2EN, SA18 2EW, SA18 2FD",230,116,114
W00003842,SA18,"SA18 2DR, SA18 2DS, SA18 2DT, SA18 2DU, SA18 2DY",298,186,112
W00003843,SA18,"SA18 2DL, SA18 2DN, SA18 2DP, SA18 2ED, SA18 2EE, SA18 2EJ, SA18 3QU",252,125,127
W00003844,SA18,"SA18 2BT, SA18 2BU, SA18 2DA, SA18 2EA, SA18 2EB, SA18 2PX, SA18 3ST",330,169,161
W00003662,SA18,"SA18 2SR, SA18 2SS, SA18 2SX, SA18 2SY, SA18 2TA, SA18 2TJ",247,118,129
W00003863,SA18,"SA18 1SA, SA18 1SB, SA18 1SD, SA18 1TA",240,99,141
W00003845,SA18,"SA18 2DB, SA18 2DE, SA18 2DF, SA18 2DG, SA18 2DH, SA18 2DW, SA18 3SU, SA18 3SY",266,150,116
W00003856,SA18,"SA18 1DA, SA18 1DB, SA18 1DE, SA18 1DF, SA18 1DG, SA18 1ED",259,127,132
W00003857,SA18,"SA18 1AE, SA18 1AF, SA18 1AP, SA18 1AS, SA18 1AW",306,104,202
W00003858,SA18,"SA18 1AN, SA18 1AR, SA18 1AY, SA18 1BB, SA18 1BE, SA18 1DL",325,144,181
W00003859,SA18,"SA18 1DH, SA18 1DN, SA18 1DP, SA18 1DW, SA9 2WA, SA9 2WB, SA9 2WD, SA9 2WE, SA9 2WF, SA9 2WG, SA9 2WH, SA9 2WJ, SA9 2WL, SA9 2WN, SA9 2WP, SA9 2WQ, SA9 2WR, SA9 2WS, SA9 2WT, SA9 2WU, SA9 2WW, SA9 2WX, SA9 2WY, SA9 2XU, SA9 2XX, SA9 2XY",316,140,176
W00003860,SA18,"SA18 1BD, SA18 1BG, SA18 1BH, SA18 1BL, SA18 1BN, SA18 1BW, SA18 1SE",288,95,193
W00003861,SA18,"SA18 1AA, SA18 1AB, SA18 1AD, SA18 1AT, SA18 1AU, SA18 1BA, SA18 1SF, SA18 1SG, SA18 1SH",270,122,148
W00003846,SA18,"SA18 2FN, SA18 2JP, SA18 2JS, SA18 2NE, SA18 2NF, SA18 2NG, SA18 2UT, SA18 2XT, SA18 2XU, SA18 2XZ, SA18 2YU, SA18 2YY, SA18 2YZ, SA18 2ZH",295,140,155
W00003361,SA18,"SA18 3HE, SA18 3HF, SA18 3HG, SA18 3HL, SA18 3HN, SA18 3HQ",292,172,120
W00003369,SA18,"SA18 3BY, SA18 3DA, SA18 3DR, SA18 3DT, SA18 3DU, SA18 3DW, SA18 3EB, SA18 3EF, SA18 3EG, SA18 3EL, SA18 3EW",229,120,109
W00003363,SA18,"SA18 2LR, SA18 3DD, SA18 3ED, SA18 3EE, SA18 3EH, SA18 3ER, SA18 3EX, SA18 3EZ",198,122,76
W00003638,SA18,"SA18 2LZ, SA18 2TU, SA18 2TY, SA18 2UA, SA18 2UB, SA19 6PF, SA19 6PP, SA19 6PR, SA19 6PT, SA19 6PU, SA19 6PW, SA19 6PY, SA19 6RB, SA19 6RD, SA19 6TN, SA19 6TP, SA19 6TR, SA19 6TS, SA19 6TT, SA19 6TU, SA32 8NN, SA32 8NW",377,217,160
W00004306,SA18,"SA18 2RG, SA18 2RH, SA18 2RJ, SA18 2RL, SA18 2RN, SA18 2RP, SA18 2RR, SA18 2RS, SA18 2RT, SA18 2RU, SA18 2RY, SA18 2SA, SA18 2SB, SA18 2SD, SA18 2SE, SA18 2SF, SA4 8QJ, SA5 7PX",329,207,122
W00004955,SA18,"SA18 1SJ, SA18 1SL, SA18 1SN, SA18 1SP, SA18 1SR, SA18 1SU, SA18 1SW, SA18 1SX, SA18 1TD, SA18 1TF, SA18 1TG, SA18 1TL, SA18 1TW",352,186,166
W00003540,SA18,"SA18 2AP, SA18 2AR, SA18 2AU, SA18 2AW, SA18 2AY, SA18 2BA",228,137,91
W00003539,SA18,"SA18 2AJ, SA18 2AX, SA18 2BJ, SA18 2BQ, SA18 2BX, SA18 2BZ, SA18 2DJ, SA18 2YF, SA18 2YG, SA18 2YH, SA18 2YJ, SA18 2YL, SA18 2YN, SA18 2YP, SA18 2YR, SA18 2YS, SA18 2YT, SA18 2YW, SA18 2ZD",347,185,162
W00003538,SA18,"SA18 1AQ, SA18 1EZ, SA18 1HJ, SA18 1HQ, SA18 1HX, SA18 1JD, SA18 1YU, SA18 1YY, SA18 2AA, SA18 2AD, SA18 2AE, SA18 2AG",308,131,177
W00003537,SA18,"SA18 1DX, SA18 1DZ, SA18 1EQ, SA18 1JE, SA18 1JF, SA18 1NT",326,153,173
W00003536,SA18,"SA18 1EJ, SA18 1EX, SA18 1HZ, SA18 1JA, SA18 1JB, SA18 2BB, SA18 2FH, SA18 2YA, SA18 2YB",311,173,138
W00003535,SA18,"SA18 2AF, SA18 2AH, SA18 2AN, SA18 2BE, SA18 2JF, SA18 2JG",283,151,132
W00004936,SA18,"SA18 1EU, SA18 1HL, SA18 1HU, SA18 1HY, SA18 1UD, SA18 1UL, SA18 1UN, SA18 1UW",291,144,147
W00004937,SA18,"SA18 1BR, SA18 1EH, SA18 1EL, SA18 1EN, SA18 1EP",217,107,110
W00004938,SA18,"SA18 1RF, SA18 1RG, SA18 1RN, SA18 1RR, SA18 1RS",262,144,118
W00003534,SA18,"SA18 1BX, SA18 1BZ, SA18 1DQ, SA18 2AL, SA18 2AT, SA18 2FA",311,170,141
W00004939,SA18,"SA18 1AX, SA18 1PS, SA18 1PY, SA18 1RA, SA18 1RB, SA18 1RD, SA18 1RE",283,173,110
W00003533,SA18,"SA18 1DJ, SA18 1LJ, SA18 1LQ, SA18 1LX, SA18 2AZ, SA18 2YE",303,153,150
W00003530,SA18,"SA18 1JG, SA18 1JH, SA18 1JL, SA18 1JQ, SA18 1JT, SA18 2BD, SA18 2BL, SA18 2BN, SA18 2BP, SA18 2GB",295,136,159
W00003529,SA18,"SA18 1AZ, SA18 1LB, SA18 1LE, SA18 1LF, SA18 1LG, SA18 1LL, SA18 1LU, SA18 1LY, SA18 1NA, SA18 1NB, SA18 1NU, SA18 1NY",329,159,170
W00004954,SA18,"SA18 1BJ, SA18 1SS, SA18 1ST, SA18 1SY, SA18 1TB",252,116,136
W00004953,SA18,"SA18 1DD, SA18 1UP, SA18 1UR, SA18 1US, SA18 1UT, SA18 1UU, SA18 1UY, SA18 1WD, SA18 1YA, SA18 1YB, SA18 1YD, SA18 1YE, SA18 1YF, SA18 1YG, SA18 1YH, SA18 1YL, SA18 1YN, SA18 1YQ",408,230,178
W00004952,SA18,"SA18 1TE, SA18 1TN, SA18 1TP, SA18 1TR, SA18 1TU, SA18 1TY",299,109,190
W00004946,SA18,"SA18 1PG, SA18 1PH, SA18 1PL, SA18 1PN",302,183,119
W00010691,SA18,"SA18 2FE, SA18 2GA, SA18 2GE, SA18 2UU",323,170,153
W00004945,SA18,"SA18 1HN, SA18 1HP, SA18 1HW, SA18 1NZ, SA18 1PA, SA18 1PE, SA18 1PF, SA18 1PT, SA18 1PU",258,137,121
W00003362,SA18,"SA18 1WA, SA18 1WB, SA18 1WQ, SA18 1WX, SA18 1WY, SA18 1WZ, SA18 1XA, SA18 1XT, SA18 1YJ, SA18 1YX, SA18 1YZ, SA18 2LL, SA18 2LS, SA18 2LT, SA18 2LU, SA18 2LY, SA18 2NB, SA18 2NS, SA18 2NT, SA18 2WU, SA18 2WW, SA18 2WX, SA18 2WY, SA18 2WZ, SA18 2YD, SA18 2YQ, SA18 2YX, SA18 2ZB, SA18 2ZE, SA18 2ZF, SA18 2ZG, SA18 2ZL, SA18 2ZN, SA18 2ZP, SA18 2ZR, SA18 2ZS, SA18 2ZT, SA18 3BW, SA18 3WA, SA18 3WG, SA18 3WH, SA18 3WJ, SA18 3WN, SA18 3WQ, SA18 3WS, SA18 3WT, SA18 3WU, SA18 3WW, SA18 3WX, SA18 3WY, SA18 3WZ, SA18 3XA, SA18 3XU, SA18 3YQ, SA18 3YZ, SA18 3ZR, SA18 3ZU, SA18 9AB, SA18 9AD, SA18 9AF, SA18 9AH, SA18 9AJ, SA18 9AN, SA18 9AP, SA18 9AQ, SA18 9AR, SA18 9AS, SA18 9AT, SA18 9AU, SA18 9AW, SA18 9AX, SA18 9AY, SA18 9AZ, SA18 9BA, SA18 9BB, SA18 9BD, SA18 9BE, SA18 9BF, SA18 9BG, SA18 9BH",219,118,101
W00004944,SA18,"SA18 1HF, SA18 1HR, SA18 1HS, SA18 1HT, SA18 1PB, SA18 1PD",312,147,165
W00004942,SA18,"SA18 1EG, SA18 1ER, SA18 1ES, SA18 1ET, SA18 1EW",171,88,83
W00004941,SA18,"SA18 1RU, SA18 1TS, SA18 1TT, SA18 1UF, SA18 1UG, SA18 1UH, SA18 1XZ",341,151,190
W00004940,SA18,"SA18 1PP, SA18 1PR, SA18 1PW, SA18 1RH, SA18 1RL, SA18 1RP, SA18 1RW",118,74,44
W00003526,SA18,"SA18 1AJ, SA18 1JJ, SA18 1LT, SA18 1ND, SA18 1NE, SA18 1NF, SA18 1NG, SA18 1NN, SA18 1NS",331,143,188
W00003527,SA18,"SA18 1LD, SA18 1LH, SA18 1LN, SA18 1LP, SA18 1LR, SA18 1LS, SA18 1LW",268,129,139
W00003528,SA18,"SA18 1BP, SA18 1BQ, SA18 1DR, SA18 1DS, SA18 1DT, SA18 1DU, SA18 1DY, SA18 1NH, SA18 1NJ, SA18 1NL, SA18 1NP, SA18 1NR, SA18 1NW, SA18 1XY, SA18 1YP, SA18 1YR, SA18 1YS, SA18 1YT, SA18 1YW",398,216,182
W00004943,SA18,"SA18 1EF, SA18 1EY, SA18 1HA, SA18 1HB, SA18 1HD, SA18 1HE, SA18 1HG, SA18 1HH",210,104,106
W00003657,SA18,"SA18 2JX, SA18 2JY, SA18 2SU, SA18 2TG, SA18 2UY, SA18 2XY, SA18 3YG, SA18 3YH",346,160,186
W00003894,SA18,"SA18 3TD, SA18 3TF, SA18 3TH, SA18 3TQ, SA18 3TR, SA18 3TW, SA18 3UD, SA18 3WL, SA18 3WP, SA18 3WR, SA18 3YW, SA18 3YX, SA18 3YY",396,200,196
W00003375,SA18,"SA18 2EZ, SA18 2HG, SA18 2HH, SA18 2PT, SA18 2PU, SA18 2PY",255,117,138
W00003661,SA18,"SA18 2EG, SA18 2NY, SA18 2ST, SA18 3HU, SA18 3ND, SA18 3NE, SA18 3NF, SA18 3NG, SA18 3NL, SA18 3NP",284,122,162
W00003374,SA18,"SA18 2PS, SA18 2RA, SA18 2RB, SA18 2SP",286,173,113
W00003372,SA18,"SA18 2FB, SA18 2GY, SA18 2HF, SA18 2HP, SA18 2HT, SA18 2HU, SA18 2HW, SA18 2HY, SA18 2JQ, SA18 2LH",392,207,185
W00009989,SA18,"SA18 2EY, SA18 2HD, SA18 2HQ, SA18 2HR, SA18 2LA, SA18 2LB, SA18 2LD, SA18 2LE, SA18 2LF, SA18 2PZ",341,161,180
W00003659,SA18,"SA18 3US, SA18 3UT, SA18 3UU, SA18 3WB, SA18 3WD, SA18 3WE, SA18 3WF",242,139,103
W00010661,SA18,"SA18 2EF, SA18 2EH, SA18 2ES, SA18 2GF",361,186,175
W00009991,SA18,"SA18 2FF, SA18 2FG, SA18 2FL, SA18 2GD, SA18 2JZ, SA18 2PA, SA18 2QD",573,258,315
W00003370,SA18,"SA18 3DY, SA18 3EA, SA18 3EP, SA18 3ES, SA18 3FE, SA18 3HA, SA18 3RB",312,152,160
W00003368,SA18,"SA18 2LN, SA18 2NA, SA18 3AB, SA18 3AD, SA18 3AE, SA18 3AF, SA18 3AG, SA18 3AH, SA18 3AL, SA18 3AN, SA18 3BG, SA18 3BP, SA18 3BR, SA18 3BS, SA18 3BT, SA18 3DB, SA18 3DE, SA18 3DF, SA18 3DG, SA18 3DH, SA18 3DL, SA18 3DN, SA18 3DP, SA18 3EN, SA18 3GL",233,149,84
W00003367,SA18,"SA18 2DD, SA18 3AP, SA18 3AR, SA18 3AS, SA18 3AT, SA18 3AU, SA18 3AW, SA18 3FD",291,133,158
W00003366,SA18,"SA18 2BR, SA18 2BS, SA18 3AA, SA18 3AY, SA18 3BA, SA18 3BB, SA18 3BD, SA18 3BE, SA18 3BH",317,151,166
W00003365,SA18,"SA18 2BY, SA18 2NL, SA18 2NN, SA18 2NP, SA18 2NR, SA18 2NW, SA18 2PJ",283,155,128
W00003364,SA18,"SA18 3DS, SA18 3ET, SA18 3EU, SA18 3EY, SA18 3FB, SA18 3HB, SA18 3HD, SA18 3HH, SA18 3HW",284,161,123
W00003376,SA18,"SA18 2ET, SA18 2EU, SA18 2EX, SA18 2HA, SA18 2HB, SA18 2HE, SA18 2HL, SA18 2HN",269,115,154
W00003373,SA18,"SA18 2HS, SA18 2JH, SA18 2JJ, SA18 2JN, SA18 2PB, SA18 2PD, SA18 2PE, SA18 2PF, SA18 2PG, SA18 2PH, SA18 2PL, SA18 2PN, SA18 2PP, SA18 2PR, SA18 2PW, SA18 2RD, SA18 2RE, SA18 2RF, SA18 2RW, SA18 2SG, SA18 2SH, SA18 2SL, SA18 2SN, SA18 2SW",205,129,76
W00003660,SA18,"SA18 2AQ, SA18 2EL, SA18 2TB, SA18 2TD, SA18 2TE, SA18 2TF, SA18 2UD, SA18 2UE, SA18 2UF, SA18 2UG, SA18 2UH, SA18 2UL, SA18 2UN, SA18 2UP, SA18 2UR, SA18 2US, SA18 2UW",308,159,149
W00010655,SA18,"SA18 1JN, SA18 1JP, SA18 1JR, SA18 1JS, SA18 1JU, SA18 1JW, SA18 1LZ, SA18 1NQ, SA18 2AB, SA18 2BG, SA18 2BW, SA18 2DQ, SA18 2DX, SA18 2DZ, SA18 2EP, SA18 2EQ, SA18 2ER",367,197,170
W00003699,SA19,"SA19 9AP, SA19 9AR, SA19 9AS, SA19 9AT, SA19 9AU, SA19 9AY, SA19 9BA, SA19 9BB, SA19 9LB, SA19 9LD, SA19 9LE, SA19 9LF, SA19 9LG, SA19 9LH, SA20 0DZ, SA20 0EJ, SA20 0EQ, SA20 0EX, SA20 0EZ, SA20 0HJ, SA20 0HQ, SA20 0HX, SA20 0HZ, SA20 0JA, SA20 0JB, SA20 0JD, SA20 0JE, SA20 0JF, SA20 0JG, SA20 0JQ, SA20 0JY, SA20 0JZ, SA20 0LZ, SA20 0NJ, SA20 0NQ, SA20 0NX, SA20 0NZ, SA20 0PJ, SA20 0PQ, SA20 0PX, SA20 0PZ, SA20 0QA, SA20 0QB, SA20 0QD, SA20 0QE, SA20 0QF, SA20 0RU, SA20 0RY, SA20 0SF",360,220,140
W00003698,SA19,"SA19 6YR, SA19 6YY, SA19 9DP, SA19 9DR, SA19 9DS, SA19 9DT, SA19 9NS, SA19 9NT, SA19 9NU, SA19 9NY, SA19 9PA, SA19 9PB, SA19 9PD, SA19 9PE, SA19 9PF, SA19 9PG, SA19 9PH, SA19 9PR, SA19 9PS, SA19 9PT, SA19 9PU, SA19 9PY, SA19 9RA, SA19 9RB, SA19 9RD, SA19 9RE, SA19 9RF, SA19 9RG, SA19 9RH, SA19 9RL, SA19 9RN, SA19 9RP, SA19 9RR, SA19 9RS, SA19 9RT, SA19 9RU, SA19 9RW, SA19 9SA, SA19 9SB, SA19 9SD, SA19 9SH, SA19 9SY, SA19 9TB, SA19 9TD, SA19 9TE",324,181,143
W00003697,SA19,"SA19 6AQ, SA19 6YB, SA19 6YD, SA19 6YE, SA19 6YF, SA19 6YG, SA19 6YH, SA19 6YL, SA19 6YN, SA19 6YP, SA19 6YW, SA19 9BT, SA19 9BU, SA19 9BY, SA19 9DA, SA19 9DB, SA19 9DD, SA19 9DE, SA19 9DF, SA19 9DG, SA19 9DH, SA19 9DL, SA19 9DN, SA19 9DU, SA19 9DW, SA19 9DY, SA19 9HG, SA19 9LN, SA19 9LU, SA19 9LY",344,124,220
W00003646,SA19,"SA19 6AA, SA19 6AB, SA19 6AD, SA19 6AE, SA19 6AF, SA19 6AG, SA19 6AH, SA19 6AL, SA19 6AN, SA19 6AS, SA19 6AT, SA19 6AU, SA19 6AY, SA19 6BA, SA19 6BB, SA19 6BD, SA19 6BN, SA19 6BQ, SA19 6BR, SA19 6BT, SA19 6BW, SA19 6BY, SA19 6EN, SA19 6EP, SA19 6ER, SA19 6ET, SA19 6EU, SA19 6HA, SA19 6HE, SA19 6HG, SA19 6HJ",233,131,102
W00003496,SA19,"SA19 8AJ, SA19 8AT, SA19 8DS, SA19 8EB, SA19 8JP, SA19 8JR, SA19 8JS, SA19 8JT, SA19 8JU, SA19 8JX, SA19 8JY, SA19 8JZ, SA19 8LX, SA19 8QA, SA19 8QB, SA19 8QD, SA19 8QE, SA19 8QF, SA19 8QG, SA19 8QH, SA19 8QJ, SA19 8QL, SA19 8QN, SA19 8QP, SA19 8QQ, SA19 8QR, SA19 8QS, SA19 8QW, SA48 8HB, SA48 8HF, SA48 8HG, SA48 8HL, SA48 8HN",217,130,87
W00003695,SA19,"SA19 9AA, SA19 9AB, SA19 9AD, SA19 9AE, SA19 9AG, SA19 9AL, SA19 9AN, SA19 9AW, SA19 9BD, SA19 9BE, SA19 9BG, SA19 9BW, SA19 9BX, SA19 9ED, SA19 9EE, SA19 9EF, SA19 9EG, SA19 9EL, SA19 9EN, SA19 9EP, SA19 9ER, SA19 9ES, SA19 9ET, SA19 9EU, SA19 9EW, SA19 9HB, SA19 9HE, SA19 9HF, SA19 9HP, SA19 9HR, SA19 9HS, SA19 9HT, SA19 9HU, SA19 9HY, SA19 9LA, SA19 9LP, SA19 9LR, SA19 9LS, SA19 9LT, SA19 9PP, SA19 9YZ, SA20 0JH",391,200,191
W00003694,SA19,"SA19 9AJ, SA19 9AQ, SA19 9EY, SA19 9HA, SA19 9HD, SA19 9SL, SA19 9SN, SA19 9SP, SA19 9SR, SA19 9SS, SA19 9ST, SA19 9SU, SA19 9SW, SA19 9TA, SA19 9TF, SA19 9TG, SA19 9TH, SA19 9TL, SA19 9TN, SA19 9TP, SA19 9TR, SA19 9TW, SA19 9TY, SA19 9UA, SA19 9UB, SA19 9UD, SA19 9UE, SA19 9UF, SA19 9UG, SA19 9UH, SA19 9UL, SA19 9UN, SA19 9UP, SA19 9UR, SA19 9UW, SA19 9UY, SA19 9XJ, SA19 9YA, SA19 9YB, SA19 9YD, SA19 9YE, SA19 9YF, SA19 9YG, SA19 9YH, SA19 9YL, SA19 9YN, SA19 9YP, SA19 9YR, SA19 9YS, SA19 9YT, SA19 9YU, SA19 9YW, SA19 9YY",222,140,82
W00003678,SA19,"SA19 7TN, SA19 7UG, SA19 7UH, SA32 7BY, SA32 7DA, SA32 7DB, SA32 7DD, SA32 7DE, SA32 7RG, SA32 7SY, SA32 7SZ, SA32 7TA, SA32 7TB, SA32 7TH, SA32 7TJ, SA32 7TL, SA32 7TN, SA32 7TX, SA32 7UA, SA32 7UB, SA32 7UE, SA32 7UF, SA32 7UG, SA32 7UH, SA32 7UJ, SA32 7UL, SA32 7UQ, SA32 7YE, SA32 7YG, SA32 8BB, SA32 8SG",258,144,114
W00003495,SA19,"SA19 7HZ, SA19 7JA, SA19 7JB, SA19 7JD, SA19 7JE, SA19 7JF, SA19 7JG, SA19 7JH, SA19 7JJ, SA19 7JL, SA19 7JN, SA19 7JP, SA19 7JQ, SA19 7JR, SA19 7JS, SA19 7JT, SA19 7JU, SA19 7JW, SA19 7JX, SA19 7JY, SA19 7JZ, SA19 7LJ, SA19 7LQ, SA19 7LX, SA19 7LZ, SA19 7NJ, SA19 7NQ, SA19 7NX, SA19 7NZ, SA19 7PE, SA19 7PF, SA19 7PG, SA19 7PH, SA19 7PL, SA19 7PN, SA19 7PQ, SA19 7PW, SA19 7RN, SA19 7SH, SA19 7SL, SA19 7SN, SA19 7SW, SA19 8SA, SA19 8SB, SA19 8SD, SA19 8SE, SA32 7ST",419,238,181
W00003494,SA19,"SA19 7DJ, SA19 7DX, SA19 8BL, SA19 8DD, SA19 8DE, SA19 8PH, SA19 8PL, SA19 8PN, SA19 8PP, SA19 8PR, SA19 8PU, SA19 8PW, SA19 8PY, SA19 8RB, SA19 8RD, SA19 8RE, SA19 8RF, SA19 8RH, SA19 8RL, SA19 8RN, SA19 8RP, SA19 8RR, SA19 8RS, SA19 8RW, SA19 8RY, SA19 8SF, SA19 8SL, SA19 8SN, SA19 8SR, SA19 8SS, SA19 8ST, SA19 8SU, SA19 8SW, SA19 8TA, SA19 8TH, SA19 8TJ, SA19 8TL, SA19 8TN, SA19 8TP, SA19 8TR, SA19 8TS, SA19 8TT, SA19 8TU, SA19 8TW, SA19 8TY, SA19 8UA, SA19 8UB, SA19 8UD, SA19 8UE, SA19 8UF, SA19 8UG, SA19 8UH, SA19 8UL, SA19 8UN, SA19 8UR, SA19 8US",281,154,127
W00003696,SA19,"SA19 9AF, SA19 9AH, SA19 9BP, SA19 9BR, SA19 9BS, SA19 9EH, SA19 9HN, SA19 9HW, SA19 9LL",265,142,123
W00003683,SA19,"SA19 6RY, SA19 6SA, SA19 6SB, SA19 6SD, SA19 6SE, SA19 6SF, SA19 6SG, SA19 6SH, SA19 6SL, SA19 6SN, SA19 7AA, SA19 7AB, SA19 7AD, SA19 7AE, SA19 7TY, SA19 7UA, SA19 7UB, SA19 7UD, SA19 7UE, SA19 7UF, SA19 7UL, SA32 8BA, SA32 8QD, SA32 8QE, SA32 8QF, SA32 8QG, SA32 8QL, SA32 8QN, SA32 8QP, SA32 8QQ, SA32 8QR, SA32 8QS, SA32 8QW, SA32 8RB",266,167,99
W00003811,SA19,"SA19 7AF, SA19 7AG, SA19 7AH, SA19 7AL, SA19 7AR, SA19 7AS, SA19 7AT, SA19 7BD, SA19 7BE, SA19 7BH, SA19 7BL, SA19 7BN, SA19 7BP, SA19 7BR, SA19 7BW, SA19 7BY, SA19 7DD, SA19 7DE, SA19 7DF, SA19 7DP, SA19 7LE, SA19 7LG, SA19 7LH, SA19 7NF, SA19 7US, SA19 7UT",311,156,155
W00003773,SA19,"SA19 7RS, SA19 7RT, SA19 7RU, SA19 7RY, SA19 7SA, SA19 7SB, SA19 7SD, SA19 7SE, SA19 7SF, SA48 8EJ, SA48 8EN, SA48 8ER, SA48 8ES, SA48 8EU, SA48 8EX, SA48 8EY, SA48 8EZ, SA48 8HA, SA48 8HH, SA48 8HQ, SA48 8HT, SA48 8JP",403,178,225
W00003645,SA19,"SA19 6BE, SA19 6BG, SA19 6BH, SA19 6BL, SA19 6ES, SA19 6EY, SA19 6HD, SA19 6HF, SA19 6HL, SA19 6HN, SA19 6HP, SA19 6HR, SA19 6HS, SA19 6HT, SA19 6HW, SA19 6HY, SA19 6LA, SA19 6LG, SA19 6XB",219,125,94
W00003644,SA19,"SA19 6AP, SA19 6AR, SA19 6BS, SA19 6BU, SA19 6DA, SA19 6DB, SA19 6DD, SA19 6DE, SA19 6DF, SA19 6DH, SA19 6DN, SA19 6DP, SA19 6DW, SA19 6DX, SA19 6DZ, SA19 6HB, SA19 6LP, SA19 6LR, SA19 6NA",287,183,104
W00003643,SA19,"SA19 6HU, SA19 6LB, SA19 6LD, SA19 6LE, SA19 6LW, SA19 6ND, SA19 6NG, SA19 6NH, SA19 6NL, SA19 6NN",210,96,114
W00003493,SA19,"SA19 7SG, SA19 8AX, SA19 8BJ, SA19 8BX, SA19 8BZ, SA19 8DJ, SA19 8DP, SA19 8DQ, SA19 8DR, SA19 8DT, SA19 8DU, SA19 8DW, SA19 8DX, SA19 8DY, SA19 8DZ, SA19 8EA, SA19 8EJ, SA19 8EQ, SA19 8PF, SA19 8PG, SA19 8PS, SA19 8RA, SA19 8RG, SA19 8SY, SA19 8TB, SA19 8TD, SA19 8TE, SA19 8TF, SA19 8TG, SA19 8UP, SA19 8UT, SA19 8UU, SA19 8UW, SA19 8UY, SA19 8YA, SA19 8YB, SA19 8YD, SA19 8YE, SA19 8YF, SA19 8YG, SA19 8YH, SA19 8YL, SA19 8YP, SA19 8YT, SA19 8YU, SA19 8YY, SA48 8HD, SA48 8HE",308,164,144
W00003642,SA19,"SA19 6DR, SA19 6DS, SA19 6DT, SA19 6DU, SA19 6DY, SA19 6EB, SA19 6EG, SA19 7HW",213,140,73
W00003641,SA19,"SA19 6EA, SA19 6ED, SA19 6EE, SA19 6EF, SA19 6LF, SA19 6LU, SA19 6NB, SA19 6NE, SA19 6NF, SA19 6NX",251,154,97
W00003640,SA19,"SA19 6AW, SA19 6AZ, SA19 6DG, SA19 6DL, SA19 6EH, SA19 6RJ, SA19 6RP, SA19 6RR, SA19 6RS, SA19 6RT, SA19 6RU, SA19 6RW, SA19 6RX, SA19 6RZ",337,147,190
W00003637,SA19,"SA19 6PA, SA19 6PD, SA19 6UH, SA19 6UL, SA19 6UN, SA19 6UP, SA19 6UW",281,140,141
W00003770,SA19,"SA19 7PP, SA19 7PR, SA19 7PS, SA19 7PT, SA19 7PU, SA19 7PY, SA19 7RA, SA19 7RB, SA19 7RD, SA19 7RE, SA19 7RF, SA19 7RG, SA19 7RH, SA19 7RL, SA19 7RP, SA19 7RR, SA19 7RW, SA19 7SP, SA32 7RT, SA40 9QE, SA40 9QR, SA40 9QS, SA40 9QY, SA40 9QZ, SA40 9RB, SA40 9RD, SA40 9RE, SA40 9RF",355,214,141
W00003636,SA19,"SA19 6PE, SA19 6SR, SA19 6SS, SA19 6ST, SA19 6SU, SA19 6SY, SA19 6SZ, SA19 6TA, SA19 6UR",217,105,112
W00003479,SA19,"SA19 7DG, SA19 7DL, SA19 7DN, SA19 7DW, SA19 7UU, SA19 7YB, SA19 7YE, SA19 8HA, SA19 8HE, SA19 8HP, SA19 8LE, SA19 8LF, SA19 8LL, SA19 8LP, SA19 8LW, SA19 8NB, SA19 8ND, SA19 9NA, SA19 9NB, SA19 9ND, SA19 9NE, SA19 9NF",218,115,103
W00003480,SA19,"SA19 7DH, SA19 8BA, SA19 8BB, SA19 8BD, SA19 8BN, SA19 8BP, SA19 8BR, SA19 8BW, SA19 8BY, SA19 8DA, SA19 8HF, SA19 8HG, SA19 8HH, SA19 8HL, SA19 8HN, SA19 8HR, SA19 8HS, SA19 8HT, SA19 8HU, SA19 8HW, SA19 8HY, SA19 8LG, SA19 8LH, SA19 8LN, SA19 8LR, SA19 8LS, SA19 8LT, SA19 8LU, SA19 8LY, SA19 8NA, SA19 8NG, SA19 8NH, SA19 8NL, SA19 8NN, SA19 8NP, SA19 8NR, SA19 8NS, SA19 8NT, SA19 8NW, SA19 9NG, SA19 9NH, SA19 9NL, SA19 9NN",291,182,109
W00003481,SA19,"SA19 8AD, SA19 8AH, SA19 8AL, SA19 8AN, SA19 8AP, SA19 8AR, SA19 8AS, SA19 8AW, SA19 8AY, SA19 8BG, SA19 8BH, SA19 8BS, SA19 8DB, SA19 8DF, SA19 8EP, SA19 8ER, SA19 8ES, SA19 8ET, SA19 8EU, SA19 8EW, SA19 8PA, SA19 8PB, SA19 8PD, SA19 8PE, SA20 0ES, SA20 0ET, SA20 0EU",196,123,73
W00003482,SA19,"SA19 8AA, SA19 8AB, SA19 8AE, SA19 8AF, SA19 8AG, SA19 8AU, SA19 8EF, SA19 8EG, SA19 8EH, SA19 8EL, SA19 8EN, SA19 8EY, SA19 8HD",258,130,128
W00003815,SA19,"SA19 7AJ, SA19 7AQ, SA19 7AX, SA19 7AZ, SA19 7BJ, SA19 7BQ, SA19 7BX, SA19 7BZ, SA19 7DQ, SA19 7DS, SA19 7DT, SA19 7DU, SA19 7DZ, SA19 7EE, SA19 7EH, SA19 7EJ, SA19 7EN, SA19 7EP, SA19 7EQ, SA19 7EX, SA19 7EZ, SA19 7PB, SA19 7XZ, SA19 7YH, SA19 7YL, SA19 7YN, SA19 7YP, SA19 7YR, SA19 7YS, SA19 7YT, SA19 7YU, SA19 7YW, SA19 7YY, SA19 8SG, SA19 8SH",451,306,145
W00003814,SA19,"SA19 6AJ, SA19 6AX, SA19 7ER, SA19 7ES, SA19 7ET, SA19 7EU, SA19 7EY, SA19 7HA, SA19 7HB, SA19 7HE, SA19 7HF, SA19 7LB, SA19 7LP, SA19 7LR, SA19 7LS, SA19 7NA, SA19 7NR, SA19 7ST, SA19 7SU, SA19 7SY, SA19 7TA, SA19 7TB, SA19 7TD, SA19 7TE, SA19 7TF, SA19 7TG, SA19 7TL, SA19 7TP, SA19 7TR, SA19 7TS, SA19 7TU, SA19 7TW",361,190,171
W00003813,SA19,"SA19 0AA, SA19 0AB, SA19 0AD, SA19 0AE, SA19 0AF, SA19 0AG, SA19 0AH, SA19 0AJ, SA19 0AL, SA19 0AN, SA19 0AP, SA19 0AQ, SA19 0AR, SA19 0AS, SA19 0AT, SA19 0AU, SA19 0AW, SA19 0AX, SA19 0AY, SA19 0AZ, SA19 0BA, SA19 6DJ, SA19 6EW, SA19 6HH, SA19 6NP, SA19 6NR, SA19 6NS, SA19 6NT, SA19 6NU, SA19 6NW, SA19 6WX, SA19 6WZ, SA19 6XA, SA19 6XD, SA19 6XE, SA19 6XG, SA19 6XY, SA19 6XZ, SA19 6YJ, SA19 6YQ, SA19 6YX, SA19 7HJ, SA19 7HL, SA19 7HN, SA19 7HP, SA19 7HR, SA19 7HS, SA19 7HT, SA19 7HU, SA19 7HY, SA19 7LA, SA19 7LD, SA19 7LF, SA19 7LN, SA19 7WX, SA19 7WY, SA19 7WZ, SA19 7XA, SA19 7XB, SA19 7XD, SA19 7XE, SA19 7XF, SA19 7XG, SA19 7XJ, SA19 7XL, SA19 7XW, SA19 7YQ, SA19 7ZU, SA19 8WA, SA19 8WH, SA19 8WY, SA19 8WZ, SA19 8XU, SA19 8XY, SA19 8XZ, SA19 8YJ, SA19 8YQ, SA19 8YS, SA19 8YX, SA19 8YZ, SA19 8ZF, SA19 8ZG, SA19 8ZW, SA19 9WA, SA19 9WG, SA19 9WR, SA19 9WZ, SA19 9YX, SA20 0ZB",299,107,192
W00003812,SA19,"SA19 7AN, SA19 7AP, SA19 7AU, SA19 7AW, SA19 7AY, SA19 7BA, SA19 7BB, SA19 7BG, SA19 7BS, SA19 7BT, SA19 7BU",333,167,166
W00003477,SA19,"SA19 8DG, SA19 8DH, SA19 8DL, SA19 8DN, SA19 8NY, SA20 0EW, SA20 0EY, SA20 0HE, SA20 0HF, SA20 0HG, SA20 0HH, SA20 0HL, SA20 0HN, SA20 0HP, SA20 0HR, SA20 0HW, SA20 0SN, SA20 0SP, SA20 0SR, SA20 0SW, SA20 0TA, SA20 0TB, SA20 0TD, SA20 0TE, SA20 0TN, SA20 0TU, SA20 0TW, SA20 0UA, SA20 0UD",241,141,100
W00003639,SA19,"SA19 6PH, SA19 6PL, SA19 6PN, SA19 6RA, SA19 6RE, SA19 6RF, SA19 6RG, SA19 6RH, SA19 6TB, SA19 6TD, SA19 6TE, SA19 6TF, SA19 6TG, SA19 6TH, SA19 6TL, SA19 6TW, SA19 6TY, SA19 6UA, SA19 6UB, SA19 6UD, SA19 6US, SA19 6UT, SA19 6UU, SA19 6UY, SA19 6WR, SA19 6WY, SA19 6XF, SA19 6YA, SA19 6YS, SA19 6YT, SA19 6YU, SA19 6YZ, SA19 9RY",274,153,121
W00003492,SA19,"SA19 8AQ, SA19 8AZ, SA19 8BQ, SA19 8EX, SA19 8EZ, SA19 8HJ, SA19 8HQ, SA19 8HX, SA19 8HZ, SA19 8JA, SA19 8JB, SA19 8JD, SA19 8JE, SA19 8JF, SA19 8JG, SA19 8JH, SA19 8JJ, SA19 8JL, SA19 8JN, SA19 8JQ, SA19 8JW, SA19 8LJ, SA19 8LQ, SA19 8LZ, SA19 8NJ, SA19 8NQ, SA19 8NX, SA19 8NZ, SA19 8PJ, SA19 8PQ, SA19 8PX, SA19 8PZ, SA19 8YN, SA19 8YR, SA19 8YW, SA20 0PP",294,173,121
W00010004,SA19,"SA19 7DA, SA19 7DB, SA19 7DR, SA19 7DY, SA19 7EA, SA19 7EB, SA19 7ED, SA19 7EF, SA19 7EG, SA19 7EL, SA19 7EW, SA19 7HD, SA19 7HG, SA19 7LL, SA19 7LT, SA19 7LU, SA19 7LW, SA19 7LY, SA19 7NB, SA19 7ND, SA19 7NE, SA19 7NG, SA19 7NH, SA19 7NL, SA19 7NN, SA19 7NP, SA19 7NS, SA19 7NT, SA19 7NU, SA19 7NW, SA19 7NY, SA19 7PA, SA19 7TT, SA19 7UR, SA19 7UY, SA19 7WA, SA19 7XH, SA19 7YA, SA19 7YD, SA19 7YF, SA19 7YG, SA19 7YJ, SA19 7YX, SA19 7YZ",390,250,140
W00004565,SA2,"SA2 8HR, SA2 9HT, SA2 9JA, SA2 9JB, SA2 9JG, SA2 9JH, SA2 9LA, SA2 9LB, SA2 9LD, SA2 9LE, SA2 9LF",317,280,37
W00004647,SA2,"SA2 0EN, SA2 0EP, SA2 0ER, SA2 0JB, SA2 0JN, SA2 0LB, SA2 0LF, SA2 0LG, SA2 0LH, SA2 0LQ, SA2 0LW",242,209,33
W00004652,SA2,"SA2 0DG, SA2 0DN, SA2 0DP, SA2 0DU, SA2 0EW, SA2 0JE, SA2 0JH, SA2 0JJ, SA2 0JL, SA2 0JQ",335,276,59
W00004200,SA2,"SA2 7EL, SA2 7EQ, SA2 7RA, SA2 7RJ, SA2 7RU, SA2 7RX",279,262,17
W00004199,SA2,"SA2 7AY, SA2 7DS, SA2 7DT, SA2 7DU, SA2 7DW, SA2 7DX, SA2 7DY",281,258,23
W00004198,SA2,"SA2 7AJ, SA2 7AL, SA2 7AN, SA2 7BA, SA2 7BB, SA2 7BD, SA2 7DA, SA2 7DZ, SA2 7EA, SA2 7EB, SA2 7ED",237,214,23
W00004646,SA2,"SA2 0AA, SA2 0AB, SA2 0AZ, SA2 0EY, SA2 0EZ, SA2 0HB, SA2 0HD, SA2 0HE, SA2 0HH, SA2 0HL, SA2 0HN, SA2 0NP, SA2 0NS, SA2 0NT, SA2 0PG, SA2 0PQ, SA2 0QR",429,386,43
W00004197,SA2,"SA2 7AR, SA2 7AU, SA2 7AX, SA2 7AZ",252,239,13
W00004192,SA2,"SA2 7ES, SA2 7ET, SA2 7PA, SA2 7PD",300,264,36
W00004191,SA2,"SA2 7DB, SA2 7DD, SA2 7NR, SA2 7QP, SA2 7SG, SA2 7SQ",289,261,28
W00004566,SA2,"SA2 9BJ, SA2 9BS, SA2 9DP, SA2 9DR, SA2 9DS, SA2 9DT, SA2 9DW, SA2 9HS",306,276,30
W00004189,SA2,"SA2 7BP, SA2 7BR, SA2 7BS, SA2 7NN",257,236,21
W00004188,SA2,"SA2 7DL, SA2 7LF, SA2 7NP, SA2 7NS, SA2 7NT, SA2 7NW",257,229,28
W00004653,SA2,"SA2 0DR, SA2 0DT, SA2 0HS, SA2 0HX, SA2 0HY, SA2 0JA, SA2 0JD",350,309,41
W00004196,SA2,"SA2 7AE, SA2 7BN, SA2 7BW, SA2 7NL",217,192,25
W00004644,SA2,"SA2 0JZ, SA2 0LA, SA2 0LD, SA2 0LE, SA2 0LS, SA2 0LT",310,260,50
W00004643,SA2,"SA2 0AW, SA2 0LN, SA2 0LP, SA2 0LR, SA2 0NE, SA2 0PX",351,307,44
W00004642,SA2,"SA2 0GU, SA2 0HQ, SA2 0NX, SA2 0NY, SA2 0PB, SA2 0QX, SA2 0QY, SA2 0QZ, SA2 0RG",348,317,31
W00004204,SA2,"SA2 7AP, SA2 7AS, SA2 7AT, SA2 7EF, SA2 7QS",277,256,21
W00004203,SA2,"SA2 7EE, SA2 7EN, SA2 7QT, SA2 7QY, SA2 7YL, SA2 7YN, SA2 7YR",241,217,24
W00004202,SA2,"SA2 7AD, SA2 7AF, SA2 7AG, SA2 7AH, SA2 7AQ, SA2 7BE, SA2 7BT, SA2 8QQ",343,318,25
W00004147,SA2,"SA2 7DP, SA2 7DR, SA2 7EW, SA2 7EY, SA2 7JJ, SA2 7JL, SA2 7JN, SA2 7JP, SA2 7JR, SA2 7JX",353,318,35
W00004201,SA2,"SA2 7EG, SA2 7EH, SA2 7EJ, SA2 7QZ",252,230,22
W00004631,SA2,"SA2 0RA, SA2 0RB, SA2 0RD, SA2 0RF, SA2 0RH, SA2 0RJ, SA2 0RQ",293,238,55
W00010369,SA2,"SA2 7DF, SA2 7DH, SA2 7DN, SA2 7DQ, SA2 7RD, SA2 7RG",261,228,33
W00010436,SA2,"SA2 7DG, SA2 7PG, SA2 7PZ, SA2 7QG, SA2 7RE, SA2 7RF",588,517,71
W00004076,SA2,"SA2 0FG, SA2 0FL, SA2 0FQ, SA2 0FR, SA2 0FT, SA2 0FU, SA2 0FY",263,237,26
W00004632,SA2,"SA2 0JX, SA2 0JY, SA2 0QF, SA2 0QG, SA2 0QJ, SA2 0SE",224,188,36
W00004635,SA2,"SA2 0PP, SA2 0PR, SA2 0PS, SA2 0RL, SA2 0RP, SA2 0RT",233,197,36
W00004636,SA2,"SA2 0NB, SA2 0ND, SA2 0QA, SA2 0QB",243,209,34
W00004639,SA2,"SA2 0LU, SA2 0LX, SA2 0LY, SA2 0NA, SA2 0YF, SA2 0ZJ",244,201,43
W00004640,SA2,"SA2 0AG, SA2 0PJ, SA2 0PN, SA2 0PT, SA2 0QT",237,214,23
W00004641,SA2,"SA2 0EU, SA2 0EX, SA2 0LJ, SA2 0LL, SA2 0NF, SA2 0NG, SA2 0NH, SA2 0NL, SA2 0PL, SA2 0PU, SA2 0PY, SA2 0PZ, SA2 0QS",288,264,24
W00004657,SA2,"SA2 0BR, SA2 0DX, SA2 0DY, SA2 0DZ, SA2 0EA",355,314,41
W00004659,SA2,"SA2 0BP, SA2 0BS, SA2 0BZ",323,282,41
W00004660,SA2,"SA2 0BT, SA2 0DE, SA2 0DH, SA2 0DJ, SA2 0DQ, SA2 0ED, SA3 4WE, SA3 4WF, SA3 4WG, SA3 4WH, SA3 4WL",222,193,29
W00004661,SA2,"SA2 0BA, SA2 0BB, SA2 0BD, SA2 0BY, SA2 0DB, SA2 0DD",340,294,46
W00004131,SA2,"SA2 7QD, SA2 7ST, SA2 7SU, SA2 7TA, SA2 7TB, SA2 7UZ, SA2 7WG, SA2 7XQ, SA2 7YG",315,286,29
W00004132,SA2,"SA2 7PT, SA2 7PU, SA2 7PX, SA2 7PY, SA2 7QB",240,218,22
W00004133,SA2,"SA2 7BH, SA2 7TD, SA2 7TG, SA2 7TJ, SA2 7TP, SA2 7TR",279,260,19
W00004134,SA2,"SA2 7TF, SA2 7TH, SA2 7UE, SA2 7UF, SA2 7UG, SA2 7UP, SA2 7UQ, SA2 7UR, SA2 7UT, SA2 7UU",276,251,25
W00004135,SA2,"SA2 7NY, SA2 7NZ, SA2 7PB, SA2 7PF, SA2 7QH, SA2 7QJ",322,298,24
W00004136,SA2,"SA2 7NU, SA2 7NX, SA2 7PE, SA2 7PH, SA2 7PQ",282,267,15
W00004130,SA2,"SA2 7TE, SA2 7TS, SA2 7TT, SA2 7TU, SA2 7US, SA2 7UX, SA2 7XB",272,246,26
W00004137,SA2,"SA2 7UA, SA2 7UB, SA2 7UL, SA2 7UW",304,287,17
W00004139,SA2,"SA2 7PN, SA2 7PP, SA2 7PS, SA2 7PW",283,254,29
W00004143,SA2,"SA2 7LA, SA4 3HX, SA4 3JF, SA4 3PH, SA4 3PJ, SA4 3PL, SA4 3PN, SA4 3PQ, SA4 3PR, SA4 3PS, SA4 3PT, SA4 3PU, SA4 3UP, SA4 3US",350,311,39
W00004145,SA2,"SA2 7BG, SA2 7BJ, SA2 7EX, SA2 7EZ, SA2 7HB, SA2 7HE, SA2 7HF, SA2 7HP, SA2 7HQ, SA2 7HR, SA2 7HX, SA2 7JH, SA2 7LN, SA2 7UD",381,345,36
W00004165,SA2,"SA2 7LJ, SA3 1BG, SA3 1EA, SA3 1EB, SA3 1ED, SA3 1ER, SA3 1ES, SA3 1ET, SA3 1EU, SA3 1EX, SA3 1EY, SA3 1HA, SA3 1HB, SA4 3UB",298,265,33
W00004161,SA2,"SA2 7LB, SA2 7LD, SA2 7LE, SA2 7LH, SA2 7LL, SA2 7LQ, SA3 2HA, SA3 2HB, SA3 2HD, SA3 2HE, SA3 2HH, SA3 2HJ, SA3 2HL, SA3 2HN, SA3 2HP, SA3 2HQ, SA3 2HS, SA4 3UL",317,287,30
W00004148,SA2,"SA2 7HA, SA2 7HN, SA2 7HU, SA2 7HY, SA2 7HZ, SA2 7JA",242,224,18
W00004138,SA2,"SA2 7PR, SA2 7QA, SA2 7QE, SA2 7QQ, SA4 4XS",258,246,12
W00004129,SA2,"SA2 7PJ, SA2 7PL, SA2 7QU, SA2 7QX, SA2 7SH, SA2 7SJ, SA2 7SL, SA2 7SN, SA2 7SP, SA2 7YD, SA2 7YW, SA2 7YX",315,296,19
W00004128,SA2,"SA2 7RH, SA2 7RL, SA2 7RN, SA2 7RQ, SA2 7RT, SA2 7SA, SA2 7SX",230,210,20
W00004127,SA2,"SA2 7QF, SA2 7RB, SA2 7RW, SA2 7SR, SA2 7SS, SA2 8RD, SA2 8RE",284,269,15
W00004662,SA2,"SA2 0AH, SA2 0AL, SA2 0AR",388,336,52
W00004663,SA2,"SA2 0BE, SA2 0BU, SA2 0BX, SA2 0DA",375,338,37
W00004664,SA2,"SA2 0AJ, SA2 0AN, SA2 0AP, SA2 0AS, SA2 0AT, SA2 0AU, SA2 0AY",423,385,38
W00004665,SA2,"SA2 0FA, SA2 0TU, SA2 0YD, SA2 0YE, SA2 0YH",250,224,26
W00004666,SA2,"SA2 0TX, SA2 0US, SA2 0YJ, SA2 0YL, SA2 0YN, SA2 0YQ, SA2 0YR",246,212,34
W00004667,SA2,"SA2 0RU, SA2 0TN, SA2 0TP, SA2 0TR, SA2 0TW, SA2 0TY, SA2 0UT",262,215,47
W00004669,SA2,"SA2 0TH, SA2 0TJ, SA2 0TQ, SA2 0TS, SA2 0TT, SA2 0TZ, SA2 0UR",307,262,45
W00004173,SA2,"SA2 7XD, SA2 7XE, SA4 3HJ, SA4 3HL, SA4 3HN, SA4 3HP, SA4 3HS, SA4 3HW, SA4 3QS, SA4 3QT, SA4 3QU, SA4 3QX, SA4 3RB, SA4 3RE",176,157,19
W00004670,SA2,"SA2 0QD, SA2 0QE, SA2 0RN, SA2 0RX, SA2 0RY, SA2 0RZ, SA2 0SA, SA2 0TL, SA2 0WH, SA2 0YG, SA2 0YS, SA2 0ZE, SA2 0ZF, SA2 0ZG, SA2 0ZH, SA2 0ZQ, SA2 0ZS",313,259,54
W00004672,SA2,"SA2 0QH, SA2 0QP, SA2 0QQ, SA2 0RR, SA2 0RS, SA2 0SH, SA2 0SJ",273,230,43
W00004092,SA2,"SA2 0GJ, SA5 4AJ, SA5 4AW, SA5 4DE, SA5 4ET, SA5 4EX, SA5 4HH, SA5 4HN, SA5 4HP, SA5 4HS, SA5 4HT, SA5 4HU, SA5 4HX, SA5 4QA, SA5 4RJ, SA5 4RN, SA5 4RP, SA5 4RR, SA5 4RU, SA5 4RX, SA5 4TH, SA5 4TP, SA5 4TR, SA5 4WW",234,220,14
W00010087,SA2,"SA2 7DJ, SA2 7EP, SA2 7ER, SA2 7QL, SA2 7QN, SA2 7QW, SA5 4RT",241,219,22
W00010073,SA2,"SA2 8AD, SA2 8DE, SA2 8DF, SA2 8PG, SA2 8PH, SA2 8PJ, SA2 8PL, SA2 8PN, SA2 8PP, SA2 8PQ, SA2 8PR, SA2 8PS, SA2 8PT, SA2 8PU, SA2 8PW, SA2 8PX, SA2 8PY, SA2 8PZ, SA2 8QA, SA2 8QB, SA2 8QD, SA2 8QE, SA2 8QG, SA2 8QJ, SA2 8QL, SA2 9AU",1112,973,139
W00004125,SA2,"SA2 7TQ, SA2 7UH, SA2 7UJ, SA2 7UN",241,222,19
W00004126,SA2,"SA2 7RP, SA2 7RR, SA2 7RS, SA2 7TZ",255,233,22
W00004606,SA2,"SA2 0UX, SA2 0UY, SA2 0UZ, SA2 0WX, SA2 0XA",273,256,17
W00004605,SA2,"SA2 0XG, SA2 0XL, SA2 0XQ",238,226,12
W00004190,SA2,"SA2 7BU, SA2 7BX, SA2 7BY, SA2 7BZ, SA2 7DE",265,231,34
W00004598,SA2,"SA2 9AZ, SA2 9BL, SA2 9BP, SA2 9BQ, SA2 9EG, SA2 9EQ, SA2 9JQ, SA2 9YE, SA2 9YH, SA2 9YN, SA2 9YR",341,298,43
W00004553,SA2,"SA2 8LE, SA2 8LN, SA2 8LR, SA2 8QF, SA2 8QH, SA2 9AP, SA2 9AR, SA2 9AS, SA2 9BE, SA2 9EA",368,318,50
W00010254,SA2,"SA2 8AP, SA2 8DD, SA2 8DQ, SA2 8DS",134,112,22
W00004490,SA2,"SA2 7JS, SA2 7JT, SA2 7JU, SA3 2AA, SA3 2AB, SA3 2AT, SA3 2AU, SA3 2EA, SA3 2EB, SA3 2ED, SA3 2EE, SA3 3JD, SA3 3JE, SA3 3JQ",270,249,21
W00004055,SA2,"SA2 0FZ, SA2 0GA, SA2 0GB, SA2 0GE, SA2 0GF, SA2 0GG, SA2 0GQ",269,245,24
W00004574,SA2,"SA2 0JF, SA2 0JP, SA2 0LZ, SA2 9BY, SA2 9DX, SA2 9FE, SA2 9FF, SA2 9FG, SA2 9FH",355,312,43
W00004575,SA2,"SA2 8HE, SA2 8JL, SA2 8JN, SA2 8JR",237,211,26
W00004554,SA2,"SA2 8BN, SA2 8NP, SA2 8NS, SA2 8NT, SA2 8NU, SA2 8NW, SA2 8NX",376,348,28
W00004576,SA2,"SA2 0AX, SA2 0DL, SA2 8AF, SA2 8DT, SA2 8EB, SA2 8ED, SA2 8EE, SA2 8EF, SA2 8EH, SA2 8EQ, SA2 8ET, SA2 9DU, SA3 5AT, SA3 5AU",306,274,32
W00004578,SA2,"SA2 8NH, SA2 8NJ, SA2 8NL, SA2 8NN, SA2 8NY",268,261,7
W00004579,SA2,"SA2 8NZ, SA2 8PA, SA2 8PB, SA2 8PE",239,220,19
W00004580,SA2,"SA2 8AL, SA2 8AN, SA2 8AW, SA2 8BJ, SA2 8BL, SA2 8ND",266,237,29
W00004581,SA2,"SA2 8JH, SA2 8LX, SA2 8LY, SA2 8LZ, SA2 8NE, SA2 8NF, SA2 8NG, SA2 8NQ",262,228,34
W00004582,SA2,"SA2 8AA, SA2 8AB, SA2 8AE, SA2 8DH, SA2 8LT, SA2 8LU, SA2 9AT",314,269,45
W00004583,SA2,"SA2 8AH, SA2 8AS, SA2 8AT, SA2 8BB, SA2 8BQ",275,228,47
W00004577,SA2,"SA2 8DA, SA2 8LF, SA2 8LG, SA2 8LH, SA2 8LJ, SA2 8LL, SA2 8LQ, SA2 8LS",218,200,18
W00004555,SA2,"SA2 0FB, SA2 0FD, SA2 0UA, SA2 0UP, SA2 0YY, SA2 0ZN, SA2 0ZU, SA2 0ZW, SA2 9EB, SA2 9EE, SA2 9ER, SA2 9FA, SA2 9FD",270,242,28
W00004556,SA2,"SA2 0GH, SA2 0GN, SA2 0GP, SA2 9GR, SA2 9GU, SA2 9GW, SA2 9GX, SA2 9GZ",431,369,62
W00004557,SA2,"SA2 9EY, SA2 9GS, SA2 9GT, SA2 9HB, SA2 9HE, SA2 9HF, SA2 9HH, SA2 9HQ, SA2 9JY",291,257,34
W00004564,SA2,"SA2 9DL, SA2 9DN, SA2 9DZ, SA2 9ED, SA2 9EH, SA2 9HG",208,197,11
W00004563,SA2,"SA2 8HP, SA2 8HW, SA2 9AF, SA2 9AX, SA2 9AY, SA2 9BG, SA2 9GP, SA2 9HU, SA2 9HX, SA2 9HY",353,309,44
W00004562,SA2,"SA2 7AA, SA2 7AB, SA2 7AW, SA2 8JE, SA2 8JG, SA2 8NR",213,196,17
W00004561,SA2,"SA2 8JB, SA2 8JD, SA2 8JF, SA2 9JP, SA2 9JR, SA2 9JU, SA2 9JZ",180,167,13
W00004560,SA2,"SA2 0SB, SA2 0SN, SA2 0SP, SA2 0SR, SA2 0SS, SA2 0ST",324,273,51
W00004567,SA2,"SA2 8HX, SA2 8HY, SA2 8HZ, SA2 8JA",169,161,8
W00004568,SA2,"SA2 0UH, SA2 0UJ, SA2 9DE, SA2 9DF, SA2 9DG, SA2 9DJ, SA2 9GA",283,242,41
W00004569,SA2,"SA2 9AB, SA2 9AE, SA2 9BA, SA2 9BB, SA2 9BD, SA2 9BH, SA2 9BR, SA2 9BT",264,228,36
W00004570,SA2,"SA2 8HS, SA2 8JJ, SA2 8JP, SA2 8JQ, SA2 8JW",250,236,14
W00004571,SA2,"SA2 0SD, SA2 0SF, SA2 0SL, SA2 0SQ, SA2 0SU, SA2 0SX, SA2 9DA, SA2 9DB",336,274,62
W00004572,SA2,"SA2 9AA, SA2 9AD, SA2 9AG, SA2 9AH, SA2 9AJ, SA2 9AL, SA2 9AN, SA2 9AQ, SA2 9AW, SA2 9BU, SA2 9BX, SA2 9BZ, SA2 9DD, SA2 9FB",317,292,25
W00004573,SA2,"SA2 8BP, SA2 8BS, SA2 8BT, SA2 8HH, SA2 8HJ, SA2 8HL, SA2 8HN, SA2 8HQ",190,183,7
W00004599,SA2,"SA2 9DY, SA2 9JE, SA2 9LH, SA2 9LL, SA2 9LN, SA2 9LR, SA2 9LW, SA4 1ZU, SA4 9ZU",288,248,40
W00004559,SA2,"SA2 8HT, SA2 8HU, SA2 9FJ, SA2 9JJ, SA2 9JL, SA2 9JN, SA2 9LG",290,261,29
W00004558,SA2,"SA2 0TE, SA2 0UL, SA2 0UN, SA2 9DQ, SA2 9EF",303,264,39
W00004584,SA2,"SA2 7LP, SA2 8AJ, SA2 8BA, SA2 8BD, SA2 8BE, SA2 8BG, SA2 8BH, SA2 8NA, SA2 8NB",314,284,30
W00004586,SA2,"SA2 8AQ, SA2 8AU, SA2 8AX, SA2 8AY, SA2 8AZ, SA2 8DZ",308,251,57
W00004146,SA2,"SA2 7HH, SA2 7HJ, SA2 7HL, SA2 7HW",298,276,22
W00004597,SA2,"SA2 7LX, SA2 7LY, SA2 7LZ, SA2 7NB, SA2 7ND, SA2 7NE, SA2 7NF, SA2 7NG, SA2 7NH, SA2 7NJ, SA2 7NQ",277,248,29
W00004587,SA2,"SA2 8AG, SA2 8AR, SA2 8DP, SA2 8DR, SA2 8DU, SA2 8DX, SA2 8DY, SA2 8EA, SA2 8EG, SA2 8EU",351,292,59
W00004596,SA2,"SA2 7NA, SA2 9JS, SA2 9JT, SA2 9LJ, SA2 9LQ, SA2 9LU, SA2 9NF, SA2 9NH, SA2 9WA, SA2 9WB, SA2 9WD, SA2 9WF, SA2 9WG",348,307,41
W00004588,SA2,"SA2 8EJ, SA2 8EL, SA2 8EN, SA2 8EP, SA2 8ER, SA2 8ES, SA2 8EW",260,220,40
W00004589,SA2,"SA2 0GL, SA2 9HN, SA2 9HZ, SA2 9JW, SA2 9JX",233,204,29
W00004595,SA2,"SA2 9EJ, SA2 9EL, SA2 9EW, SA2 9EZ, SA2 9HA",270,238,32
W00004594,SA2,"SA2 9BN, SA2 9BW, SA2 9DH, SA2 9LP, SA2 9LS, SA2 9LT, SA2 9NE",255,229,26
W00004593,SA2,"SA2 9HD, SA2 9HJ, SA2 9HL, SA2 9HW, SA2 9LX, SA2 9NA, SA2 9NB, SA2 9ND",255,233,22
W00004592,SA2,"SA2 9LY, SA2 9LZ",224,191,33
W00004591,SA2,"SA2 9GY, SA2 9HP, SA2 9HR, SA2 9JD, SA2 9JF",250,214,36
W00004590,SA2,"SA2 9EN, SA2 9EP, SA2 9ES, SA2 9ET, SA2 9EU, SA2 9EX, SA2 9FL",465,403,62
W00004072,SA2,"SA2 0FJ, SA5 5BT, SA5 5BU, SA5 5BX, SA5 5BY, SA5 5BZ",276,243,33
W00003649,SA20,"SA20 0DA, SA20 0DH, SA20 0DN, SA20 0DP, SA20 0DW",223,145,78
W00003656,SA20,"SA20 0LE, SA20 0LF, SA20 0LG, SA20 0LN, SA20 0LT, SA20 0LU, SA20 0NA, SA20 0NG, SA20 0NL, SA20 0NN, SA20 0NP, SA20 0NR, SA20 0NS, SA20 0NW, SA20 0NY, SA20 0PA, SA20 0PB, SA20 0PD, SA20 0PF, SA20 0PG, SA20 0UB, SA20 0UG, SA20 0UH, SA20 0UL, SA20 0UN, SA20 0UP, SA20 0UR, SA20 0UW, SA20 0YL, SA20 0YW",321,230,91
W00003647,SA20,"SA20 0AL, SA20 0BE, SA20 0BG, SA20 0BR, SA20 0DR, SA20 0DU, SA20 0DY, SA20 0EG, SA20 0EH, SA20 0EL, SA20 0EN, SA20 0EP, SA20 0ER, SA20 0HA, SA20 0HB, SA20 0HD, SA20 0HS, SA20 0HU, SA20 0LA, SA20 0LB, SA20 0TT, SA20 0YF",295,159,136
W00003648,SA20,"SA20 0AG, SA20 0AP, SA20 0AR, SA20 0AT, SA20 0AU, SA20 0AY, SA20 0AZ, SA20 0BL, SA20 0DJ, SA20 0DS, SA20 0DX, SA20 0JT, SA20 0JU, SA20 0JX, SA20 0LJ, SA20 0LQ, SA20 0LX, SA20 0PR, SA20 0RB, SA20 0RD",221,136,85
W00003478,SA20,"SA20 0FA, SA20 0NT, SA20 0NU, SA20 0PE, SA20 0PH, SA20 0PL, SA20 0PN, SA20 0PW, SA20 0SS, SA20 0ST, SA20 0SU, SA20 0SY, SA20 0TF, SA20 0TG, SA20 0TH, SA20 0TL, SA20 0UE, SA20 0UF",192,119,73
W00003650,SA20,"SA20 0DQ, SA20 0EA, SA20 0EB, SA20 0ED, SA20 0EE, SA20 0FG, SA20 0HY, SA20 0JW, SA20 0YE",350,203,147
W00003651,SA20,"SA20 0AA, SA20 0AB, SA20 0AD, SA20 0AE, SA20 0AF, SA20 0AH, SA20 0AN, SA20 0AW, SA20 0BN, SA20 0BS, SA20 0BX, SA20 0BZ, SA20 0JP, SA20 0JR, SA20 0JS, SA20 0NF, SA20 0PT, SA20 0YD, SA20 0YH",183,134,49
W00003655,SA20,"SA20 0AJ, SA20 0AQ, SA20 0AX, SA20 0LD, SA20 0LH, SA20 0LL, SA20 0LP, SA20 0LR, SA20 0LS, SA20 0LW, SA20 0LY, SA20 0NB, SA20 0NH, SA20 0RG, SA20 0RH, SA20 0RL, SA20 0RN, SA20 0RP, SA20 0RR, SA20 0RS, SA20 0RT, SA20 0RW, SA20 0SA, SA20 0SB, SA20 0SD, SA20 0SE, SA20 0YN, SA20 0YP, SA20 0YR, SA20 0YS, SA20 0YT, SA20 0YU, SA20 0YY",276,169,107
W00003654,SA20,"SA20 0DE, SA20 0DF, SA20 0DL, SA20 0RA, SA20 0RE, SA20 0RF, SA20 0TY, SA20 0US, SA20 0UT, SA20 0UU, SA20 0WA, SA20 0YG, SA20 0YQ, SA20 0YX, SA20 0ZD",229,155,74
W00003652,SA20,"SA20 0AS, SA20 0BA, SA20 0BB, SA20 0BD, SA20 0BH, SA20 0BJ, SA20 0BP, SA20 0BQ, SA20 0BW, SA20 0DT",227,123,104
W00003653,SA20,"SA20 0BT, SA20 0BU, SA20 0BY, SA20 0DB, SA20 0DD, SA20 0DG, SA20 0EF, SA20 0GA, SA20 0PU, SA20 0PY, SA20 0WD, SA20 0WY, SA20 0WZ, SA20 0YA, SA20 0YB, SA20 0YJ, SA20 0YZ, SA20 0ZA, SA20 0ZF, SA20 0ZH, SA20 0ZW, SA20 9AA, SA20 9AB",224,145,79
W00004696,SA3,"SA3 5PR, SA3 5PS, SA3 5PT, SA3 5QD, SA3 5QF, SA3 5QP, SA3 5QR, SA3 5TS, SA3 5UA",228,212,16
W00004695,SA3,"SA3 5PU, SA3 5PY, SA3 5PZ, SA3 5QA, SA3 5TT, SA3 5TU",223,185,38
W00004414,SA3,"SA3 4AP, SA3 4ER, SA3 4LP, SA3 4LR, SA3 4LS, SA3 4LU, SA3 4LY, SA3 4NA, SA3 4NB, SA3 4NP, SA3 4NS, SA3 4PJ, SA3 4XD, SA3 4XE, SA3 4XF, SA3 4XG, SA3 4XH, SA3 4XW, SA3 4XY, SA3 4XZ, SA3 4YB, SA3 4YD, SA3 4YH, SA3 4YS, SA3 4YX, SA3 4YY, SA3 4YZ, SA3 4ZD, SA3 4ZG, SA3 4ZL, SA3 4ZN, SA3 4ZP, SA3 4ZW",266,229,37
W00004694,SA3,"SA3 4XL, SA3 4XN, SA3 4XP, SA3 4XS, SA3 4YA, SA3 4YE, SA3 4YG, SA3 4YN, SA3 4YQ, SA3 4YT, SA3 5PX, SA3 5QB, SA3 5TX, SA3 5TZ",245,201,44
W00004693,SA3,"SA3 5BQ, SA3 5NG, SA3 5NP, SA3 5NS, SA3 5PA, SA3 5QN, SA3 5RD, SA3 5RE, SA3 5RF, SA3 5RH, SA3 5RN, SA3 5RW, SA3 5RY",389,332,57
W00003954,SA3,"SA3 3BU, SA3 3DA, SA3 3DB, SA3 3DD, SA3 3DN, SA3 3DR, SA3 3DW, SA3 3HJ",300,274,26
W00004692,SA3,"SA3 5QE, SA3 5QJ, SA3 5QL, SA3 5QQ",282,236,46
W00004691,SA3,"SA3 5ET, SA3 5EU, SA3 5EY, SA3 5LU, SA3 5LY",270,231,39
W00004690,SA3,"SA3 3JA, SA3 5NL, SA3 5NR, SA3 5PB",221,198,23
W00004689,SA3,"SA3 5AB, SA3 5ES, SA3 5JD, SA3 5JF, SA3 5LQ, SA3 5LS",333,293,40
W00004688,SA3,"SA3 5LX, SA3 5NA, SA3 5NB, SA3 5ND, SA3 5NY",243,222,21
W00004687,SA3,"SA3 5NQ, SA3 5NT, SA3 5NU, SA3 5PD, SA3 5PE, SA3 5PQ",201,186,15
W00004686,SA3,"SA3 4TJ, SA3 4TL, SA3 4TW, SA3 4UT, SA3 4UZ, SA3 5RP, SA3 5RR, SA3 5RS, SA3 5RT",274,247,27
W00004685,SA3,"SA3 5RA, SA3 5RB, SA3 5RG, SA3 5RJ, SA3 5RL, SA3 5RQ",239,215,24
W00004315,SA3,"SA3 5DL, SA3 5DX, SA3 5DZ, SA3 5HR, SA3 5HS",295,266,29
W00004426,SA3,"SA3 1WA, SA3 1WZ, SA3 1YA, SA3 1YB, SA3 1YD, SA3 1YE, SA3 1YH, SA3 1YN, SA3 1YX, SA3 1ZB, SA3 1ZH, SA3 2WA, SA3 2WU, SA3 2WW, SA3 2WX, SA3 2WY, SA3 2WZ, SA3 2YA, SA3 2YB, SA3 2YD, SA3 2ZX, SA3 3WT, SA3 3WU, SA3 3WX, SA3 3WY, SA3 3WZ, SA3 3YD, SA3 3YE, SA3 3YF, SA3 3YG, SA3 3YL, SA3 4AA, SA3 4AB, SA3 4AF, SA3 4DA, SA3 4DB, SA3 4DH, SA3 4DJ, SA3 4DW, SA3 4LE, SA3 4LG, SA3 4PZ, SA3 4SH, SA3 4WA, SA3 4WJ, SA3 4WN, SA3 4WP, SA3 4WQ, SA3 4WR, SA3 4WS, SA3 4WT, SA3 4WU, SA3 4WW, SA3 4WY, SA3 4WZ, SA3 4XB, SA3 4XQ, SA3 4XT, SA3 4XU, SA3 4YF, SA3 4YJ, SA3 4YP, SA3 4YR, SA3 4ZA, SA3 4ZB, SA3 4ZE, SA3 4ZF, SA3 4ZH, SA3 4ZJ, SA3 4ZQ, SA3 4ZR, SA3 4ZT, SA3 4ZU, SA3 5WJ, SA3 5WL, SA3 5WQ, SA3 5WS, SA3 5WT, SA3 5WU, SA3 5WW, SA3 5WX, SA3 5WY, SA3 5WZ, SA3 5XJ, SA3 5XL, SA3 5XN, SA3 5XP, SA3 5XQ, SA3 5XR, SA3 5XS, SA3 5XT, SA3 5XU, SA3 5XX, SA3 5XY, SA3 5XZ, SA3 5YA, SA3 5YB, SA3 5YD, SA3 5YE, SA3 5YF, SA3 5YG, SA3 5YH, SA3 5YJ, SA3 5YL, SA3 5YQ, SA3 5YR, SA3 5YS, SA3 5YT, SA3 5YU, SA3 5YW, SA3 5YX, SA3 5YY, SA3 5ZX, SA3 9AA, SA3 9AB, SA3 9AD, SA3 9AF, SA3 9AG, SA3 9AH, SA3 9AJ, SA3 9AL, SA3 9AN, SA3 9AP, SA3 9AQ, SA3 9AR, SA3 9AS, SA3 9AT, SA3 9AY, SA3 9AZ, SA4 1WP, SA4 1WR, SA4 1WS, SA4 1WT, SA4 1WW, SA4 1WY, SA4 1YE, SA4 1YZ, SA4 1ZD, SA4 1ZF, SA4 1ZX, SA4 3WD, SA4 3WJ, SA4 3WP, SA4 3WQ, SA4 3WS, SA4 3WT, SA4 3WU, SA4 3WW, SA4 4XR, SA4 4ZJ, SA4 4ZL, SA4 4ZP, SA4 4ZR, SA4 4ZS, SA4 4ZU, SA4 6ZF, SA4 9WY",143,134,9
W00004314,SA3,"SA3 5AR, SA3 5DY, SA3 5EA, SA3 5EB, SA3 5ED, SA3 5EE, SA3 5EF, SA3 5EJ, SA3 5EQ",263,231,32
W00004698,SA3,"SA3 4TN, SA3 4TP, SA3 4TY, SA3 4UU, SA3 4UW, SA3 4UY, SA3 4WD",261,235,26
W00004312,SA3,"SA3 5AS, SA3 5AW, SA3 5BL, SA3 5BS, SA3 5BT, SA3 5BU, SA3 5BX",260,213,47
W00004160,SA3,"SA3 2EH, SA3 2EJ, SA3 2EL, SA3 2EQ",147,132,15
W00004162,SA3,"SA3 1BT, SA3 1BU, SA3 1BX, SA3 1BY, SA3 1DA, SA3 1DB, SA3 1DE, SA3 1DF, SA3 1DH, SA3 1DJ, SA3 1DL, SA3 1DN, SA3 1DP, SA3 1DQ, SA3 1DR, SA3 1DS, SA3 1DT, SA3 1HD, SA3 1HE, SA3 1JN, SA3 1JS",332,289,43
W00004163,SA3,"SA3 1AH, SA3 1HQ, SA3 1HR, SA3 1HS, SA3 1HT, SA3 1HU, SA3 1HW, SA3 1HX, SA3 1HY, SA3 1HZ, SA3 1JA, SA3 1JB, SA3 1JD, SA3 1JE, SA3 1JH, SA3 1JJ, SA3 1JL, SA3 1JP, SA3 1JQ, SA3 1JR, SA3 1JT",446,408,38
W00004164,SA3,"SA3 1AW, SA3 1EE, SA3 1EH, SA3 1EJ, SA3 1EL, SA3 1EN, SA3 1EP, SA3 1EQ",245,215,30
W00004485,SA3,"SA3 1WY, SA4 0WT, SA4 0WY, SA4 0WZ, SA4 0YG, SA4 0ZD, SA4 0ZR, SA4 1AB, SA4 1AD, SA4 1AE, SA4 1BD, SA4 1BE, SA4 1DF, SA4 1GE, SA4 1GF, SA4 1GG, SA4 1GJ, SA4 1GL, SA4 1GQ, SA4 1GW, SA4 1GY, SA4 1GZ, SA4 1HN, SA4 1WF, SA4 1WG, SA4 2DX, SA4 3WA, SA4 3WB, SA4 3WE, SA4 3WF, SA4 3WG, SA4 3WH, SA4 3WL, SA4 3WN, SA4 3WR, SA4 3WX, SA4 3WY, SA4 3WZ, SA4 3YB, SA4 3YT, SA4 3ZA, SA4 3ZQ, SA4 3ZU, SA4 3ZW, SA4 4DX, SA4 4UG, SA4 4UH, SA4 4UQ, SA4 4WS, SA4 4WT, SA4 4WU, SA4 4WY, SA4 4WZ, SA4 4XX, SA4 4ZH, SA4 4ZT, SA4 4ZW, SA4 4ZX, SA4 5AA, SA4 5AB, SA4 5AF, SA4 5AL, SA4 5AN, SA4 5AP, SA4 5AT, SA4 5AU, SA4 5AW, SA4 5AX, SA4 5AY, SA4 5AZ, SA4 5BA, SA4 5BB, SA4 5BD, SA4 5BE, SA4 5BF, SA4 5BG, SA4 5BH, SA4 5BJ, SA4 5BL, SA4 5BN, SA4 5BP, SA4 5BQ, SA4 5BR, SA4 5BS, SA4 5BT, SA4 5BU, SA4 5BW, SA4 5BX, SA4 5BY, SA4 5BZ, SA4 5DA, SA4 5DB, SA4 5DD, SA4 5DE, SA4 5DF, SA4 5DG, SA4 5DH, SA4 5DJ, SA4 5DL, SA4 5DN, SA4 5DP, SA4 5DR, SA4 5DS, SA4 5DT, SA4 6WA, SA4 6WW, SA4 6WX, SA4 6WY, SA4 6WZ, SA4 6YA, SA4 6YD, SA4 6YQ, SA4 6YU, SA4 8WE, SA4 8WF, SA4 8WN, SA4 8WP, SA4 8WR, SA4 8WT, SA4 8ZF, SA4 8ZH, SA4 9AB, SA4 9AD, SA4 9AE, SA4 9BD, SA4 9BE, SA4 9DF, SA4 9DX, SA4 9GE, SA4 9GG, SA4 9GL, SA4 9GQ, SA4 9GW, SA4 9GZ, SA4 9HN, SA4 9RU, SA4 9SA, SA4 9WA, SA4 9WF, SA4 9WG, SA4 9WL, SA4 9WN, SA4 9WT, SA4 9WU, SA4 9WX, SA4 9WZ, SA4 9XA, SA4 9XQ, SA4 9XS, SA4 9XT, SA4 9XW, SA4 9XY, SA4 9YU",322,276,46
W00004428,SA3,"SA3 4BE, SA3 4BJ, SA3 4BN, SA3 4LX, SA3 4ND, SA3 4NE, SA3 4NG, SA3 4QU",213,193,20
W00004427,SA3,"SA3 4AN, SA3 4AW, SA3 4BB, SA3 4BD, SA3 4BG, SA3 4BL, SA3 4BQ, SA3 4NH, SA3 4NQ",249,229,20
W00003947,SA3,"SA3 3AP, SA3 3AT, SA3 3AU, SA3 3JH, SA3 3JJ, SA3 3JL",242,199,43
W00003948,SA3,"SA3 3EN, SA3 3EP, SA3 3ER, SA3 3ES, SA3 3EW, SA3 3EZ",268,239,29
W00003949,SA3,"SA3 3AR, SA3 3BB, SA3 3DJ",208,187,21
W00003950,SA3,"SA3 3AG, SA3 3AH, SA3 3AL, SA3 3AN, SA3 3AS",220,212,8
W00004307,SA3,"SA3 5AX, SA3 5AY, SA3 5AZ, SA3 5BA, SA3 5BB, SA3 5BD, SA3 5BE, SA3 5BG, SA3 5BH, SA3 5BW, SA3 5BY, SA3 5BZ, SA3 5DF, SA3 5DH, SA3 5DR, SA3 5HE, SA3 5HH, SA3 5HQ, SA3 5HU",391,360,31
W00004313,SA3,"SA3 5DP, SA3 5DS, SA3 5DT, SA3 5DU, SA3 5EL",282,250,32
W00004308,SA3,"SA3 5HF, SA3 5HG, SA3 5HJ, SA3 5HL, SA3 5HN, SA3 5HP, SA3 5HT",279,242,37
W00003951,SA3,"SA3 3DG, SA3 3DQ, SA3 3JW, SA3 3JZ",273,243,30
W00003952,SA3,"SA3 3AJ, SA3 3AX, SA3 3AY, SA3 3AZ, SA3 3BA, SA3 3DH",230,210,20
W00003953,SA3,"SA3 3DE, SA3 3DF, SA3 3DL, SA3 3DY, SA3 3ET, SA3 3EY, SA3 3HL, SA3 3YB",310,292,18
W00004705,SA3,"SA3 5AA, SA3 5DA, SA3 5LT, SA3 5NF, SA3 5SW, SA3 5TB, SA3 5TJ, SA3 5TL, SA3 5TN, SA3 5TP, SA3 5TR, SA3 5TW, SA3 5UB",349,318,31
W00004704,SA3,"SA3 5NW, SA3 5NX, SA3 5PF",232,213,19
W00004702,SA3,"SA3 5JP, SA3 5JT, SA3 5JU, SA3 5JX",240,221,19
W00004701,SA3,"SA3 5AD, SA3 5AG, SA3 5AH, SA3 5AJ, SA3 5AL, SA3 5AQ, SA3 5LJ, SA3 5LN",221,191,30
W00004700,SA3,"SA3 5JH, SA3 5JJ, SA3 5JN, SA3 5LL, SA3 5LP, SA3 5LW",207,186,21
W00004699,SA3,"SA3 5GZ, SA3 5HA, SA3 5HB, SA3 5HD, SA3 5NH, SA3 5PH",259,237,22
W00004697,SA3,"SA3 5TF, SA3 5TG, SA3 5TH, SA3 5TQ, SA3 5TY",205,183,22
W00004310,SA3,"SA3 5DJ, SA3 5DN, SA3 5DW, SA3 5HW, SA3 5JL, SA3 5JR, SA3 5JS",261,224,37
W00004311,SA3,"SA3 5AE, SA3 5AF, SA3 5AN, SA3 5AP, SA3 5BJ, SA3 5BN, SA3 5BP, SA3 5BR, SA3 5DQ",231,203,28
W00004309,SA3,"SA3 5DB, SA3 5DD, SA3 5DE, SA3 5DG",262,222,40
W00004684,SA3,"SA3 5EX, SA3 5EZ, SA3 5JY, SA3 5JZ, SA3 5LD, SA3 5LZ, SA3 5NE, SA3 5NN, SA3 5XW, SA3 5YP, SA3 5YZ",294,255,39
W00004413,SA3,"SA3 4HG, SA3 4HR, SA3 4JE, SA3 4JH, SA3 4JJ, SA3 4JL, SA3 4JQ, SA3 4JW, SA3 4JY, SA3 4LB",268,223,45
W00004166,SA3,"SA3 1AJ, SA3 1AL, SA3 1LA, SA3 1LB, SA3 1LD, SA3 1LE, SA3 1LH, SA3 1LJ, SA3 1LL, SA3 1LN, SA3 1LP, SA3 1LQ, SA3 1LR, SA3 1LS, SA3 1LT, SA3 1LU, SA3 1LW, SA3 1LX, SA3 1LY, SA3 1NA, SA3 1NB, SA3 1ND",351,329,22
W00004492,SA3,"SA3 3JG, SA3 3JU, SA3 3JX, SA3 3JY, SA3 3LA",233,202,31
W00004491,SA3,"SA3 3LB, SA3 3LD, SA3 3LE",197,179,18
W00004409,SA3,"SA3 4SB, SA3 4SD, SA3 4UL, SA3 4UN",284,250,34
W00003958,SA3,"SA3 3EH, SA3 3EJ, SA3 3EL, SA3 3JB, SA3 3JN, SA3 3JP, SA3 3JR, SA3 3JS, SA3 3JT",428,384,44
W00004415,SA3,"SA3 4LL, SA3 4PE, SA3 4PG, SA3 4PH",223,191,32
W00004489,SA3,"SA3 2AP, SA3 2AS, SA3 2AW, SA3 2DA, SA3 2DB, SA3 2DH, SA3 2DJ",294,268,26
W00004488,SA3,"SA3 2AN, SA3 2BZ, SA3 2DD, SA3 2DE, SA3 2DQ",278,243,35
W00004416,SA3,"SA3 4AE, SA3 4AH, SA3 4AJ, SA3 4AL, SA3 4AQ",215,178,37
W00004493,SA3,"SA3 2BJ, SA3 2BL, SA3 2BN, SA3 2BR, SA3 2BS",326,288,38
W00004417,SA3,"SA3 4AD, SA3 4DD, SA3 4LF, SA3 4LH, SA3 4LJ, SA3 4LQ",185,169,16
W00004407,SA3,"SA3 4RR, SA3 4RX, SA3 4RZ, SA3 4SA, SA3 4SE, SA3 4SG, SA3 4UJ",253,218,35
W00004406,SA3,"SA3 4BP, SA3 4BS, SA3 4RL, SA3 4RN, SA3 4RP, SA3 4RS, SA3 4RU",367,339,28
W00004405,SA3,"SA3 3AA, SA3 4RG, SA3 4TR, SA3 4TS, SA3 4TT, SA3 4TU, SA3 4TX, SA3 4TZ, SA3 4UA, SA3 4UX",439,388,51
W00004404,SA3,"SA3 3BN, SA3 3BP, SA3 3BR, SA3 4LA, SA3 4RE, SA3 4RF, SA3 4RH, SA3 4RJ, SA3 4RQ, SA3 4RT, SA3 4RW",215,178,37
W00004403,SA3,"SA3 4LT, SA3 4QB, SA3 4QD, SA3 4QE, SA3 4QS, SA3 4SS, SA3 4SU",302,263,39
W00004402,SA3,"SA3 4SN, SA3 4SP, SA3 4SR, SA3 4ST, SA3 4SW, SA3 4TG, SA3 4UD, SA3 4US",301,266,35
W00004487,SA3,"SA3 2AL, SA3 2BT, SA3 2BW, SA3 2DF, SA3 2EN, SA3 2EP, SA3 2ER, SA3 2EW",263,235,28
W00003957,SA3,"SA3 3AQ, SA3 3BS, SA3 3BT, SA3 3BX, SA3 4RY",122,108,14
W00004418,SA3,"SA3 4AR, SA3 4AS, SA3 4AT, SA3 4AU, SA3 4AX, SA3 4BT, SA3 4BU, SA3 4BX, SA3 4BY, SA3 4DL, SA3 4DN, SA3 4DP, SA3 4DQ, SA3 4DR, SA3 4DS, SA3 4DX",205,173,32
W00004410,SA3,"SA3 4QR, SA3 4QT, SA3 4RB, SA3 4RD, SA3 4SF, SA3 4SJ, SA3 4SQ, SA3 4SY, SA3 4SZ",202,180,22
W00004408,SA3,"SA3 4UB, SA3 4UE, SA3 4UF, SA3 4UG, SA3 4UH, SA3 4UP, SA3 4UQ, SA3 4UR",444,408,36
W00004495,SA3,"SA3 2BP, SA3 2DN, SA3 2DP, SA3 2DR, SA3 2DW",352,321,31
W00004683,SA3,"SA3 5JE, SA3 5JG, SA3 5LF, SA3 5LG, SA3 5LR",248,223,25
W00004412,SA3,"SA3 4NY, SA3 4QA, SA3 4QH, SA3 4QJ, SA3 4QL, SA3 4QN, SA3 4QP, SA3 4QQ, SA3 4QW, SA3 4QY, SA3 4QZ, SA3 4TH",217,189,28
W00003955,SA3,"SA3 3GA, SA3 3HB, SA3 3HD, SA3 3HE, SA3 3HF, SA3 3HH, SA3 3HW",253,218,35
W00004682,SA3,"SA3 5JW, SA3 5LA, SA3 5LB, SA3 5LE, SA3 5LH",282,263,19
W00004494,SA3,"SA3 2AD, SA3 2AE, SA3 2AH, SA3 2AJ, SA3 2AQ, SA3 2BU, SA3 2BX, SA3 2BY, SA3 2DX",402,352,50
W00004168,SA3,"SA3 1AR, SA3 1AS, SA3 1AT, SA3 1AU, SA3 1AX, SA3 1AY, SA3 1AZ, SA3 1BA, SA3 1BB, SA3 1BD, SA3 1BE, SA3 1BH, SA3 1BJ, SA3 1BQ, SA3 1DD, SA3 1NJ, SA3 1NS, SA3 1NT, SA3 1NU, SA3 1PD",383,365,18
W00004169,SA3,"SA3 1AA, SA3 1AB, SA3 1AD, SA3 1AE, SA3 1AF, SA3 1AG, SA3 1AN, SA3 1AP, SA3 1AQ, SA3 1BL, SA3 1BR, SA3 1BS, SA3 1BZ, SA3 1HN, SA3 1HP",408,363,45
W00004170,SA3,"SA3 1PE, SA3 1PH, SA3 1PJ, SA3 1PL, SA3 1PN, SA3 1PP, SA3 1PQ, SA3 1PR, SA3 1PT",214,193,21
W00004167,SA3,"SA3 1NL, SA3 1NN, SA3 1NP, SA3 1NQ, SA3 1NR, SA3 1NX, SA3 1NY, SA3 1NZ",212,188,24
W00004424,SA3,"SA3 4HH, SA3 4HS, SA3 4HT, SA3 4HU, SA3 4HX, SA3 4HY, SA3 4JB, SA3 4JD, SA3 4LD, SA3 4LZ",231,207,24
W00003956,SA3,"SA3 3DP, SA3 3DS, SA3 3DT, SA3 3DU, SA3 3DX, SA3 3EU, SA3 3EX, SA3 3HA, SA3 3HG",317,266,51
W00004425,SA3,"SA3 4AY, SA3 4BA, SA3 4BH, SA3 4SL, SA3 5SU, SA3 5SX, SA3 5SY, SA3 5SZ, SA3 5TA, SA3 5TD, SA3 5TE",275,250,25
W00004419,SA3,"SA3 4EH, SA3 4EJ, SA3 4EL, SA3 4EN, SA3 4EP, SA3 4EQ, SA3 4EX, SA3 4HW, SA3 4HZ, SA3 4JF, SA3 4JG, SA3 4JN, SA3 4JP, SA3 4JR, SA3 4JS, SA3 4JT, SA3 4JU, SA3 4JX, SA3 4JZ",208,196,12
W00004420,SA3,"SA3 4DY, SA3 4DZ, SA3 4EA, SA3 4EB, SA3 4ED, SA3 4EE, SA3 4EF, SA3 4EG, SA3 4ES, SA3 4HA, SA3 4HB, SA3 4HE",235,205,30
W00004411,SA3,"SA3 4AZ, SA3 4QF, SA3 4QG, SA3 4QX, SA3 4RA, SA3 4SX, SA3 4TA, SA3 4TB, SA3 4TD, SA3 4TE, SA3 4TF, SA3 4TQ",387,336,51
W00004422,SA3,"SA3 4NT, SA3 4NU, SA3 4NX, SA3 4PA, SA3 4PD, SA3 4PF, SA3 4PL, SA3 4PN, SA3 4PP, SA3 4PQ, SA3 4PR",267,230,37
W00004423,SA3,"SA3 4HJ, SA3 4HL, SA3 4HN, SA3 4HP, SA3 4HQ, SA3 4JA, SA3 4PB, SA3 4PS, SA3 4PW",261,217,44
W00004421,SA3,"SA3 4BZ, SA3 4DE, SA3 4DF, SA3 4DT, SA3 4DU, SA3 4EU, SA3 4EW, SA3 4EY, SA3 4HD, SA3 4HF, SA3 4LN, SA3 4LW",261,220,41
W00003454,SA31,"SA31 3NN, SA31 3NP, SA31 3NU, SA31 3PA, SA31 3PD, SA31 3PE, SA31 3PF, SA31 3PG, SA31 3PQ",286,150,136
W00003455,SA31,"SA31 1NN, SA31 1NR, SA31 1NS, SA31 1NT, SA31 1NW, SA31 1NZ, SA31 2EN, SA31 2EY, SA31 2HF, SA31 2HH, SA31 2HQ, SA31 2HU",299,170,129
W00003453,SA31,"SA31 3HZ, SA31 3NB, SA31 3ND, SA31 3NE, SA31 3QQ, SA31 3QX, SA31 3QY, SA31 3QZ, SA31 3RA, SA31 3RD, SA31 3RE, SA31 3RF, SA31 3RH, SA31 3RJ, SA31 3RL, SA31 3RN, SA31 3RY, SA31 3RZ, SA31 3SA, SA33 5DP, SA33 5ES",248,145,103
W00003456,SA31,"SA31 3FE, SA31 3HG, SA31 3LP, SA31 3LS, SA31 3PX, SA31 3PY, SA31 3PZ, SA31 3QB, SA31 3YJ, SA31 3YL, SA31 3YP",283,209,74
W00003457,SA31,"SA31 3EZ, SA31 3HE, SA31 3HF, SA31 3HH, SA31 3HN, SA31 3HQ, SA31 3HX, SA31 3JU, SA31 3NA, SA31 3RQ",502,363,139
W00003458,SA31,"SA31 3BR, SA31 3BW, SA31 3FB, SA31 3QN, SA31 3QS, SA31 3QW, SA31 3RG, SA31 3RP, SA31 3RR, SA31 3RS, SA31 3RT, SA31 3SG, SA31 3XG, SA31 3XH, SA31 3XU, SA31 3YD, SA31 3YE, SA31 3YS, SA33 5DR, SA33 5DS, SA33 5ER",508,293,215
W00003459,SA31,"SA31 3DA, SA31 3FA, SA31 3FD, SA31 3HD, SA31 3SB, SA31 3SD, SA31 3SE",393,231,162
W00003460,SA31,"SA31 3BL, SA31 3EN, SA31 3ER, SA31 3ES, SA31 3EX, SA31 3EY",297,175,122
W00003463,SA31,"SA31 1RL, SA31 3BA, SA31 3DL, SA31 3DN, SA31 3DS, SA31 3DT, SA31 3EE, SA31 3JG, SA31 3JH",298,161,137
W00003452,SA31,"SA31 3AF, SA31 3GA, SA31 3HP, SA31 3HR, SA31 3HS, SA31 3HU, SA31 3HW, SA31 3JB, SA31 3RB, SA31 3RU, SA31 3RW, SA31 3RX",291,179,112
W00003451,SA31,"SA31 1BJ, SA31 1PP, SA31 1PY, SA31 3AA, SA31 3AD, SA31 3AE, SA31 3AG, SA31 3AH, SA31 3AJ, SA31 3AL, SA31 3AN, SA31 3AP, SA31 3AQ, SA31 3AR, SA31 3AT, SA31 3AW, SA31 3AX, SA31 3AY, SA31 3BD, SA31 3BE, SA31 3BG, SA31 3BH, SA31 3BN, SA31 3BQ, SA31 3DG, SA31 3FF, SA31 3JT, SA31 3JX, SA31 3JY, SA31 3JZ, SA31 3LA, SA31 3LB, SA31 3LD, SA31 3LF, SA31 3LG, SA31 3LL",291,218,73
W00003464,SA31,"SA31 3EF, SA31 3EH, SA31 3QE",251,187,64
W00003727,SA31,"SA31 2DY, SA31 2EA, SA31 2NP",187,91,96
W00003466,SA31,"SA31 1RH, SA31 1RW, SA31 3DY, SA31 3EL, SA31 3EU, SA31 3EW, SA31 3JD, SA31 3JE",235,183,52
W00003467,SA31,"SA31 3BZ, SA31 3DD, SA31 3DH, SA31 3QF, SA31 3QG",299,229,70
W00003468,SA31,"SA31 3AZ, SA31 3BX, SA31 3BY, SA31 3DE, SA31 3DF, SA31 3DJ, SA31 3DQ",323,211,112
W00003469,SA31,"SA31 3BS, SA31 3BU, SA31 3DB, SA31 3PP, SA31 3PR, SA31 3PS, SA31 3PT",284,211,73
W00003730,SA31,"SA31 2LH, SA31 2LQ, SA31 2NE, SA31 2NL",230,126,104
W00003729,SA31,"SA31 2HR, SA31 2HX, SA31 2HY, SA31 2LS, SA31 2PG, SA31 2PH, SA31 2YL, SA31 2YS, SA31 2YT, SA32 8AA, SA32 8AB, SA32 8AF, SA32 8AQ, SA32 8AT, SA32 8BE, SA32 8BG, SA32 8EE, SA32 8EL, SA32 8EN, SA32 8EP, SA32 8ER, SA32 8ES, SA32 8ET, SA32 8EU, SA32 8EW, SA32 8EX, SA32 8EY, SA32 8HA, SA32 8HB, SA32 8HD, SA32 8HE, SA32 8HF",542,282,260
W00003728,SA31,"SA31 2HS, SA31 2HT, SA31 2NR, SA31 2NS, SA31 2NU, SA31 2NY, SA31 2NZ, SA31 2PA, SA31 2PB, SA31 2PD",268,140,128
W00010688,SA31,"SA31 1SH, SA31 1TW, SA31 3GB, SA31 3GL, SA31 3GR, SA31 3GU, SA31 3JJ",332,192,140
W00003945,SA31,"SA31 1EN, SA34 0NG, SA34 0QF, SA34 0QG, SA34 0QH, SA34 0QJ, SA34 0QP, SA34 0QQ, SA34 0QS, SA34 0QT, SA34 0QU",258,157,101
W00003450,SA31,"SA31 1AA, SA31 1AB, SA31 1AD, SA31 1AE, SA31 1AL, SA31 1AN, SA31 1AP, SA31 1AQ, SA31 1AR, SA31 1AT, SA31 1AU, SA31 1AY, SA31 1AZ, SA31 1BA, SA31 1BB, SA31 1BD, SA31 1BE, SA31 1BH, SA31 1BL, SA31 1BN, SA31 1BP, SA31 1BQ, SA31 1BT, SA31 1BW, SA31 1BZ, SA31 1GS, SA31 1JN, SA31 1JP, SA31 1JR, SA31 1JS, SA31 1JT, SA31 1JW, SA31 1JX, SA31 1JY, SA31 1JZ, SA31 1LA, SA31 1LB, SA31 1LE, SA31 1LF, SA31 1LG, SA31 1LJ, SA31 1LL, SA31 1LP, SA31 1LW, SA31 1LY, SA31 1PG, SA31 1PH, SA31 1PJ, SA31 1PL, SA31 1PN, SA31 1PQ, SA31 1PR, SA31 1PW, SA31 1QB, SA31 1QD, SA31 1RA, SA31 1RS, SA31 1SR, SA31 1TN, SA31 1ZD, SA31 3JP, SA31 3JR, SA31 3JS, SA31 3LE, SA31 3LH, SA31 3LJ, SA31 3LN, SA31 3LW, SA31 9SA, SA31 9SB",273,189,84
W00003726,SA31,"SA31 1DT, SA31 1WA, SA31 1WR, SA31 1WS, SA31 1WT, SA31 1XZ, SA31 1YA, SA31 1YB, SA31 1YD, SA31 1YF, SA31 1YH, SA31 1YS, SA31 1YT, SA31 1YU, SA31 1YW, SA31 1ZB, SA31 2BA, SA31 2BD, SA31 2BE, SA31 2BG, SA31 2BJ, SA31 2BL, SA31 2BN, SA31 2BP, SA31 2BQ, SA31 2BR, SA31 2BS, SA31 2BT, SA31 2BU, SA31 2BW, SA31 2BX, SA31 2BY, SA31 2DD, SA31 2DH, SA31 2DJ, SA31 2DL, SA31 2DN, SA31 2JY, SA31 2JZ, SA31 2LG, SA31 2LJ, SA31 2LL, SA31 2NF, SA31 2NG, SA31 2NH, SA31 2NJ, SA31 2NN, SA31 2NQ, SA31 2NT, SA31 2NW, SA31 2PF, SA31 2PJ, SA31 2PL, SA31 2PQ, SA31 2WX, SA31 2WY, SA31 2WZ, SA31 2YA, SA31 2YB, SA31 2YG, SA31 2YN, SA31 2YP, SA31 2YQ, SA31 2YR, SA31 2YU, SA31 2YY, SA31 2ZB, SA31 2ZR, SA31 2ZW, SA31 3AU, SA31 3WR, SA31 3WX, SA31 3WY, SA31 3XA, SA31 3XB, SA31 3XP, SA31 3YA, SA31 3YB, SA31 3YF, SA31 3YG, SA31 3YH, SA31 3YN, SA31 3YQ, SA31 3YR, SA31 3YT, SA31 3YU, SA31 3YX, SA31 3ZB, SA31 9AA, SA31 9AB, SA31 9AD, SA31 9AE, SA31 9AF, SA31 9AG, SA31 9AH, SA31 9AJ, SA31 9AL, SA31 9AN, SA31 9AP, SA31 9AQ, SA31 9AR, SA31 9AS, SA31 9AT, SA31 9AU, SA31 9AW, SA31 9AX, SA31 9AY, SA31 9AZ, SA31 9BA, SA31 9BB, SA31 9BD, SA31 9BE, SA31 9BF, SA31 9BG, SA31 9BH, SA31 9BJ, SA31 9BL, SA31 9BN, SA31 9BP, SA31 9BQ, SA31 9BR, SA31 9BS, SA31 9BU, SA31 9BW, SA31 9BX, SA31 9BY, SA31 9BZ, SA31 9DA, SA31 9DB, SA31 9DD, SA31 9DE, SA31 9DF, SA31 9DG, SA31 9DH, SA31 9DJ, SA31 9DL, SA31 9DN, SA31 9DP, SA31 9DQ, SA31 9DR, SA31 9DS, SA31 9DT, SA31 9DU, SA31 9DW, SA31 9DX, SA31 9DY, SA31 9DZ, SA31 9EA, SA31 9EB, SA31 9ED, SA31 9EE, SA31 9EF, SA31 9EH, SA31 9EJ, SA31 9EL, SA31 9EN, SA31 9EP, SA31 9EQ, SA31 9ER, SA31 9ES, SA31 9ET, SA31 9EU, SA31 9EW, SA31 9EX, SA31 9EY, SA31 9EZ, SA31 9FA, SA31 9FB, SA31 9FD, SA31 9FE, SA31 9FF, SA31 9ZZ, SA32 7YA, SA32 7YB, SA32 7YD, SA32 7YF, SA32 7YH, SA32 7YJ, SA32 7YL, SA32 7YQ, SA32 7YW, SA32 7ZL, SA32 8WY, SA32 8WZ, SA32 8YA, SA32 8YE, SA33 4WW, SA33 4YB, SA33 4YD, SA33 4YE, SA33 4YG, SA33 4YH, SA33 4YL, SA33 4YQ, SA33 5WZ, SA33 5YA, SA33 5YB, SA33 5YD, SA33 5YE, SA33 5YF, SA33 5YG, SA33 5YH, SA33 5YL, SA33 5YN, SA33 5YP, SA33 5YR, SA33 5YS, SA33 5YT, SA33 5YU, SA33 5YW, SA33 6YA, SA33 6YD, SA33 6YE, SA33 6YF, SA33 6YG, SA33 6YH, SA33 6YJ, SA33 6YL, SA33 6YP, SA33 6YQ, SA33 6YU, SA33 6ZF, SA33 6ZH",541,263,278
W00003491,SA31,"SA31 3QP, SA31 3QT, SA33 6AA, SA33 6AB, SA33 6AF, SA33 6EE, SA33 6EG, SA33 6EH",310,146,164
W00010694,SA31,"SA31 1SP, SA31 1SW, SA31 3ED, SA31 3EG, SA31 3EJ, SA31 3GH, SA31 3JQ, SA31 3QL",388,237,151
W00003465,SA31,"SA31 3DP, SA31 3DR, SA31 3DU, SA31 3DW, SA31 3DX",320,208,112
W00003449,SA31,"SA31 1AW, SA31 1BU, SA31 1DD, SA31 1PS, SA31 1PT, SA31 1PU, SA31 1PX, SA31 1PZ, SA31 1QA, SA31 1QE, SA31 1QG, SA31 1QH, SA31 1QJ, SA31 1QL, SA31 1QN, SA31 1QQ, SA31 1QT, SA31 1QU, SA31 1QX, SA31 1QY, SA31 1QZ, SA31 1RB, SA31 1RD, SA31 1RF, SA31 1RX, SA31 1SE, SA31 3AB, SA31 3DZ, SA31 3EB, SA31 3LQ",208,159,49
W00003448,SA31,"SA31 1BS, SA31 1BX, SA31 1BY, SA31 1DA, SA31 1EP, SA31 1ER, SA31 1ES, SA31 1LD",210,163,47
W00003434,SA31,"SA31 1HF, SA31 1HH, SA31 1HP, SA31 1HQ, SA31 1HW, SA31 1JQ",244,189,55
W00003357,SA31,"SA31 2JH, SA31 2JJ, SA31 2JL, SA31 2JN, SA31 2JP, SA31 2JT, SA31 2JU, SA31 2JW, SA31 2JX, SA31 2PP, SA31 2YD, SA31 2YE, SA31 2YH, SA31 2YW, SA31 2YX, SA32 7DH",286,129,157
W00003358,SA31,"SA31 2BB, SA31 2HZ, SA31 2JA, SA31 2JB, SA31 2JD, SA31 2JE, SA31 2JG",229,111,118
W00003435,SA31,"SA31 1RP, SA31 1RQ, SA31 1SJ, SA31 1SL, SA31 1SN",279,166,113
W00003433,SA31,"SA31 1DR, SA31 1SD, SA31 1TF, SA31 1TH, SA31 1TJ, SA31 1TL, SA31 1TP",280,202,78
W00003432,SA31,"SA31 1HR, SA31 1HS, SA31 1HT, SA31 1HU, SA31 1JE, SA31 1JG, SA31 2DB, SA31 2EJ, SA31 2EL, SA31 2EP, SA31 2EW, SA31 2EZ",320,246,74
W00003431,SA31,"SA31 1ST, SA31 1SU, SA31 1SY, SA31 1TD",280,194,86
W00003430,SA31,"SA31 1GX, SA31 1HX, SA31 1JJ, SA31 2ER, SA31 2ES, SA31 2EX, SA31 2HA",261,185,76
W00003429,SA31,"SA31 1EJ, SA31 1HY, SA31 1JA, SA31 1JB, SA31 1JD, SA31 1JF",277,200,77
W00003356,SA31,"SA31 2JF, SA31 2JQ, SA31 2JR, SA32 7AE, SA32 7AY, SA32 7EJ, SA32 7EL, SA32 7EN, SA32 7EP, SA32 7ER, SA32 7ET, SA32 7EW, SA32 7EY",262,131,131
W00003428,SA31,"SA31 1SZ, SA31 1TB, SA31 1TE, SA31 1TQ",211,146,65
W00003426,SA31,"SA31 1SF, SA31 1SS, SA31 1SX, SA31 1TA, SA31 1TX, SA31 1TY, SA31 1UX, SA31 1WU, SA31 1WX, SA31 1WZ, SA31 1YE, SA31 1YG, SA31 1YQ, SA31 1ZE, SA31 1ZF, SA31 1ZG, SA31 1ZH, SA31 1ZN, SA31 1ZQ, SA31 1ZR, SA31 1ZS, SA31 1ZT, SA31 1ZU, SA31 1ZW, SA31 1ZX, SA31 1ZY, SA31 3QA",287,197,90
W00003425,SA31,"SA31 1EA, SA31 1EB, SA31 1ED, SA31 1EF, SA31 1EH, SA31 1EQ, SA31 1GZ, SA31 1JL, SA31 1QF",313,195,118
W00003424,SA31,"SA31 1EG, SA31 2ET, SA31 2EU, SA31 2HB, SA31 2HD, SA31 2HL, SA31 2HN, SA31 2JS",207,109,98
W00003876,SA31,"SA31 2DA, SA31 2LT, SA31 2LW, SA32 8DH, SA32 8DN, SA32 8DP, SA32 8DS, SA32 8DU, SA32 8DW",379,208,171
W00003867,SA31,"SA31 1EW, SA33 4NB, SA33 5DQ, SA33 5EQ, SA33 5NB, SA33 5ND, SA33 5NE, SA33 5NF, SA33 5NG, SA33 5NR, SA33 5NS, SA33 5NT",302,139,163
W00009998,SA31,"SA31 3HY, SA31 3JL, SA31 3JN, SA31 3JW",164,121,43
W00009997,SA31,"SA31 3EA, SA31 3ET",174,116,58
W00009992,SA31,"SA31 3BB, SA31 3BJ, SA31 3EP, SA31 3EQ, SA31 3HA, SA31 3HB",276,173,103
W00003427,SA31,"SA31 1DN, SA31 1DP, SA31 1DW, SA31 1DZ, SA31 1EE, SA31 1SG, SA31 1SQ, SA31 1TR, SA31 1TS",315,171,144
W00003436,SA31,"SA31 1AS, SA31 1DS, SA31 1DU, SA31 1DX, SA31 1EL, SA31 1HJ, SA31 1HL, SA31 1HN, SA31 1WY, SA31 1YJ, SA31 1YL, SA31 1YN, SA31 1YP, SA31 1YR, SA31 1ZJ, SA31 1ZL, SA31 1ZP",273,178,95
W00003878,SA31,"SA31 2LY, SA31 2LZ, SA31 2NA, SA32 8DB, SA32 8DD, SA32 8DE, SA32 8DG, SA32 8DJ, SA32 8DQ, SA32 8DR, SA32 8DT",248,103,145
W00003438,SA31,"SA31 1DE, SA31 1DF, SA31 1DG, SA31 1DH, SA31 1DJ, SA31 1DL, SA31 1DQ, SA31 1DY, SA31 1EY, SA31 1EZ",291,183,108
W00003437,SA31,"SA31 1AF, SA31 1RU, SA31 1RY, SA31 1RZ, SA31 1SA, SA31 1SB, SA31 1TG",337,262,75
W00003442,SA31,"SA31 1BG, SA31 3BT, SA31 3HJ, SA31 3HL, SA31 3HT, SA31 3JA, SA31 3JF, SA31 3LU, SA31 3LX, SA31 3LY, SA31 3LZ",239,155,84
W00003443,SA31,"SA31 3AS, SA31 3BP, SA31 3LT, SA31 3NF, SA31 3NG, SA31 3NH, SA31 3NJ, SA31 3NL, SA31 3NQ, SA31 3NR, SA31 3NT, SA31 3NW, SA31 3PL, SA31 3PN, SA31 3PW",340,227,113
W00003444,SA31,"SA31 3NS, SA31 3NX, SA31 3NY, SA31 3NZ, SA31 3PB, SA31 3PH, SA31 3PJ, SA31 3PU, SA31 3QR, SA31 3QU",310,209,101
W00003733,SA31,"SA31 2EB, SA31 2LB, SA31 2LE, SA31 2LF",151,84,67
W00003445,SA31,"SA31 1AH, SA31 1DB, SA31 1EU, SA31 1EX, SA31 1GY, SA31 1HA, SA31 1HB, SA31 1HD, SA31 1HE, SA31 1HG, SA31 1NU, SA31 1NY",247,162,85
W00003441,SA31,"SA31 2AA, SA31 2AB, SA31 2AD, SA31 2AE, SA31 2AF, SA31 2AG, SA31 2AH, SA31 2AJ, SA31 2AQ, SA31 2AU, SA31 2AX, SA31 2BH, SA31 2DE, SA31 2HE, SA31 2HG, SA31 2HJ, SA31 2HP, SA31 2PN",337,195,142
W00003732,SA31,"SA31 2DU, SA31 2DX, SA31 2DZ, SA31 2ED, SA31 2EE",289,163,126
W00003731,SA31,"SA31 2DS, SA31 2DT, SA31 2EF, SA31 2LA, SA31 2LD, SA31 2LN, SA31 2NX, SA31 2PE",355,182,173
W00003446,SA31,"SA31 1AG, SA31 1LS, SA31 1LT, SA31 1LU, SA31 1LX, SA31 1LZ, SA31 1NA, SA31 1NE, SA31 1NF, SA31 1NG, SA31 1NH, SA31 1NJ, SA31 1NL, SA31 1NP, SA31 1NQ, SA31 1NX",279,183,96
W00003447,SA31,"SA31 1ET, SA31 1GW, SA31 1HZ, SA31 1JH, SA31 1JU, SA31 1LH, SA31 1LN, SA31 1LQ, SA31 1LR, SA31 1NB, SA31 1ND, SA31 1PA, SA31 1PB, SA31 1PD, SA31 1PE, SA31 1PF, SA31 1QP",194,141,53
W00003440,SA31,"SA31 2AL, SA31 2AN, SA31 2AP, SA31 2AR, SA31 2AS, SA31 2AT, SA31 2AW, SA31 2AY, SA31 2AZ, SA31 2BZ, SA31 2DF",327,152,175
W00003439,SA31,"SA31 1GA, SA31 1RE, SA31 1RG, SA31 1RJ, SA31 1RN, SA31 1RR, SA31 1RT",242,168,74
W00003634,SA32,"SA32 8BJ, SA32 8BL, SA32 8NS, SA32 8NU, SA32 8PA, SA32 8PD, SA32 8PE, SA32 8PF, SA32 8PH, SA32 8PZ",279,91,188
W00003360,SA32,"SA32 7AP, SA32 7AQ, SA32 7AR, SA32 7AZ, SA32 7DP, SA32 7DQ, SA32 7DS, SA32 7DT, SA32 7DU, SA32 7DW, SA32 7HX, SA32 7HY, SA32 7HZ, SA32 7JA, SA33 6BH, SA33 6BL",387,172,215
W00003359,SA32,"SA32 7AH, SA32 7AJ, SA32 7AL, SA32 7AN, SA32 7DR, SA32 7DX, SA32 7DY, SA32 7DZ, SA32 7JB, SA32 7JD, SA32 7JE, SA32 7JF, SA32 7JG, SA32 7JH, SA32 7JJ, SA32 7JL, SA32 7JQ, SA33 6DD, SA33 6JX",368,181,187
W00003670,SA32,"SA32 7NL, SA32 7NN, SA32 7NP, SA32 7PL, SA32 8RD, SA32 8RE, SA32 8RF, SA32 8RG, SA32 8RH, SA32 8RT, SA32 8RX, SA32 8RY, SA32 8SA, SA32 8SB, SA32 8SD, SA32 8SE, SA32 8SF, SA32 8SH, SA32 8SN",339,150,189
W00003671,SA32,"SA32 7LE, SA32 7LF, SA32 7LG, SA32 7LQ, SA32 7LS, SA32 7LT, SA32 7LX, SA32 7NB, SA32 7NF, SA32 7NG, SA32 7NH, SA32 7NR, SA32 7NS, SA32 7NT, SA32 7NY, SA32 7PA, SA32 7PF, SA32 7PG",520,195,325
W00003672,SA32,"SA32 7LU, SA32 7LY, SA32 7LZ, SA32 7NA, SA32 7ND, SA32 7NE, SA32 7NJ, SA32 7NQ, SA32 7NU",239,103,136
W00003633,SA32,"SA32 8AJ, SA32 8AN, SA32 8BH, SA32 8BQ, SA32 8BU, SA32 8BY, SA32 8NR, SA32 8NT, SA32 8NX, SA32 8NY, SA32 8PB",274,131,143
W00003630,SA32,"SA32 7LH, SA32 7LJ, SA32 8AD, SA32 8AE, SA32 8AG, SA32 8AH, SA32 8AL, SA32 8AP, SA32 8AR, SA32 8AS, SA32 8AW, SA32 8AY, SA32 8HL, SA32 8HN, SA32 8JY, SA32 8LD, SA32 8LE, SA32 8LG, SA32 8LH, SA32 8LJ, SA32 8LL, SA32 8YB, SA32 8YD",418,212,206
W00003674,SA32,"SA32 7BA, SA32 7BB, SA32 7HA, SA32 7JX, SA32 7LL, SA32 7LN, SA32 7LP, SA32 7LR, SA32 7PB, SA32 7PD, SA32 7PE, SA32 7PH, SA32 7PR, SA32 7PS, SA32 7PT, SA32 7PU, SA32 7PX, SA32 7PY, SA32 7QB, SA32 7QD, SA32 7QE, SA32 7QG, SA32 7XW, SA32 7YN",196,102,94
W00003484,SA32,"SA32 7HU, SA33 6BB, SA33 6EQ, SA33 6HU, SA33 6HX, SA33 6HY, SA33 6JA, SA33 6JB, SA33 6JE, SA33 6JF, SA33 6JG",241,119,122
W00003675,SA32,"SA32 7BG, SA32 7BH, SA32 7BQ, SA32 7QX, SA32 7QY, SA32 7QZ, SA32 7RB, SA32 7RD, SA32 7RE, SA32 7RN, SA32 7RP, SA32 7SP, SA32 7SS",215,142,73
W00003676,SA32,"SA32 7BJ, SA32 7BL, SA32 7BN, SA32 7BP, SA32 7BS, SA32 7BW, SA32 7QR, SA32 7QS, SA32 7RH, SA32 7RR, SA32 7RS, SA32 7RU, SA32 7RY, SA32 7RZ, SA32 7SA, SA32 7SB, SA32 7SD, SA32 7SE, SA32 7SG, SA32 7SJ, SA32 7SL, SA32 7SN, SA32 7SR, SA32 7SW, SA39 9ED, SA39 9EJ",232,183,49
W00003673,SA32,"SA32 7BD, SA32 7BE, SA32 7JS, SA32 7JT, SA32 7JU, SA32 7JY, SA32 7JZ, SA32 7LA, SA32 7QA, SA32 7QJ, SA32 7QL, SA32 7QN, SA32 7QP, SA32 7QW, SA32 7RA",138,94,44
W00003354,SA32,"SA32 7AA, SA32 7AD, SA32 7AF, SA32 7AG, SA32 7AU, SA32 7ES, SA32 7EU, SA32 7EX, SA32 7HB, SA32 7HD, SA32 7HE, SA32 7HG, SA32 7HH, SA32 7HJ, SA32 7HL, SA32 7HN, SA32 7HQ, SA32 7HW",403,188,215
W00003355,SA32,"SA32 7AB, SA32 7AS, SA32 7AT, SA32 7AX, SA32 7BT, SA32 7BU, SA32 7BX, SA32 7DJ, SA32 7DL, SA32 7DN, SA32 7HF, SA32 7HR, SA32 7HS, SA32 7HT",345,111,234
W00003684,SA32,"SA32 8QH, SA32 8QJ, SA32 8QX, SA32 8QY, SA32 8RA, SA32 8RJ, SA32 8RL, SA32 8RN, SA32 8RP, SA32 8RU, SA32 8RW",215,100,115
W00003677,SA32,"SA32 7BZ, SA32 7PJ, SA32 7TG, SA32 7TQ, SA32 7TR, SA32 7TS, SA32 7TT, SA32 7TU, SA32 8SJ, SA32 8SL",263,128,135
W00003691,SA32,"SA32 7AW, SA32 7EA, SA32 7EB, SA32 7ED, SA32 7EE, SA32 7EG, SA39 9AJ, SA39 9AL, SA39 9BY, SA39 9DA, SA39 9DB, SA39 9DD, SA39 9HN",248,127,121
W00003489,SA33,"SA33 6BJ, SA33 6BN, SA33 6BP, SA33 6BU, SA33 6BW, SA33 6BX, SA33 6HL, SA33 6HN, SA33 6JL, SA33 6JN, SA33 6LA, SA33 6LJ, SA33 6LP, SA33 6LR, SA33 6LS, SA33 6LT, SA33 6LU, SA33 6LX",366,179,187
W00003488,SA33,"SA33 6BQ, SA33 6BS, SA33 6BT, SA33 6BY, SA33 6BZ, SA33 6DA, SA33 6DB, SA33 6JP, SA33 6JR, SA33 6JS, SA33 6JT, SA33 6JU, SA33 6LB, SA33 6LD, SA33 6LE, SA33 6LG, SA33 6LH, SA33 6LN",348,195,153
W00003487,SA33,"SA33 6AN, SA33 6AR, SA33 6EJ, SA33 6EL, SA33 6EN, SA33 6EP, SA33 6ER, SA33 6ES, SA33 6ET, SA33 6HB, SA33 6HW, SA33 6SW, SA33 6TH, SA33 6TL, SA33 6TN, SA33 6TP, SA33 6TQ, SA33 6TR, SA33 6TS, SA33 6TT, SA33 6TU, SA33 6TW, SA33 6TX, SA33 6YB",307,172,135
W00003485,SA33,"SA33 6EU, SA33 6EX, SA33 6EY, SA33 6HA, SA33 6SP, SA33 6SR, SA33 6SZ, SA33 6TA, SA33 6TB, SA33 6TY, SA33 6TZ, SA33 6UA, SA33 6UD, SA33 6UE, SA33 6UF, SA33 6UH, SA33 6UJ, SA33 6UN, SA33 6XA, SA33 6XN",354,170,184
W00003483,SA33,"SA33 6BA, SA33 6BD, SA33 6BE, SA33 6BG, SA33 6HT, SA33 6JD",291,142,149
W00003473,SA33,"SA33 6RL, SA33 6RN, SA33 6RP, SA33 6SX, SA38 9LU, SA38 9LX, SA38 9NB, SA38 9ND, SA38 9NE, SA38 9NG, SA38 9NH, SA38 9NJ, SA38 9NL, SA38 9NN, SA38 9NQ",265,158,107
W00003490,SA33,"SA33 5DT, SA33 5DU, SA33 5DX, SA33 5DZ, SA33 5EA, SA33 5EB, SA33 5ED, SA33 5EG, SA33 5EH, SA33 5EJ, SA33 5EL, SA33 5EP, SA33 6AD, SA33 6AE, SA33 6AG, SA33 6AH, SA33 6AJ, SA33 6AL, SA33 6AQ, SA33 6AW, SA33 6NA, SA33 6ND, SA33 6NE",356,166,190
W00003486,SA33,"SA33 6AS, SA33 6AT, SA33 6SS, SA33 6ST, SA33 6SU, SA33 6SY, SA33 6TD, SA33 6TE, SA33 6TG, SA33 6UB, SA33 6UL, SA33 6UP, SA33 6UR, SA33 6UT, SA33 6UU, SA33 6XB, SA33 6XD, SA33 6XE, SA33 6XG, SA33 6XJ, SA33 6XL, SA33 6XP, SA33 6XR, SA33 6XT, SA33 6YN",324,179,145
W00003621,SA33,"SA33 4EZ, SA33 4HZ, SA33 4NX, SA33 4PX, SA33 4PY, SA33 4RG, SA33 4TU, SA33 4TX, SA33 4TY, SA33 4TZ, SA33 4UA, SA33 4UB, SA33 4UF, SA33 4UG",248,219,29
W00003619,SA33,"SA33 4HA, SA33 4HD, SA33 4HE, SA33 4HF, SA33 4HG, SA33 4HH, SA33 4HJ, SA33 4HL, SA33 4HN, SA33 4HP, SA33 4HR, SA33 4HS, SA33 4HT, SA33 4HU, SA33 4HX, SA33 4HY, SA33 4JA, SA33 4QU, SA33 4QX, SA33 4QY, SA33 4RA, SA33 4YF",293,204,89
W00003614,SA33,"SA33 4SR, SA33 4SS, SA33 4SX, SA33 4SY, SA33 4SZ, SA33 4TA, SA33 4TH, SA33 4TQ, SA33 4TS",175,140,35
W00003613,SA33,"SA33 4JB, SA33 4JD, SA33 4JE, SA33 4JF, SA33 4PL, SA33 4PN, SA33 4PP, SA33 4PR, SA33 4PS, SA33 4PU, SA33 4PW, SA34 0LT, SA34 0LU, SA34 0LX, SA34 0LY, SA34 0NH, SA34 0NP, SA34 0NX, SA34 0NY, SA34 0NZ, SA34 0PA, SA34 0PB, SA34 0PD, SA34 0PE, SA34 0PF, SA34 0PG, SA34 0PH, SA34 0PJ, SA34 0PL, SA34 0PN, SA34 0PP, SA67 8NR",417,324,93
W00003767,SA33,"SA33 5AJ, SA33 5AL, SA33 5AN, SA33 5AR, SA33 5AS, SA33 5EX, SA33 5HB, SA33 5HD, SA33 5LX",215,151,64
W00003766,SA33,"SA33 5JH, SA33 5JN, SA33 5JQ, SA33 5JR, SA33 5JS, SA33 5JT, SA33 5JW, SA33 5JY, SA33 5JZ, SA33 5LA, SA33 5LB, SA33 5LL",184,105,79
W00003765,SA33,"SA33 5EY, SA33 5EZ, SA33 5HA, SA33 5JD, SA33 5JG, SA33 5JJ, SA33 5JL, SA33 5JP, SA33 5JU, SA33 5LE, SA33 5LF, SA33 5LG, SA33 5LH, SA33 5LJ, SA33 5LN, SA33 5LP, SA33 5LW",215,117,98
W00003764,SA33,"SA33 5HE, SA33 5HF, SA33 5HG, SA33 5HH, SA33 5HJ, SA33 5HL, SA33 5HQ, SA33 5HW, SA33 5HX, SA33 5HZ, SA33 5JB, SA33 5JX, SA33 5LT, SA33 5LU",258,148,110
W00003763,SA33,"SA33 5AW, SA33 5BT, SA33 5HN, SA33 5HP, SA33 5HR, SA33 5HS, SA33 5HT, SA33 5HY, SA33 5JA",225,135,90
W00003762,SA33,"SA33 5AY, SA33 5AZ, SA33 5BA, SA33 5BN, SA33 5BP, SA33 5BS, SA33 5BU, SA33 5BW, SA33 5BX, SA33 5BY, SA33 5BZ, SA33 5DA, SA33 5DB, SA33 5DD, SA33 5DE, SA33 5DG, SA33 5DH, SA33 5DJ, SA33 5DN, SA33 5DY, SA33 5HU",290,148,142
W00003761,SA33,"SA33 5AE, SA33 5AF, SA33 5AG, SA33 5AH, SA33 5AP, SA33 5AQ, SA33 5AT, SA33 5AU, SA33 5AX, SA33 5BJ",268,165,103
W00003760,SA33,"SA33 5AA, SA33 5AB, SA33 5AD, SA33 5BB, SA33 5BD, SA33 5BE, SA33 5BG, SA33 5BH, SA33 5BL, SA33 5BQ, SA33 5DF, SA33 5DL, SA33 5DW, SA33 5EU",283,192,91
W00003616,SA33,"SA33 4RY, SA33 4SA, SA33 4SB, SA33 4SD, SA33 4SE, SA33 4SF, SA33 4SG, SA33 4SJ, SA33 4SP, SA33 4ST, SA33 4SW, SA33 4TB",146,111,35
W00003708,SA33,"SA33 6AU, SA33 6AX, SA44 5DT, SA44 5EL, SA44 5EN, SA44 5HG, SA44 5HT, SA44 5HU, SA44 5HX, SA44 5HY, SA44 5JA, SA44 5JB, SA44 5JD, SA44 5JE, SA44 5JF, SA44 5XD, SA44 5XE, SA44 5XR, SA44 5XS, SA44 5XT, SA44 5XU, SA44 5XX",380,240,140
W00003617,SA33,"SA33 4SN, SA33 4SQ, SA33 4SU, SA33 4TE, SA33 4TG, SA33 4TJ, SA33 4TL, SA33 4TN",183,154,29
W00003623,SA33,"SA33 4NY, SA33 4NZ, SA33 4PA, SA33 4PB, SA33 4PD, SA33 4PE, SA33 4PF, SA33 4UH, SA33 4YA",162,147,15
W00003622,SA33,"SA33 4FA, SA33 4PH, SA33 4PJ, SA33 4PQ, SA33 4PT, SA33 4PZ",112,90,22
W00003620,SA33,"SA33 4TW, SA33 4UD, SA33 4UE, SA33 4UL, SA33 4UQ",229,197,32
W00003866,SA33,"SA33 4AL, SA33 4AP, SA33 4AR, SA33 4AS, SA33 4AT, SA33 4AX, SA33 4BR, SA33 4EB, SA33 4EU, SA33 4EX, SA33 4JS",308,140,168
W00003615,SA33,"SA33 4QE, SA33 4QF, SA33 4QG, SA33 4QH, SA33 4QJ, SA33 4QQ, SA33 4RZ, SA33 4SH, SA33 4SL",192,139,53
W00003629,SA33,"SA33 4AY, SA33 4AZ, SA33 4BA, SA33 4JQ, SA33 4JT, SA33 4JU, SA33 4JX, SA33 4JY, SA33 4JZ, SA33 4LA, SA33 4LB, SA33 4LD, SA33 4LE",278,145,133
W00003618,SA33,"SA33 4NS, SA33 4NT, SA33 4NU, SA33 4QD, SA33 4QL, SA33 4QN, SA33 4QP, SA33 4QR, SA33 4QS, SA33 4QT, SA33 4RB, SA33 4RD, SA33 4RE, SA33 4RF, SA33 4RH, SA33 4RJ, SA33 4RL, SA33 4RN, SA33 4RP, SA33 4RR, SA33 4RS, SA33 4TD, SA33 4TP, SA33 4TT, SA33 4UJ",387,309,78
W00003909,SA33,"SA33 5PG, SA33 5PN, SA33 5PQ, SA33 5PT, SA33 5PU, SA33 6DJ, SA33 6DL, SA33 6DN, SA33 6DT, SA33 6DU, SA33 6DW, SA33 6DX, SA33 6QL, SA33 6QN, SA33 6RE, SA33 6RG, SA33 6RQ, SA33 6RU, SA33 6RW, SA33 6SA, SA33 6SB, SA33 6SE, SA33 6SF, SA33 6SG, SA33 6SH, SA33 6SQ",354,186,168
W00003907,SA33,"SA33 4DR, SA33 4DS, SA33 4LF, SA33 4LG, SA33 4LQ, SA33 5NW, SA33 5PH, SA33 5QF, SA33 5QG, SA33 5QH, SA33 5QL, SA33 5QP, SA33 5QQ, SA33 5QR, SA33 5QT, SA33 5QU, SA33 5QW, SA33 5QX, SA33 5QY, SA33 5QZ",269,138,131
W00003906,SA33,"SA33 5EE, SA33 5EW, SA33 5NH, SA33 5NJ, SA33 5NL, SA33 5NN, SA33 5NP, SA33 5NQ, SA33 5NX, SA33 5NY, SA33 5NZ, SA33 5PA, SA33 5PB, SA33 5PD, SA33 5PJ, SA33 5QA, SA33 5QE, SA33 5QJ, SA33 5QN, SA33 5QS",303,173,130
W00003905,SA33,"SA33 6DP, SA33 6DR, SA33 6DS, SA33 6DY, SA33 6EA, SA34 0DG, SA34 0DH, SA34 0DJ, SA34 0DL, SA34 0DN, SA34 0DP, SA34 0DR, SA34 0DS, SA34 0DT, SA34 0DU, SA34 0HS, SA34 0HT, SA34 0HU, SA34 0HX, SA34 0HY, SA34 0JA, SA34 0JB, SA34 0JD, SA34 0JE, SA34 0JN, SA35 0DD, SA35 0DE, SA35 0DF",435,259,176
W00003904,SA33,"SA33 5EN, SA33 5RG, SA33 5RH, SA33 5RJ, SA33 5RL, SA33 5RN, SA33 5RP, SA33 5RR, SA33 5RS, SA33 5RW, SA33 6HD, SA33 6HE, SA33 6HH, SA33 6NB, SA33 6NF, SA33 6NG, SA33 6NH, SA33 6NN, SA33 6NP, SA33 6NS, SA33 6NW, SA33 6NY, SA33 6NZ, SA33 6PA, SA33 6PB, SA33 6PD",288,167,121
W00003874,SA33,"SA33 4EA, SA33 4EE, SA33 4EF, SA33 4EG, SA33 4EL, SA33 4EN, SA33 4EP, SA33 4EQ, SA33 4ER, SA33 4ES, SA33 4EW, SA33 4NF, SA33 4NG, SA33 4NQ",245,137,108
W00003873,SA33,"SA33 4AD, SA33 4AG, SA33 4AH, SA33 4BJ, SA33 4DA, SA33 4DT, SA33 4EH, SA33 4EJ, SA33 4ET, SA33 4EY, SA33 4FD, SA33 4JN, SA33 4JP, SA33 4JW",377,197,180
W00003872,SA33,"SA33 4AJ, SA33 4AN, SA33 4AQ, SA33 4AU, SA33 4AW, SA33 4BB, SA33 4JR, SA33 4LH",456,230,226
W00003871,SA33,"SA33 4AA, SA33 4AB, SA33 4AE, SA33 4AF, SA33 4BD, SA33 4BG, SA33 4BL, SA33 4BN, SA33 4DX, SA33 4DY, SA33 4DZ, SA33 4ED, SA33 4LR, SA33 4LS",311,189,122
W00003870,SA33,"SA33 4BH, SA33 4BP, SA33 4BQ, SA33 4BW, SA33 4BX, SA33 4BY, SA33 4BZ, SA33 4DB, SA33 4DE, SA33 4DF, SA33 4FB, SA33 4LT, SA33 4LU, SA33 4LX, SA33 4LY, SA33 4LZ, SA33 4NW",316,181,135
W00003869,SA33,"SA33 4BE, SA33 4BS, SA33 4BT, SA33 4BU, SA33 4DG, SA33 4DL",524,279,245
W00003868,SA33,"SA33 4DD, SA33 4DH, SA33 4DJ, SA33 4DN, SA33 4DP, SA33 4DQ, SA33 4DU, SA33 4DW, SA33 4LJ, SA33 4NA, SA33 4ND, SA33 4NE, SA33 4NH, SA33 4NJ",284,154,130
W00003908,SA33,"SA33 5PE, SA33 5PL, SA33 5PP, SA33 5PR, SA33 5PS, SA33 5PW, SA33 5PX, SA33 5PY, SA33 6NR, SA33 6PE, SA33 6PF, SA33 6PJ, SA33 6PL, SA33 6PN, SA33 6PP, SA33 6PR, SA33 6PS, SA33 6PT, SA33 6PU, SA33 6PX, SA33 6PY, SA33 6QA, SA33 6QE, SA33 6QF, SA33 6QG, SA33 6QH, SA33 6QJ, SA33 6QP, SA33 6QR, SA33 6QS, SA33 6QU, SA33 6QX, SA33 6QY, SA33 6QZ, SA33 6RA, SA33 6RB, SA33 6RD, SA33 6RH, SA33 6RJ, SA33 6RT, SA33 6RX, SA33 6RY, SA33 6SD",372,188,184
W00010670,SA34,"SA34 0BX, SA34 0HD, SA34 0HG, SA34 0HJ, SA34 0HQ, SA34 0HR, SA34 0HZ, SA34 0WA, SA34 0WG, SA34 0WU, SA34 0WW, SA34 0WX, SA34 0WY, SA34 0WZ, SA34 0YF",309,180,129
W00010357,SA34,"SA34 0DA, SA34 0DB, SA34 0HE, SA34 0HL, SA34 0HP, SA34 0HW, SA34 0JF",268,152,116
W00002993,SA34,"SA34 0TY, SA34 0UA, SA34 0UB, SA34 0UD, SA34 0UE, SA34 0XY, SA34 0YD, SA34 0YE, SA34 0YG, SA34 0YH, SA34 0YJ, SA34 0YQ, SA35 0DA, SA36 0DU, SA36 0DY, SA36 0DZ, SA36 0EA, SA41 3QP, SA41 3QR, SA41 3QS, SA41 3QT, SA41 3QU, SA41 3QW, SA41 3RA, SA41 3RH, SA41 3RQ",431,250,181
W00003946,SA34,"SA34 0AE, SA34 0AQ, SA34 0AU, SA34 0AX, SA34 0AY, SA34 0BA, SA34 0BB, SA34 0BD, SA34 0BE, SA34 0BG, SA34 0BH, SA34 0BQ, SA34 0QR, SA34 0ST",321,163,158
W00003944,SA34,"SA34 0AJ, SA34 0AL, SA34 0AN, SA34 0AP, SA34 0AR, SA34 0AS, SA34 0AW, SA34 0NB, SA34 0PX, SA34 0PY, SA34 0QA, SA34 0QB",252,163,89
W00003940,SA34,"SA34 0RR, SA34 0RS, SA34 0SE, SA34 0SG, SA34 0SH, SA34 0SJ, SA34 0SL, SA34 0SN, SA34 0SP, SA34 0SR, SA34 0SS, SA34 0TD, SA34 0TF, SA34 0UJ, SA34 0UL, SA34 0UN, SA34 0UP, SA34 0UR, SA34 0UT, SA34 0UW, SA34 0XH",465,336,129
W00003624,SA34,"SA34 0TA, SA34 0TB, SA34 0TE, SA34 0TG, SA34 0TH, SA34 0TL, SA34 0UU, SA34 0UX, SA34 0UY, SA34 0XA, SA34 0XB, SA34 0XD, SA34 0XE, SA34 0XG, SA34 0YR, SA34 0YS, SA66 7UT, SA66 7XB, SA66 7XD, SA66 7XE, SA66 7XG",387,178,209
W00003625,SA34,"SA34 0XR, SA34 0XS, SA34 0XT, SA34 0XU, SA34 0XX, SA34 0YL, SA34 0YN, SA34 0YP, SA66 7RP, SA66 7RR, SA66 7RS, SA66 7UU, SA66 7UX, SA66 7UY, SA66 7UZ, SA66 7XA, SA66 7XF, SA66 7XH",386,197,189
W00003626,SA34,"SA34 0ET, SA34 0JU, SA34 0JX, SA34 0RU, SA34 0RX, SA34 0RY, SA34 0SA, SA34 0SB, SA34 0SD, SA34 0TJ, SA34 0TN, SA34 0TP, SA34 0TR, SA34 0TS, SA34 0TT, SA34 0TU, SA34 0XP, SA34 0YA, SA34 0YB",359,199,160
W00003627,SA34,"SA34 0BZ, SA34 0DD, SA34 0DE, SA34 0DF, SA34 0EB, SA34 0ED, SA34 0EE, SA34 0EF, SA34 0ER, SA34 0ES, SA34 0HB, SA34 0LG, SA34 0LH, SA34 0LJ, SA34 0LL, SA34 0LN, SA34 0LP, SA34 0LR, SA34 0LS, SA34 0RP, SA34 0RT, SA34 0YU",329,193,136
W00003628,SA34,"SA34 0EG, SA34 0EH, SA34 0EJ, SA34 0EL, SA34 0EN, SA34 0EP, SA34 0EU, SA34 0EX, SA34 0EY, SA34 0HA, SA34 0JG, SA34 0JH, SA34 0JJ, SA34 0JL, SA34 0JP, SA34 0JR, SA34 0JS, SA34 0JT",305,164,141
W00003941,SA34,"SA34 0AB, SA34 0AD, SA34 0AF, SA34 0AG, SA34 0AH, SA34 0AT",161,116,45
W00002956,SA34,"SA34 0AZ, SA34 0NS, SA34 0NU, SA67 8BP, SA67 8NP, SA67 8NW, SA67 8PR, SA67 8PS, SA67 8PT, SA67 8PU, SA67 8PX, SA67 8PY, SA67 8PZ, SA67 8QA, SA67 8QB, SA67 8QD, SA67 8QE, SA67 8QF, SA67 8QG, SA67 8QH, SA67 8QP, SA67 8YE",376,336,40
W00003943,SA34,"SA34 0AA, SA34 0HH, SA34 0HN, SA34 0PZ, SA34 0QD, SA34 0QE, SA34 0QL, SA34 0QN, SA34 0QW",287,195,92
W00003086,SA34,"SA34 0NE, SA34 0NF, SA34 0NJ, SA34 0NL, SA34 0NN, SA34 0NQ, SA34 0NR, SA34 0NT, SA34 0PR, SA67 8JD, SA67 8JY, SA67 8LE, SA67 8TH, SA67 8TJ, SA67 8TN, SA67 8TP, SA67 8UL",329,273,56
W00003089,SA34,"SA34 0RE, SA34 0RG, SA34 0RH, SA66 7HB, SA67 7EG, SA67 7EH, SA67 7EJ, SA67 7EL, SA67 7EQ, SA67 7NY, SA67 7NZ, SA67 7PA, SA67 7PB, SA67 7PD, SA67 7PE, SA67 7PF, SA67 7PG, SA67 7PH, SA67 7PL, SA67 8UP, SA67 8UR, SA67 8UT, SA67 8UU",376,276,100
W00003087,SA34,"SA34 0QX, SA34 0QY, SA34 0RA, SA34 0RB, SA34 0RD, SA67 8JB, SA67 8TG, SA67 8TQ, SA67 8TR, SA67 8TS, SA67 8UG, SA67 8UH, SA67 8UJ, SA67 8UN, SA67 8UQ",372,290,82
W00002987,SA35,"SA35 0AG, SA35 0AH, SA35 0AJ, SA35 0AL, SA35 0AP, SA35 0AQ, SA35 0BB, SA35 0BD, SA35 0BE, SA35 0BG, SA35 0BJ, SA35 0BL, SA35 0BN, SA35 0BQ, SA35 0BS, SA35 0BY, SA35 0DB, SA35 0DN, SA35 0DW, SA36 0EE, SA36 0EF, SA37 0JT",371,202,169
W00002732,SA35,"SA35 0WA, SA35 0WF, SA37 0WZ, SA37 0YP, SA41 3WY, SA41 3WZ, SA41 3YA, SA41 3YB, SA43 1BS, SA43 1BT, SA43 1BW, SA43 1BZ, SA43 1DA, SA43 1DD, SA43 1DE, SA43 1DF, SA43 1DG, SA43 1HW, SA43 1HZ, SA43 1JB, SA43 1JG, SA43 1JH, SA43 1JJ, SA43 1JL, SA43 1JN, SA43 1JP, SA43 1JQ, SA43 1JW, SA43 1LB, SA43 1LD, SA43 1LE, SA43 1LF, SA43 1LG, SA43 1LH, SA43 1LJ, SA43 1LL, SA43 1LN, SA43 1LQ, SA43 1LR, SA43 1WA, SA43 1WS, SA43 1WT, SA43 1WY, SA43 1WZ, SA43 1XT, SA43 1XW, SA43 1XX, SA43 1XY, SA43 1XZ, SA43 1YA, SA43 1YB, SA43 1YD, SA43 1YE, SA43 1YF, SA43 1YY, SA43 1YZ, SA43 1ZW, SA43 2WA, SA43 2WB, SA43 2WW, SA43 2WX, SA43 2WY, SA43 2WZ, SA43 2XB, SA43 2YA, SA43 2YB, SA43 2YE, SA43 2YG, SA43 2YL, SA43 2YQ, SA43 2YS, SA43 2YU, SA43 2YX, SA43 2ZD, SA43 2ZF, SA43 3WW, SA43 3WY, SA43 3WZ, SA43 3YB, SA43 3YD, SA43 3YE, SA43 3YG, SA43 3YH, SA43 3YL, SA43 3YN, SA43 9AA, SA43 9AB, SA43 9AD, SA43 9AE, SA43 9AF, SA43 9AG, SA43 9AH, SA43 9AJ, SA43 9AL, SA43 9AN, SA43 9AP, SA43 9AQ, SA43 9AR, SA43 9AS, SA43 9AT, SA43 9AU",263,141,122
W00002988,SA35,"SA35 0AA, SA35 0AB, SA35 0AD, SA35 0AE, SA35 0AN, SA35 0AR, SA35 0AS, SA35 0AT, SA35 0AU, SA35 0AW, SA35 0AX, SA35 0BH, SA35 0BP, SA35 0BT, SA35 0DP, SA35 0YN, SA37 0JU, SA37 0JX, SA37 0JY, SA37 0JZ, SA37 0LJ, SA37 0LL, SA37 0LN, SA37 0LW",329,175,154
W00002989,SA35,"SA35 0BA, SA35 0BZ, SA35 0DG, SA35 0DQ, SA36 0DS, SA36 0DT, SA36 0DX, SA36 0EB, SA36 0ED",389,163,226
W00002986,SA37,"SA37 0AB, SA37 0HN, SA37 0HP, SA37 0HR, SA37 0HT, SA37 0HU, SA37 0HW, SA37 0HX, SA37 0HY, SA37 0HZ, SA37 0JH, SA37 0JQ, SA37 0JW",426,176,250
W00002992,SA37,"SA37 0JA, SA37 0JB, SA37 0JE, SA41 3RS, SA41 3RT, SA41 3RU, SA41 3RX, SA41 3SE, SA41 3SF, SA41 3SG, SA41 3SQ",206,97,109
W00003471,SA37,"SA37 0LG, SA37 0LQ, SA38 9JL, SA38 9JN, SA38 9LD, SA38 9LE, SA38 9LG, SA38 9RH, SA38 9RL, SA38 9RQ",187,112,75
W00002984,SA37,"SA37 0EB, SA37 0EH, SA37 0EJ, SA37 0ES, SA37 0EZ, SA37 0HA, SA37 0HB, SA37 0HD, SA37 0HF, SA37 0HJ, SA37 0HL, SA37 0HQ",264,137,127
W00002983,SA37,"SA37 0ER, SA37 0ET, SA37 0EU, SA37 0EX, SA37 0EY, SA37 0HE, SA37 0HG, SA37 0HH, SA43 2PG, SA43 2PH, SA43 2PJ, SA43 2PL, SA43 2PN, SA43 2PP, SA43 2PW, SA43 2QB, SA43 2QE",277,155,122
W00003472,SA37,"SA37 0LH, SA38 9JB, SA38 9JD, SA38 9JQ, SA38 9LP, SA38 9LW, SA38 9NW, SA38 9RB, SA38 9RE, SA38 9RF, SA38 9RG, SA38 9RJ, SA38 9RN, SA38 9RS, SA38 9RT, SA38 9RW",232,126,106
W00002979,SA37,"SA37 0JF, SA43 2PD, SA43 2PE, SA43 2PF, SA43 2PR, SA43 2QA, SA43 2QD, SA43 2RG, SA43 2TJ, SA43 2TL, SA43 2TN, SA43 2TP, SA43 2TR, SA43 2TT, SA43 2TU, SA43 2TW, SA43 2TX, SA43 2TY, SA43 2YD, SA43 2YF, SA43 3DH, SA43 3DJ, SA43 3DL",293,163,130
W00002994,SA37,"SA37 0JD, SA41 3PL, SA41 3PN, SA41 3PP, SA41 3PR, SA41 3PS, SA41 3PT, SA41 3PU, SA41 3PW, SA41 3PY, SA41 3PZ, SA41 3QA, SA41 3SH, SA41 3SN, SA41 3SR, SA41 3SS, SA41 3ST, SA41 3SU, SA41 3SX, SA41 3UJ, SA41 3UL, SA41 3UN",356,143,213
W00002985,SA37,"SA37 0EL, SA37 0EN, SA37 0EP, SA37 0EW, SA37 0HS, SA37 0JG, SA37 0JL, SA37 0JN, SA37 0JP, SA37 0JR, SA37 0JS, SA37 0LA, SA41 3QX, SA41 3QY, SA41 3RB, SA43 2TS",302,156,146
W00002777,SA38,"SA38 9JY, SA43 2BG, SA43 2BQ, SA43 2LZ, SA43 2NA, SA43 2QN, SA43 2QP, SA43 2QR, SA43 2QS, SA43 2QT, SA43 2QU, SA43 2QW, SA43 2QY, SA43 2RA, SA43 2RB, SA43 2RD, SA43 2RE, SA43 2RF, SA43 2RH, SA43 2RJ, SA43 2RL, SA43 2RN, SA43 2RP, SA43 2RW",298,141,157
W00002776,SA38,"SA38 9QG, SA38 9QH, SA38 9QJ, SA38 9QL, SA38 9QQ, SA38 9QU, SA38 9QX, SA43 2JA, SA43 2JB, SA43 2JD, SA43 2JT, SA44 5RR, SA44 5RS, SA44 5RT, SA44 6NZ, SA44 6PA",286,140,146
W00002775,SA38,"SA38 9JS, SA38 9JT, SA38 9NZ, SA38 9PA, SA38 9PB, SA38 9PD, SA38 9PE, SA38 9PF, SA38 9PG, SA38 9PH, SA38 9PQ",247,153,94
W00002774,SA38,"SA38 9JJ, SA38 9JP, SA38 9JR, SA38 9JU, SA38 9JW, SA38 9JX, SA38 9JZ, SA38 9LA, SA38 9LB, SA43 2QX",307,146,161
W00002773,SA38,"SA38 9PJ, SA38 9PL, SA38 9PN, SA38 9PP, SA38 9PR, SA38 9PW, SA38 9PY, SA38 9PZ, SA38 9QD, SA38 9QR, SA38 9QS",260,119,141
W00002786,SA38,"SA38 9WA, SA38 9WW, SA38 9WX, SA38 9WY, SA38 9WZ, SA38 9YF, SA38 9YG, SA38 9YH, SA38 9YL, SA38 9YP, SA38 9ZW, SA39 9WA, SA39 9WB, SA39 9WS, SA39 9WX, SA39 9WY, SA39 9WZ, SA44 4JD, SA44 4JE, SA44 4JF, SA44 4JG, SA44 4JH, SA44 4JJ, SA44 4JP, SA44 4JR, SA44 4JS, SA44 4LJ, SA44 4LN, SA44 4LX, SA44 4LY, SA44 4LZ, SA44 4NA, SA44 4NB, SA44 4ND, SA44 4NP, SA44 4SN, SA44 4TR, SA44 4WA, SA44 4WH, SA44 4WT, SA44 4WU, SA44 4WW, SA44 4WX, SA44 4WY, SA44 4WZ, SA44 4XZ, SA44 4YA, SA44 4YD, SA44 4YE, SA44 4YF, SA44 4YL, SA44 4YN, SA44 4YP, SA44 4YQ, SA44 4YR, SA44 4YT, SA44 4YU, SA44 4YW, SA44 4YX, SA44 4ZA, SA44 4ZB, SA44 4ZD, SA44 5JX, SA44 5WB, SA44 5WD, SA44 5WQ, SA44 5WR, SA44 5WS, SA44 5WT, SA44 5WU, SA44 5WW, SA44 5WX, SA44 5WZ, SA44 5XQ, SA44 5XZ, SA44 5YP, SA44 5YR, SA44 5YT, SA44 5YU, SA44 5YX, SA44 5YZ, SA44 5ZA, SA44 5ZB, SA44 5ZD, SA44 5ZE, SA44 6YB, SA44 6YD, SA44 6YE, SA44 6YH, SA44 6YS, SA44 9AB, SA44 9AD, SA44 9AG, SA44 9AN, SA44 9AP, SA44 9AQ, SA44 9AR, SA44 9AS, SA44 9AT, SA44 9AW, SA44 9AX, SA44 9AY, SA44 9AZ, SA44 9BA, SA44 9BB, SA45 9WZ, SA45 9YA",261,119,142
W00002772,SA38,"SA38 9QA, SA38 9QB, SA38 9QE, SA38 9QF, SA38 9QN, SA38 9QP, SA38 9QT",325,157,168
W00002946,SA38,"SA38 9ER, SA38 9ES, SA38 9ET, SA38 9EU, SA38 9EX, SA38 9EY, SA38 9EZ, SA38 9HA, SA44 5QG, SA44 5QH, SA44 5QJ, SA44 5QN, SA44 5QP, SA44 5RH, SA44 5RJ",248,142,106
W00002832,SA38,"SA38 9AZ, SA38 9DS, SA38 9EA, SA38 9EB, SA38 9ED, SA38 9EE, SA38 9EF, SA38 9EH, SA38 9EJ, SA38 9EL, SA38 9EN, SA38 9EP, SA38 9EQ, SA38 9EW, SA38 9NS, SA44 5UB",265,142,123
W00003476,SA38,"SA38 9AA, SA38 9AB, SA38 9AD, SA38 9AE, SA38 9AF, SA38 9AG, SA38 9AH, SA38 9AJ, SA38 9AL, SA38 9AN, SA38 9AP, SA38 9AQ, SA38 9AR, SA38 9AS, SA38 9AT, SA38 9AU, SA38 9AW, SA38 9AX, SA38 9AY, SA38 9BA, SA38 9BB, SA38 9BD, SA38 9BG, SA38 9BJ, SA38 9BN, SA38 9BP, SA38 9BQ, SA38 9BR, SA38 9DF, SA38 9DU, SA38 9DX, SA38 9DY, SA38 9DZ, SA38 9HH, SA38 9HJ, SA38 9JH, SA38 9PT, SA38 9RA, SA38 9RD, SA38 9YA, SA38 9YB, SA38 9YD, SA38 9YE",497,260,237
W00002836,SA38,"SA38 9EG, SA38 9NP, SA38 9NT, SA38 9NY, SA38 9PX, SA38 9QW, SA38 9QY",264,124,140
W00002835,SA38,"SA38 9NR, SA38 9NU, SA38 9NX, SA38 9PS",148,70,78
W00003470,SA38,"SA38 9LJ, SA38 9LR, SA38 9LS, SA38 9LT, SA38 9LY, SA38 9LZ, SA38 9NA, SA38 9RP, SA38 9RR",282,190,92
W00002833,SA38,"SA38 9HB, SA38 9HD, SA38 9HF, SA44 5LJ, SA44 5LL, SA44 5TR, SA44 5TT, SA44 5TU, SA44 5TX, SA44 5TY, SA44 5UD",221,101,120
W00003475,SA38,"SA38 9BZ, SA38 9DA, SA38 9DB, SA38 9DD, SA38 9DE, SA38 9DG, SA38 9DH, SA38 9DJ, SA38 9DN, SA38 9DQ, SA38 9HP, SA38 9HQ, SA38 9HR, SA38 9HW, SA38 9HZ",291,126,165
W00003706,SA38,"SA38 9HS, SA38 9HT, SA38 9HU, SA38 9HX, SA38 9HY, SA38 9JA, SA38 9JE, SA38 9JF, SA38 9JG, SA44 5TG, SA44 5UN, SA44 5UP, SA44 5XL, SA44 5XN, SA44 5XW, SA44 5YL, SA44 5YW",336,194,142
W00003474,SA38,"SA38 9BE, SA38 9BH, SA38 9BL, SA38 9BS, SA38 9BT, SA38 9BU, SA38 9BW, SA38 9BX, SA38 9BY, SA38 9DL, SA38 9DT, SA38 9DW, SA38 9HL, SA38 9HN, SA38 9LL, SA38 9LN",316,155,161
W00003688,SA39,"SA39 9AB, SA39 9BB, SA39 9BD, SA39 9HT, SA39 9HU, SA39 9HX, SA39 9HY, SA39 9JA, SA39 9JH, SA39 9JJ, SA39 9JL, SA39 9JN, SA39 9JR, SA39 9JU, SA39 9LD",241,91,150
W00003692,SA39,"SA39 9BE, SA39 9BG, SA39 9DG, SA39 9DH, SA39 9DJ, SA39 9DP, SA39 9DQ, SA39 9DU, SA39 9DX, SA39 9DY, SA39 9DZ, SA39 9EA, SA39 9EB, SA39 9EE, SA39 9EF, SA39 9EG, SA39 9JP, SA39 9LG, SA39 9LH, SA39 9LJ, SA39 9LL, SA39 9TU",354,154,200
W00003693,SA39,"SA39 9DL, SA39 9DN, SA39 9DR, SA39 9DS, SA39 9DT, SA39 9DW, SA40 9SB, SA40 9SG, SA40 9SH, SA40 9SJ, SA40 9SQ",286,142,144
W00003685,SA39,"SA39 9AP, SA39 9ES, SA39 9HA, SA39 9HH, SA39 9HJ, SA39 9HL, SA39 9HP, SA39 9HQ, SA39 9HS, SA39 9HW",422,221,201
W00003686,SA39,"SA39 9AS, SA39 9AT, SA39 9AU, SA39 9AW, SA39 9AX, SA39 9AY, SA39 9AZ, SA39 9BA, SA39 9BH, SA39 9BJ, SA39 9BL, SA39 9BQ, SA39 9EH, SA39 9EL",306,134,172
W00003687,SA39,"SA39 9AA, SA39 9AD, SA39 9AF, SA39 9AR, SA39 9BP, SA39 9BS, SA39 9BT, SA39 9BU, SA39 9ER, SA39 9ET, SA39 9EU, SA39 9EX",306,138,168
W00002890,SA39,"SA39 9LN, SA39 9LP, SA39 9LW, SA40 9UJ, SA40 9UL, SA40 9UN, SA40 9UP, SA40 9UU, SA40 9UX, SA40 9UY, SA40 9UZ, SA40 9XA, SA40 9XB, SA40 9XD, SA40 9XE, SA40 9XG, SA40 9XH, SA40 9XJ, SA44 4PN",239,107,132
W00002789,SA39,"SA39 9JB, SA39 9JD, SA39 9JE, SA39 9LT, SA39 9LU, SA39 9LX, SA39 9LY, SA39 9LZ, SA39 9NA, SA44 4PB, SA44 4PD, SA44 4PE, SA44 4PF, SA44 4PG, SA44 4PJ, SA44 4PL, SA44 4RA, SA44 4RB",223,121,102
W00003690,SA39,"SA39 9AE, SA39 9AN, SA39 9BX, SA39 9HB, SA39 9HD, SA39 9HE, SA39 9HF, SA39 9HG, SA39 9HR, SA39 9JX",298,149,149
W00002787,SA39,"SA39 9NB, SA44 4EL, SA44 4PH, SA44 4PP, SA44 4PQ, SA44 4PR, SA44 4PS, SA44 4PT, SA44 4PU, SA44 4PX, SA44 4QD, SA44 4QE, SA44 4QF, SA44 4RD, SA44 4RE, SA44 4RG, SA44 4TX, SA44 4UL, SA44 4UN, SA44 4UP",238,145,93
W00003689,SA39,"SA39 9AG, SA39 9AH, SA39 9HZ, SA39 9JY, SA39 9JZ, SA39 9LA, SA39 9LB, SA44 4AA, SA44 4AE, SA44 4AF, SA44 4AG, SA44 4AH, SA44 4AL, SA44 4AQ, SA44 4RJ, SA44 4RL, SA44 4RN, SA44 4RT, SA44 4RU",228,97,131
W00010236,SA4,"SA4 2DE, SA4 2DF, SA4 2DJ, SA4 2DQ, SA4 2ED, SA4 2EN, SA4 2JB, SA4 4DE, SA4 4DF, SA4 4ED, SA4 4EN, SA4 4QA, SA4 6JB",231,211,20
W00010237,SA4,"SA4 2DD, SA4 2JA, SA4 4DD, SA4 4JA, SA4 4QB, SA4 4QE, SA4 4QF, SA4 4QH, SA4 4QJ, SA4 4QS",347,301,46
W00010238,SA4,"SA4 2HJ, SA4 2HL, SA4 4HJ, SA4 4HL, SA4 4QD, SA4 4QG",324,280,44
W00010235,SA4,"SA4 1FX, SA4 1GN, SA4 1GS, SA4 1HF, SA4 1HP, SA4 1ZR, SA4 9FX, SA4 9GN, SA4 9HF, SA4 9HP, SA4 9ZR",317,263,54
W00004518,SA4,"SA4 1PG, SA4 1PH, SA4 1PJ, SA4 1PQ, SA4 8PG, SA4 8PH, SA4 8PJ, SA4 8PQ",298,254,44
W00004520,SA4,"SA4 1JW, SA4 1LD, SA4 1LF, SA4 1LU, SA4 8JW, SA4 8LF, SA4 8LU",318,253,65
W00004517,SA4,"SA4 1LY, SA4 1LZ, SA4 1NA, SA4 1PE, SA4 1PL, SA4 1PN, SA4 1PR, SA4 8LY, SA4 8LZ, SA4 8NA, SA4 8PE, SA4 8PL, SA4 8PN, SA4 8PR",333,258,75
W00010233,SA4,"SA4 3GN, SA4 3GP, SA4 3GR, SA4 3GS, SA4 3GT, SA4 3GU, SA4 3JA",291,256,35
W00004521,SA4,"SA4 1QT, SA4 1QU, SA4 1QX, SA4 1RD, SA4 1ST, SA4 1SU, SA4 1SX, SA4 1TA, SA4 1TB, SA4 1TD, SA4 1TQ, SA4 8QT, SA4 8QU, SA4 8QX, SA4 8RD, SA4 8RJ, SA4 8RP, SA4 8RQ, SA4 8RR, SA4 8SA, SA4 8ST, SA4 8TA, SA4 8TB, SA4 8TD, SA4 8TF, SA4 8TQ, SA4 8WD",362,291,71
W00004439,SA4,"SA4 3SA, SA4 3SG, SA4 3SN, SA4 3SP, SA4 3SR, SA4 3SW",235,213,22
W00010445,SA4,"SA4 1GP, SA4 9DB, SA4 9DN, SA4 9FB, SA4 9FD, SA4 9FF, SA4 9FG, SA4 9GP",295,245,50
W00010234,SA4,"SA4 3AG, SA4 3AH, SA4 3AJ, SA4 3AP, SA4 3AQ, SA4 3BH, SA4 3BP, SA4 3BQ, SA4 3EE",266,237,29
W00010393,SA4,"SA4 1GU, SA4 1GX, SA4 1WB, SA4 1WD, SA4 9DJ, SA4 9DL, SA4 9FE, SA4 9FH, SA4 9GX, SA4 9WB, SA4 9WD",253,215,38
W00010411,SA4,"SA4 2AW, SA4 2SZ, SA4 6AA, SA4 6AE, SA4 6AW, SA4 6SZ",276,243,33
W00004523,SA4,"SA4 1HX, SA4 1HY, SA4 1HZ, SA4 1JD, SA4 1JT, SA4 8HX, SA4 8HY, SA4 8HZ, SA4 8JD, SA4 8JT",323,265,58
W00004522,SA4,"SA4 1HU, SA4 1JA, SA4 1JB, SA4 1LR, SA4 1LS, SA4 1LT, SA4 8HU, SA4 8JA, SA4 8LR, SA4 8LS, SA4 8LT, SA4 8WA, SA4 8WB",332,222,110
W00004479,SA4,"SA4 1BB, SA4 1BG, SA4 1BQ, SA4 1BT, SA4 9BB, SA4 9BG, SA4 9BQ, SA4 9BT, SA4 9DE",312,278,34
W00004482,SA4,"SA4 1AA, SA4 1BR, SA4 1BW, SA4 1GD, SA4 1WE, SA4 1WH, SA4 1WQ, SA4 3RU, SA4 9AA, SA4 9AH, SA4 9BR, SA4 9BW, SA4 9GD, SA4 9WE, SA4 9WH, SA4 9WQ",284,259,25
W00010356,SA4,"SA4 2HE, SA4 2HF, SA4 2HW, SA4 2LD, SA4 2LE, SA4 2LF, SA4 2LG, SA4 2LH, SA4 2LL, SA4 2LN, SA4 2LQ, SA4 2LT, SA4 4HE, SA4 4HF, SA4 4HW, SA4 4LD, SA4 4LE, SA4 4LF, SA4 4LG, SA4 4LH, SA4 4LL, SA4 4LN, SA4 4LQ, SA4 4LT, SA5 4NL, SA5 4NN, SA5 4NP, SA5 4NR, SA5 4NS, SA5 4NT, SA5 4NW",350,267,83
W00004483,SA4,"SA4 1BH, SA4 1BJ, SA4 1BL, SA4 1BP, SA4 1BS, SA4 9BF, SA4 9BH, SA4 9BJ, SA4 9BL, SA4 9BP, SA4 9BS, SA4 9DD",308,291,17
W00004440,SA4,"SA4 3JH, SA4 3JJ, SA4 3JL, SA4 3JN, SA4 3JQ",274,260,14
W00004484,SA4,"SA4 1AJ, SA4 1AL, SA4 1AN, SA4 1AP, SA4 1AR, SA4 1AW, SA4 1AZ, SA4 1BU, SA4 1BX, SA4 1BY, SA4 9AJ, SA4 9AL, SA4 9AN, SA4 9AP, SA4 9AR, SA4 9AW, SA4 9AZ, SA4 9BU, SA4 9BX, SA4 9BY, SA4 9GS, SA4 9GY",343,293,50
W00004486,SA4,"SA4 1AF, SA4 1AG, SA4 1AS, SA4 1AT, SA4 1AU, SA4 1BN, SA4 1BZ, SA4 1DA, SA4 1FY, SA4 1ZP, SA4 9AF, SA4 9AG, SA4 9AS, SA4 9AT, SA4 9AU, SA4 9BN, SA4 9BZ, SA4 9DA, SA4 9DH, SA4 9FY, SA4 9ZP, SA5 4PA, SA5 4PD, SA5 4PE, SA5 4PF",378,313,65
W00010375,SA4,"SA4 2QT, SA4 2QU, SA4 2QX, SA4 2RQ, SA4 6PA, SA4 6PB, SA4 6PD, SA4 6PE, SA4 6PF, SA4 6PX, SA4 6QT, SA4 6QU, SA4 6QX",331,264,67
W00004255,SA4,"SA4 1EB, SA4 1ED, SA4 1EE, SA4 1EY, SA4 1EZ, SA4 9DR, SA4 9EB, SA4 9ED, SA4 9EE, SA4 9EY, SA4 9EZ, SA4 9FA",482,391,91
W00004254,SA4,"SA4 1DG, SA4 1DW, SA4 1EF, SA4 1EP, SA4 1ER, SA4 1ET, SA4 1EW, SA4 1GR, SA4 1HW, SA4 1WA, SA4 9DG, SA4 9DQ, SA4 9DS, SA4 9DW, SA4 9DZ, SA4 9EF, SA4 9EP, SA4 9ER, SA4 9ET, SA4 9EW, SA4 9GR, SA4 9GT, SA4 9HW",290,233,57
W00004516,SA4,"SA4 1PP, SA4 1PS, SA4 1PT, SA4 1PW, SA4 8PP, SA4 8PS, SA4 8PT, SA4 8PW",280,239,41
W00010406,SA4,"SA4 1AQ, SA4 1AX, SA4 1AY, SA4 1BA, SA4 9AQ, SA4 9AX, SA4 9AY, SA4 9BA, SA4 9DP",274,214,60
W00010368,SA4,"SA4 2AT, SA4 3AB, SA4 6AD, SA4 6AF, SA4 6AT, SA4 6PQ, SA4 6PT, SA4 6QA",322,264,58
W00004515,SA4,"SA4 1NB, SA4 1ND, SA4 1NE, SA4 1NF, SA4 1NG, SA4 1NQ, SA4 1NW, SA4 1NZ, SA4 8NB, SA4 8ND, SA4 8NE, SA4 8NF, SA4 8NG, SA4 8NQ, SA4 8NW, SA4 8NZ",277,222,55
W00004435,SA4,"SA4 3GD, SA4 3RJ, SA4 3RL, SA4 3RN, SA4 3RP, SA4 3RS, SA4 3RT, SA4 3RX, SA4 3RZ",258,221,37
W00004438,SA4,"SA4 3SB, SA4 3SD, SA4 3SE, SA4 3SF, SA4 3SL, SA4 3SQ, SA4 3SS",350,310,40
W00004502,SA4,"SA4 2PD, SA4 2PF, SA4 2UY, SA4 2XA, SA4 2XD, SA4 2XE, SA4 4PD, SA4 4PE, SA4 4PF, SA4 4UY, SA4 4XA, SA4 4XD, SA4 4XE",317,268,49
W00004501,SA4,"SA4 2XY, SA4 2ZA, SA4 2ZB, SA4 2ZD, SA4 2ZE, SA4 4XY, SA4 4YD, SA4 4ZA, SA4 4ZB, SA4 4ZD, SA4 4ZE",258,228,30
W00004500,SA4,"SA4 2UX, SA4 2UZ, SA4 2XG, SA4 2XP, SA4 2XQ, SA4 4UZ, SA4 4XG, SA4 4XP, SA4 4XQ",324,291,33
W00004499,SA4,"SA4 2FD, SA4 2JG, SA4 2JY, SA4 2JZ, SA4 2YY, SA4 2ZG, SA4 4FD, SA4 4JG, SA4 4JY, SA4 4JZ, SA4 4YY, SA4 4ZG, SA4 6TH",232,201,31
W00004253,SA4,"SA4 1DS, SA4 1DT, SA4 1DY, SA4 1EA, SA4 1EL, SA4 1EU, SA4 1EX, SA4 1HA, SA4 1HB, SA4 1HD, SA4 1HE, SA4 1HG, SA4 8DS, SA4 8DU, SA4 9DT, SA4 9DY, SA4 9EA, SA4 9EL, SA4 9EU, SA4 9EX, SA4 9HA, SA4 9HB, SA4 9HD, SA4 9HG",256,191,65
W00004252,SA4,"SA4 0ZH, SA4 1JG, SA4 1LB, SA4 1QS, SA4 1RX, SA4 1ZH, SA4 1ZJ, SA4 1ZL, SA4 1ZQ, SA4 9JG, SA4 9LB, SA4 9QS, SA4 9RX, SA4 9XU, SA4 9XZ, SA4 9ZJ, SA4 9ZQ",532,424,108
W00004503,SA4,"SA4 2GB, SA4 2NB, SA4 2YR, SA4 4GB, SA4 4NB, SA4 4YR",253,221,32
W00004251,SA4,"SA4 1EN, SA4 1ES, SA4 1QW, SA4 1QY, SA4 9EN, SA4 9ES, SA4 9QW, SA4 9QY",229,190,39
W00004249,SA4,"SA4 1EG, SA4 1EH, SA4 1EJ, SA4 1EQ, SA4 9DU, SA4 9EG, SA4 9EH, SA4 9EJ, SA4 9EQ",281,220,61
W00004248,SA4,"SA4 1FU, SA4 1GT, SA4 1HL, SA4 1JJ, SA4 1NX, SA4 9FU, SA4 9GU, SA4 9HJ, SA4 9HL, SA4 9JJ, SA4 9NX, SA5 5WL, SA5 5WN, SA5 5WP, SA5 5WR, SA5 5WU, SA5 5WW, SA5 7DU, SA5 7HL, SA5 7LB, SA5 7LD, SA5 7LE, SA5 7LF, SA5 7LG, SA5 7LH, SA5 7LJ, SA5 7LN, SA5 7LP, SA5 7LQ, SA5 7LR, SA5 7LS, SA5 7LT, SA5 7LU, SA5 7LW, SA5 7LY, SA5 7PA, SA5 7PB, SA5 7PD, SA5 7PE, SA6 6NR, SA6 6NU, SA6 6NX",312,260,52
W00004524,SA4,"SA4 1AH, SA4 1LH, SA4 1LL, SA4 1RA, SA4 1RB, SA4 1RE, SA4 1RG, SA4 1RQ, SA4 1SR, SA4 8LH, SA4 8LL, SA4 8RA, SA4 8RB, SA4 8RE, SA4 8RG, SA4 8SR",302,217,85
W00004496,SA4,"SA4 2FA, SA4 2FB, SA4 2GW, SA4 2YA, SA4 2YD, SA4 2YF, SA4 2YX, SA4 4BF, SA4 4FA, SA4 4FB, SA4 4GN, SA4 4GW, SA4 4XT, SA4 4XU, SA4 4YA, SA4 4YF, SA4 4YH, SA4 4YX, SA4 4YZ, SA4 6PY, SA4 6PZ",447,388,59
W00004497,SA4,"SA4 2FU, SA4 2FX, SA4 2HH, SA4 2LX, SA4 2XL, SA4 2YG, SA4 2YQ, SA4 4AW, SA4 4FU, SA4 4FX, SA4 4HH, SA4 4HP, SA4 4LX, SA4 4XL, SA4 4YG, SA4 4YQ",324,261,63
W00004498,SA4,"SA4 2FR, SA4 2FS, SA4 2FT, SA4 2UU, SA4 2XH, SA4 2XJ, SA4 2XN, SA4 2XW, SA4 4AB, SA4 4FR, SA4 4FS, SA4 4FT, SA4 4HR, SA4 4UU, SA4 4XH, SA4 4XJ, SA4 4XN, SA4 4XW",420,355,65
W00004250,SA4,"SA4 1JL, SA4 1NY, SA4 1QL, SA4 1QZ, SA4 1SF, SA4 1SP, SA4 1SW, SA4 9JL, SA4 9NY, SA4 9QL, SA4 9QZ, SA4 9SF, SA4 9SP, SA4 9SW, SA4 9UZ",347,300,47
W00004429,SA4,"SA4 3FA, SA4 3FD, SA4 3FE, SA4 3FF, SA4 3FG, SA4 3FH, SA4 3FN, SA4 3FU, SA4 3GL, SA4 3XA, SA4 3YL, SA4 3YP, SA4 3YQ, SA4 3YS, SA4 3YU, SA4 3YX, SA4 3YY, SA4 3YZ",281,241,40
W00004430,SA4,"SA4 3AL, SA4 3FJ, SA4 3FL, SA4 3FP, SA4 3FQ, SA4 3FS, SA4 3FX, SA4 3FZ, SA4 3GB, SA4 3JT, SA4 3JU, SA4 3JX, SA4 3JY, SA4 3JZ, SA4 3LB, SA4 3LD, SA4 3LE, SA4 3LF, SA4 3YN, SA4 3YR, SA4 3YW",303,254,49
W00004431,SA4,"SA4 3GX, SA4 3HY, SA4 3HZ, SA4 3JB, SA4 3JD, SA4 3JE, SA4 3JP, SA4 3JS, SA4 3LA, SA4 3LX, SA4 3NA, SA4 3RG, SA4 3RH, SA4 3RQ, SA4 3RR, SA4 3SX, SA4 3TG, SA4 3TH, SA4 3TL, SA4 3TP, SA4 3TQ, SA4 3TR, SA4 3TS, SA4 3TT, SA4 3TU, SA4 3TX, SA4 3TY, SA4 3UA, SA4 3UD, SA4 3UE, SA4 3UF, SA4 3UH, SA4 3UJ, SA4 3UN, SA4 3UQ, SA4 3UR",404,351,53
W00004437,SA4,"SA4 3FT, SA4 3GA, SA4 3GW, SA4 3JR, SA4 3JW, SA4 3LL, SA4 3LQ, SA4 3XR, SA4 3XS, SA4 3XT, SA4 3YG",234,202,32
W00004436,SA4,"SA4 3XN, SA4 3XU, SA4 3XX, SA4 3XY, SA4 3XZ, SA4 3YA, SA4 3YD, SA4 3YE, SA4 3YF, SA4 3YJ",272,235,37
W00004512,SA4,"SA4 2GU, SA4 2GY, SA4 2WA, SA4 2WB, SA4 2WE, SA4 2WF, SA4 2WG, SA4 2WL, SA4 4GU, SA4 4GY, SA4 4WA, SA4 4WB, SA4 4WE, SA4 4WF, SA4 4WG, SA4 4WL",344,295,49
W00004511,SA4,"SA4 1DB, SA4 1DD, SA4 1DE, SA4 1DH, SA4 1DJ, SA4 1DL, SA4 1DN, SA4 1DP, SA4 1DQ, SA4 1DR, SA4 1DU, SA4 1LA, SA4 1XT, SA4 2JW, SA4 2WD, SA4 2WH, SA4 2WJ, SA4 2WQ, SA4 4JW, SA4 4WD, SA4 4WH, SA4 4WP, SA4 4WQ, SA4 4WR, SA4 8DA, SA4 8DB, SA4 8DD, SA4 8DE, SA4 8DF, SA4 8DH, SA4 8DJ, SA4 8DL, SA4 8DN, SA4 8DQ, SA4 8DR, SA4 8LA",403,342,61
W00004510,SA4,"SA4 2GP, SA4 2GR, SA4 2GS, SA4 2GT, SA4 2GX, SA4 2GZ, SA4 2WN, SA4 4GP, SA4 4GR, SA4 4GS, SA4 4GT, SA4 4GZ, SA4 4WN",372,326,46
W00010257,SA4,"SA4 1HJ, SA4 8BH, SA4 8ED, SA4 8EE, SA4 8EF, SA4 8EG, SA4 8HJ, SA4 8JG",270,198,72
W00004509,SA4,"SA4 2XB, SA4 2XZ, SA4 2YB, SA4 2YE, SA4 2YJ, SA4 4XB, SA4 4XZ, SA4 4YB, SA4 4YE, SA4 4YJ",297,257,40
W00004434,SA4,"SA4 3RD, SA4 3RF, SA4 3RW, SA4 3XB, SA4 3XD",249,226,23
W00004508,SA4,"SA4 2YL, SA4 2YN, SA4 2YP, SA4 2YT, SA4 2YW, SA4 4YL, SA4 4YN, SA4 4YP, SA4 4YS, SA4 4YT, SA4 4YW",302,271,31
W00004507,SA4,"SA4 2FY, SA4 2GD, SA4 2ND, SA4 2NE, SA4 2NF, SA4 2YS, SA4 2YU, SA4 4FY, SA4 4GD, SA4 4GJ, SA4 4GL, SA4 4GX, SA4 4HB, SA4 4ND, SA4 4NF, SA4 4YU",457,396,61
W00004506,SA4,"SA4 2GE, SA4 2GF, SA4 2GH, SA4 2GQ, SA4 2JP, SA4 2LJ, SA4 4FH, SA4 4GE, SA4 4GF, SA4 4GH, SA4 4GQ, SA4 4JP, SA4 4LJ",281,255,26
W00004505,SA4,"SA4 2FG, SA4 2LP, SA4 2LR, SA4 2LS, SA4 2LU, SA4 2LY, SA4 2LZ, SA4 2NA, SA4 4FG, SA4 4LP, SA4 4LR, SA4 4LS, SA4 4LU, SA4 4LY, SA4 4LZ, SA4 4NA, SA4 4NH",265,236,29
W00004504,SA4,"SA4 2DH, SA4 2FZ, SA4 2GA, SA4 2JL, SA4 2JN, SA4 4DH, SA4 4FZ, SA4 4GA, SA4 4JL, SA4 4JN",327,275,52
W00004433,SA4,"SA4 3LG, SA4 3LH, SA4 3LJ, SA4 3LN, SA4 3LS, SA4 3LT, SA4 3LU, SA4 3LY, SA4 3LZ, SA4 3XE, SA4 3XF, SA4 3XG, SA4 3XH, SA4 3XJ, SA4 3XL, SA4 3XP, SA4 3XQ, SA4 3XW",259,223,36
W00004432,SA4,"SA4 3RY, SA4 3SH, SA4 3SJ, SA4 3SU, SA4 3TA, SA4 3TB, SA4 3TF, SA4 3TJ, SA4 3TN, SA4 3TW, SA4 3TZ",359,322,37
W00004514,SA4,"SA4 1RS, SA4 1RT, SA4 1RY, SA4 1RZ, SA4 8RS, SA4 8RT, SA4 8RY, SA4 8RZ",303,240,63
W00004525,SA4,"SA4 1LE, SA4 1LN, SA4 1LP, SA4 1LW, SA4 1RF, SA4 1RH, SA4 1RJ, SA4 1RN, SA4 8LD, SA4 8LE, SA4 8LN, SA4 8LP, SA4 8LW, SA4 8RF, SA4 8RH, SA4 8RN, SA4 8SP",288,216,72
W00003578,SA4,"SA4 0FT, SA4 0TG, SA4 0TT, SA4 0TU, SA4 0TY, SA4 0TZ, SA4 0UA, SA4 0YP, SA4 0YW, SA4 0ZE, SA4 0ZN, SA4 1FT, SA4 1TG, SA4 1TT, SA4 1TU, SA4 1TY, SA4 1TZ, SA4 1UA, SA4 1YP",270,161,109
W00004527,SA4,"SA4 1DZ, SA4 1HS, SA4 1HT, SA4 1LG, SA4 1LQ, SA4 8EA, SA4 8EB, SA4 8EH, SA4 8HS, SA4 8HT, SA4 8LG, SA4 8LQ",400,256,144
W00004298,SA4,"SA4 2GL, SA4 2SJ, SA4 2XR, SA4 6GL, SA4 6SJ, SA4 6XA, SA4 6XR",250,213,37
W00004299,SA4,"SA4 2SL, SA4 2SN, SA4 2ST, SA4 2XX, SA4 6SL, SA4 6SN, SA4 6ST, SA4 6XX, SA4 6YB",185,164,21
W00004300,SA4,"SA4 2TX, SA4 2TZ, SA4 2UA, SA4 2UG, SA4 6AB, SA4 6TX, SA4 6TZ, SA4 6UA, SA4 6UG, SA4 6UJ, SA4 6UR",588,493,95
W00004142,SA4,"SA4 3NX, SA4 3NZ, SA4 3PA, SA4 3PD, SA4 3PG, SA4 3PP, SA4 3QG",315,277,38
W00004303,SA4,"SA4 1NS, SA4 8NS, SA4 9HE, SA5 7NA, SA5 7NB, SA5 7ND, SA5 7NH, SA5 7NJ, SA5 7NL, SA5 7NQ, SA5 7PG, SA5 7PH, SA5 7PJ, SA5 7PL, SA5 7PN, SA5 7PP, SA5 7PQ, SA5 7PR, SA5 7PS, SA5 7PT, SA5 7PU",298,173,125
W00004141,SA4,"SA4 3HR, SA4 3HT, SA4 3HU, SA4 3NB, SA4 3NU, SA4 3PX, SA4 3PY, SA4 3PZ, SA4 3QA, SA4 3QB, SA4 3QD, SA4 3QH, SA4 3QJ",266,232,34
W00004140,SA4,"SA4 3ND, SA4 3NG, SA4 3NY, SA4 3PB, SA4 3PE, SA4 3PW, SA4 3QY, SA4 3QZ, SA4 3RA, SA4 3YH",358,317,41
W00003586,SA4,"SA4 0AD, SA4 0UD, SA4 0UG, SA4 0UH, SA4 0UQ, SA4 0XS, SA4 1UD, SA4 1UG, SA4 1UH",316,163,153
W00003587,SA4,"SA4 0TJ, SA4 0TN, SA4 0TQ, SA4 0TS, SA4 0TW, SA4 0UL, SA4 0US, SA4 1TJ, SA4 1TN, SA4 1TR, SA4 1TS, SA4 1TW, SA4 1UF, SA4 1UL, SA4 1US",375,237,138
W00003588,SA4,"SA4 0TX, SA4 0UB, SA4 0UE, SA4 0UJ, SA4 0ZW, SA4 1TP, SA4 1TX, SA4 1UB, SA4 1UE, SA4 1UJ",333,223,110
W00010069,SA4,"SA4 1RP, SA4 1SJ, SA4 8AB, SA4 8AD, SA4 8AE, SA4 8AG, SA4 8SJ, SA4 8SN",234,169,65
W00010076,SA4,"SA4 2BL, SA4 2BP, SA4 2BR, SA4 2BS, SA4 2BT, SA4 2BU, SA4 2BX, SA4 2BZ, SA4 2DA, SA4 2DB, SA4 2EE, SA4 2EH, SA4 2FE, SA4 2GN, SA4 2NQ, SA4 4BL, SA4 4BP, SA4 4BR, SA4 4BS, SA4 4BT, SA4 4BU, SA4 4BX, SA4 4BZ, SA4 4DA, SA4 4DB, SA4 4DJ, SA4 4EE, SA4 4EH, SA4 4EJ, SA4 4FE",219,198,21
W00010078,SA4,"SA4 1GH, SA4 1ZS, SA4 1ZT, SA4 9GH, SA4 9GJ, SA4 9WW, SA4 9ZS, SA4 9ZT",378,318,60
W00010079,SA4,"SA4 1JP, SA4 1WZ, SA4 1YG, SA4 1ZA, SA4 8BA, SA4 8BL, SA4 8BW, SA4 8JB, SA4 8JL, SA4 8JP, SA4 8JZ",280,217,63
W00004526,SA4,"SA4 1HR, SA4 1JH, SA4 1LJ, SA4 1NT, SA4 1NU, SA4 1WN, SA4 1WX, SA4 1YF, SA4 1YW, SA4 1ZE, SA4 1ZG, SA4 8HR, SA4 8JH, SA4 8LJ, SA4 8NT, SA4 8NU",223,166,57
W00010082,SA4,"SA4 1RL, SA4 1RR, SA4 1SA, SA4 1SS, SA4 1SY, SA4 1SZ, SA4 1TE, SA4 1TH, SA4 1TL, SA4 1UQ, SA4 8RL, SA4 8SS, SA4 8SY, SA4 8SZ, SA4 8TE, SA4 8TH, SA4 8TJ, SA4 8TL, SA4 8UQ, SA4 8WQ, SA4 8WZ",174,139,35
W00010085,SA4,"SA4 1JE, SA4 1JF, SA4 1JQ, SA4 1JR, SA4 8JE, SA4 8JF, SA4 8JJ, SA4 8JQ, SA4 8JR",203,138,65
W00004297,SA4,"SA4 2GG, SA4 2GJ, SA4 2UH, SA4 2UQ, SA4 6GG, SA4 6GJ, SA4 6RW, SA4 6UH, SA4 6UQ",355,283,72
W00004681,SA4,"SA4 2QJ, SA4 2QL, SA4 2QN, SA4 2QP, SA4 2QR, SA4 2QS, SA4 2QW, SA4 2UB, SA4 2UD, SA4 6QJ, SA4 6QL, SA4 6QN, SA4 6QP, SA4 6QR, SA4 6QS, SA4 6QW, SA4 6UB, SA4 6UD",337,272,65
W00004296,SA4,"SA4 2JE, SA4 2SP, SA4 2SQ, SA4 2UE, SA4 2UF, SA4 6JE, SA4 6SP, SA4 6SQ, SA4 6UE, SA4 6UF",263,239,24
W00004294,SA4,"SA4 2TJ, SA4 2TL, SA4 2TN, SA4 2TP, SA4 2TR, SA4 2TS, SA4 2TT, SA4 2TU, SA4 2TW, SA4 2TY, SA4 6TB, SA4 6TJ, SA4 6TL, SA4 6TN, SA4 6TP, SA4 6TR, SA4 6TS, SA4 6TT, SA4 6TU, SA4 6TW, SA4 6TY, SA4 6UN, SA4 6UP",367,310,57
W00003579,SA4,"SA4 0FW, SA4 0XF, SA4 0XG, SA4 0XQ, SA4 0XX, SA4 1FW, SA4 1XF, SA4 1XG, SA4 1XQ, SA4 1XU, SA4 1XX",295,157,138
W00003580,SA4,"SA4 0TR, SA4 0UN, SA4 0UR, SA4 0UT, SA4 0UW, SA4 0UX, SA4 0XA, SA4 0XD, SA4 0XP, SA4 1UN, SA4 1UR, SA4 1UT, SA4 1UW, SA4 1UX, SA4 1XA, SA4 1XP, SA4 1XS",263,166,97
W00003581,SA4,"SA4 0AA, SA4 0AB, SA4 0FF, SA4 0FG, SA4 0XJ, SA4 0XL, SA4 1FF, SA4 1FG, SA4 1XH, SA4 1XJ, SA4 1XL",468,305,163
W00003582,SA4,"SA4 0XB, SA4 0XH, SA4 0XN, SA4 0XR, SA4 0XT, SA4 1XB, SA4 1XN, SA4 1XR",307,214,93
W00003584,SA4,"SA4 0FB, SA4 0FD, SA4 0FJ, SA4 0FL, SA4 0FN, SA4 0FQ, SA4 0XW, SA4 0YR, SA4 0YS, SA4 0YT, SA4 0YU, SA4 0YX, SA4 0YY, SA4 0YZ, SA4 0ZG, SA4 0ZL, SA4 1FA, SA4 1FB, SA4 1FD, SA4 1FJ, SA4 1FL, SA4 1FN, SA4 1FQ, SA4 1XW, SA4 1YR, SA4 1YS, SA4 1YT, SA4 1YU, SA4 1YX, SA4 1YY, SA4 1ZN",268,177,91
W00003585,SA4,"SA4 0TF, SA4 0TP, SA4 0UP, SA4 0UU, SA4 0UY, SA4 0UZ, SA4 0XE, SA4 1TF, SA4 1UP, SA4 1UU, SA4 1UY, SA4 1UZ, SA4 1XE",264,158,106
W00004149,SA4,"SA4 2BW, SA4 2BY, SA4 4AX, SA4 4BE, SA4 4BH, SA4 4BW, SA4 4BY",269,226,43
W00004150,SA4,"SA4 2NX, SA4 2US, SA4 2UT, SA4 4NX, SA4 4UA, SA4 4US, SA4 4UX",231,197,34
W00004151,SA4,"SA4 2DL, SA4 2DN, SA4 2DP, SA4 2DR, SA4 2DS, SA4 2DT, SA4 2DU, SA4 2DW, SA4 2WP, SA4 2WR, SA4 2WS, SA4 2WT, SA4 2WU, SA4 2WY, SA4 4DL, SA4 4DN, SA4 4DP, SA4 4DR, SA4 4DS, SA4 4DT, SA4 4DU, SA4 4DW",293,267,26
W00004152,SA4,"SA4 2AH, SA4 2AJ, SA4 2BB, SA4 2BD, SA4 2NJ, SA4 2NR, SA4 2NS, SA4 2UN, SA4 2UP, SA4 4AH, SA4 4AJ, SA4 4NJ, SA4 4NR, SA4 4NS, SA4 4UN, SA4 4UP, SA4 6BB, SA4 6BD",303,243,60
W00004153,SA4,"SA4 2AA, SA4 2AD, SA4 2DZ, SA4 2EF, SA4 2EG, SA4 2EJ, SA4 2EL, SA4 2EQ, SA4 4AA, SA4 4AD, SA4 4DZ, SA4 4EF, SA4 4EG, SA4 4EL, SA4 4EQ, SA4 4QN",394,345,49
W00004154,SA4,"SA4 2NL, SA4 2NN, SA4 2NP, SA4 2NT, SA4 2NU, SA4 2NW, SA4 2UJ, SA4 2UL, SA4 2UR, SA4 2UW, SA4 2XF, SA4 4NL, SA4 4NN, SA4 4NT, SA4 4NU, SA4 4NW, SA4 4UF, SA4 4UJ, SA4 4UL, SA4 4UR, SA4 4UT, SA4 4UW, SA4 4XF",393,323,70
W00004155,SA4,"SA4 1GA, SA4 1GB, SA4 2DG, SA4 2DY, SA4 2JH, SA4 2JJ, SA4 2JR, SA4 4DG, SA4 4DQ, SA4 4DY, SA4 4EW, SA4 4GG, SA4 4JH, SA4 4JJ, SA4 4JR, SA4 9GA, SA4 9GB",187,167,20
W00004157,SA4,"SA4 2NY, SA4 2WW, SA4 4NY, SA4 4NZ, SA4 4PG, SA4 4PH, SA4 4PJ, SA4 4PL, SA4 4PN, SA4 4PP, SA4 4PR, SA4 4PS, SA4 4WJ",477,417,60
W00004158,SA4,"SA4 2FL, SA4 2FN, SA4 2FP, SA4 2FW, SA4 2WX, SA4 2WZ, SA4 4FL, SA4 4FN, SA4 4FP, SA4 4FW, SA4 4NP, SA4 4WX, SA4 4ZN",292,255,37
W00004159,SA4,"SA4 2BN, SA4 2FF, SA4 2FJ, SA4 2FQ, SA4 4BN, SA4 4FF, SA4 4FJ, SA4 4FQ",344,303,41
W00004144,SA4,"SA4 3PF, SA4 3QE, SA4 3QF",161,152,9
W00004295,SA4,"SA4 2SG, SA4 2SH, SA4 2SU, SA4 2SW, SA4 6SG, SA4 6SH, SA4 6SU, SA4 6SW, SA4 6TG",276,251,25
W00004680,SA4,"SA4 2JS, SA4 2JT, SA4 2JU, SA4 2JX, SA4 2QB, SA4 2QQ, SA4 2SS, SA4 6JS, SA4 6JT, SA4 6JU, SA4 6JX, SA4 6QB, SA4 6SS",279,235,44
W00010081,SA4,"SA4 1RU, SA4 1SB, SA4 1SG, SA4 1SH, SA4 1SN, SA4 8AF, SA4 8RU, SA4 8RX, SA4 8SB, SA4 8SF, SA4 8SG, SA4 8SH",293,206,87
W00004678,SA4,"SA4 2SA, SA4 2SD, SA4 2SE, SA4 2SF, SA4 6SA, SA4 6SD, SA4 6SE, SA4 6SF",325,265,60
W00004179,SA4,"SA4 3BR, SA4 3BT, SA4 3BU, SA4 3DD, SA4 3DE, SA4 3DH, SA4 3DY, SA4 3EP",305,269,36
W00004180,SA4,"SA4 3DG, SA4 3DN, SA4 3DP, SA4 3DQ, SA4 3DW",296,259,37
W00004181,SA4,"SA4 3AT, SA4 3AU, SA4 3AX, SA4 3AY, SA4 3AZ, SA4 3BA, SA4 3BB, SA4 3BD",268,232,36
W00004182,SA4,"SA4 3BJ, SA4 3DT, SA4 3DU, SA4 3QL, SA4 3QP",314,287,27
W00004183,SA4,"SA4 3AA, SA4 3AE, SA4 3AF, SA4 3BG, SA4 3EQ, SA4 3FR, SA4 3FW, SA4 3FY",197,176,21
W00004184,SA4,"SA4 3DS, SA4 3EF, SA4 3GE, SA4 3GG, SA4 3GQ",246,225,21
W00004186,SA4,"SA4 3EB, SA4 3ED, SA4 3GF, SA4 3GH",259,230,29
W00004205,SA4,"SA4 2BE, SA4 2BF, SA4 2BJ, SA4 2BQ, SA4 2PA, SA4 2PT, SA4 4BQ, SA4 4PA, SA4 4PT, SA4 6BE, SA4 6BG, SA4 6BJ",277,227,50
W00004206,SA4,"SA4 1WJ, SA4 2EA, SA4 2EB, SA4 2EP, SA4 2HG, SA4 2JQ, SA4 4BJ, SA4 4EA, SA4 4EB, SA4 4EP, SA4 4HG, SA4 4JQ, SA4 9WJ, SA4 9WP, SA4 9WR, SA4 9WS",213,190,23
W00004207,SA4,"SA4 2BA, SA4 2BH, SA4 2HZ, SA4 6BA, SA4 6BH, SA4 6HX, SA4 6HZ",295,255,40
W00004208,SA4,"SA4 2AE, SA4 2AF, SA4 4AE, SA4 4AF, SA4 4AT",135,118,17
W00004211,SA4,"SA4 2BG, SA4 2RD, SA4 2RE, SA4 2RJ, SA4 2RL, SA4 6RD, SA4 6RE, SA4 6RJ, SA4 6RL",261,218,43
W00004212,SA4,"SA4 2AP, SA4 2AU, SA4 2HU, SA4 2HX, SA4 2HY, SA4 2RB, SA4 2RH, SA4 4AP, SA4 4AZ, SA4 6HU, SA4 6HY, SA4 6RB, SA4 6RH",299,253,46
W00004213,SA4,"SA4 1WL, SA4 1WU, SA4 2ES, SA4 2HA, SA4 2HB, SA4 2HN, SA4 4ES, SA4 4HA, SA4 4HN, SA4 4QL",198,165,33
W00004215,SA4,"SA4 2AY, SA4 2AZ, SA4 2HT, SA4 6AU, SA4 6AY, SA4 6AZ, SA4 6HT",229,193,36
W00004216,SA4,"SA4 2JF, SA4 2QY, SA4 2RA, SA4 2RN, SA4 2SX, SA4 2SY, SA4 6JF, SA4 6QY, SA4 6RA, SA4 6RN, SA4 6SX, SA4 6SY",254,212,42
W00004217,SA4,"SA4 2EU, SA4 2EX, SA4 2EZ, SA4 2HD, SA4 2HQ, SA4 2NH, SA4 3BE, SA4 4AS, SA4 4EU, SA4 4EX, SA4 4EZ, SA4 4HD, SA4 4HQ",220,180,40
W00004218,SA4,"SA4 2ER, SA4 2ET, SA4 2EY, SA4 4ER, SA4 4ET, SA4 4EY",247,216,31
W00004530,SA4,"SA4 1PU, SA4 1PY, SA4 1PZ, SA4 1QA, SA4 1QB, SA4 1QD, SA4 1QG, SA4 1QH, SA4 1QJ, SA4 1QN, SA4 1QP, SA4 8NJ, SA4 8PU, SA4 8PY, SA4 8PZ, SA4 8QA, SA4 8QB, SA4 8QG, SA4 8QH, SA4 8QL, SA4 8QN, SA4 8QP",283,190,93
W00004529,SA4,"SA4 1LX, SA4 1PA, SA4 1PB, SA4 1PD, SA4 1PF, SA4 1PX, SA4 1QE, SA4 1QF, SA4 1QQ, SA4 1QR, SA4 1RW, SA4 1SD, SA4 1SE, SA4 1SL, SA4 1SQ, SA4 8LX, SA4 8PA, SA4 8PB, SA4 8PD, SA4 8PF, SA4 8PX, SA4 8QD, SA4 8QE, SA4 8QF, SA4 8QQ, SA4 8QR, SA4 8RW, SA4 8SD, SA4 8SE, SA4 8SL, SA4 8SQ",311,213,98
W00004528,SA4,"SA4 1DX, SA4 1HH, SA4 1HQ, SA4 1JN, SA4 1JS, SA4 1JU, SA4 1JX, SA4 1JY, SA4 1NH, SA4 1NJ, SA4 1NN, SA4 1NP, SA4 1NR, SA4 8DX, SA4 8HH, SA4 8HQ, SA4 8JN, SA4 8JS, SA4 8JU, SA4 8JX, SA4 8JY, SA4 8NH, SA4 8NN, SA4 8NP, SA4 8NR",261,166,95
W00004178,SA4,"SA4 3BL, SA4 3BN, SA4 3BS, SA4 3BW, SA4 3DA, SA4 3DB, SA4 3DF, SA4 3EA",288,244,44
W00004679,SA4,"SA4 2QA, SA4 2QD, SA4 2QF, SA4 2QG, SA4 2QH, SA4 2QZ, SA4 2SR, SA4 6AG, SA4 6AH, SA4 6AJ, SA4 6QD, SA4 6QF, SA4 6QG, SA4 6QH, SA4 6QQ, SA4 6QZ, SA4 6RQ, SA4 6SR",380,327,53
W00004210,SA4,"SA4 2AG, SA4 2AL, SA4 2AN, SA4 2AQ, SA4 2AR, SA4 2AS, SA4 2AX, SA4 4AG, SA4 4AL, SA4 4AN, SA4 4AQ, SA4 4AR, SA4 4AY",301,252,49
W00004677,SA4,"SA4 2RY, SA4 2RZ, SA4 2SB, SA4 2TA, SA4 2TB, SA4 2TD, SA4 6RY, SA4 6RZ, SA4 6SB, SA4 6TA, SA4 6TD",253,208,45
W00004676,SA4,"SA4 2PB, SA4 2PE, SA4 2PP, SA4 2PQ, SA4 2PU, SA4 2PY, SA4 2RF, SA4 2RG, SA4 4PB, SA4 4PQ, SA4 6PP, SA4 6PU, SA4 6RF, SA4 6RG",280,225,55
W00004177,SA4,"SA4 3DR, SA4 3EJ, SA4 3ER, SA4 3ES, SA4 3ET, SA4 3EU, SA4 3HA, SA4 3HD",320,277,43
W00004176,SA4,"SA4 3BX, SA4 3BY, SA4 3BZ, SA4 3EL, SA4 3GJ, SA4 3HF, SA4 3HG, SA4 3HH",378,320,58
W00004175,SA4,"SA4 3EG, SA4 3FB, SA4 3GY, SA4 3GZ, SA4 3HE, SA4 3HQ",264,223,41
W00004675,SA4,"SA4 2PG, SA4 2PH, SA4 2PN, SA4 2RT, SA4 2RU, SA4 6PG, SA4 6PH, SA4 6PN, SA4 6RT, SA4 6RU",316,282,34
W00004674,SA4,"SA4 2PJ, SA4 2RP, SA4 2RR, SA4 2RS, SA4 2RX, SA4 2TE, SA4 2TF, SA4 2TH, SA4 2TQ, SA4 2ZF, SA4 2ZH, SA4 2ZJ, SA4 2ZQ, SA4 4AU, SA4 4ZF, SA4 4ZQ, SA4 6PJ, SA4 6RP, SA4 6RR, SA4 6RS, SA4 6RX, SA4 6TE, SA4 6TF, SA4 6TQ",373,307,66
W00004673,SA4,"SA4 2PL, SA4 2PR, SA4 2PS, SA4 2PW, SA4 2QE, SA4 6PL, SA4 6PR, SA4 6PS, SA4 6PW, SA4 6QE",322,263,59
W00004171,SA4,"SA4 3DL, SA4 3EH, SA4 3EN, SA4 3EW, SA4 3HB",294,270,24
W00004172,SA4,"SA4 3AD, SA4 3AN, SA4 3AR, SA4 3AS, SA4 3AW, SA4 3DJ, SA4 3DZ",356,322,34
W00004174,SA4,"SA4 3DX, SA4 3EX, SA4 3EY, SA4 3EZ",305,269,36
W00002889,SA40,"SA40 9SP, SA40 9SR, SA40 9SS, SA40 9ST, SA40 9SU, SA40 9UG, SA40 9YA, SA40 9YF",250,140,110
W00003775,SA40,"SA40 9QG, SA40 9QH, SA40 9QJ, SA40 9QL, SA40 9QN, SA40 9QP, SA40 9QQ, SA48 8DX, SA48 8DZ, SA48 8EA, SA48 8EB, SA48 8ED, SA48 8EE, SA48 8EG",269,145,124
W00002812,SA40,"SA40 9WZ, SA40 9YU, SA40 9YX, SA40 9YZ, SA40 9ZP, SA46 0WY, SA46 0WZ, SA46 0XZ, SA46 0YA, SA46 0YG, SA46 0ZT, SA46 0ZU, SA46 0ZW, SA47 0WA, SA48 7AW, SA48 7BB, SA48 7BD, SA48 7BR, SA48 7BT, SA48 7DJ, SA48 7DL, SA48 7DN, SA48 7DR, SA48 7DS, SA48 7DT, SA48 7DU, SA48 7DW, SA48 7DX, SA48 7EE, SA48 7EF, SA48 7EG, SA48 7EH, SA48 7EJ, SA48 7EN, SA48 7EY, SA48 7HE, SA48 7HF, SA48 7WX, SA48 7XB, SA48 7YA, SA48 7YF, SA48 7YJ, SA48 7ZW, SA48 8WZ, SA48 8YB, SA48 8YE, SA48 8YF, SA48 8YJ, SA48 8YN, SA48 8YP, SA48 8YQ, SA48 8YR, SA48 8YS, SA48 8YT, SA48 8YU, SA48 9AA, SA48 9AB, SA48 9AD, SA48 9AE, SA48 9AF, SA48 9AG, SA48 9AH",284,134,150
W00003772,SA40,"SA40 9RS, SA40 9RU, SA40 9RX, SA40 9RY, SA40 9RZ, SA40 9SA, SA40 9SD, SA40 9SE, SA40 9TZ",222,95,127
W00003769,SA40,"SA40 9RG, SA40 9RT, SA40 9SF",230,115,115
W00002892,SA40,"SA40 9TB, SA40 9TD, SA40 9TE, SA40 9TF, SA40 9TG, SA40 9TP, SA40 9TR, SA40 9YL, SA40 9YR, SA40 9YS, SA48 7LP, SA48 7LR",240,113,127
W00003771,SA40,"SA40 9QA, SA40 9QB, SA40 9QD, SA40 9UA, SA40 9UB, SA40 9UD, SA40 9UE, SA40 9UW, SA40 9XP, SA40 9XS, SA40 9XT, SA40 9XX, SA40 9XY, SA40 9XZ",230,126,104
W00002823,SA40,"SA40 9TJ, SA40 9TL, SA40 9TN, SA47 0RN, SA47 0RT, SA47 0RU, SA47 0RX, SA47 0SA, SA47 0SB, SA48 7AH, SA48 7PY, SA48 7QP, SA48 7QU, SA48 7QW, SA48 7QX, SA48 7QY, SA48 7RA, SA48 7RB, SA48 7RD, SA48 7RH, SA48 7RJ, SA48 7RL, SA48 7RP",340,172,168
W00010061,SA40,"SA40 9YT, SA46 0WX, SA46 0YB, SA48 7DZ, SA48 7HH, SA48 7HX, SA48 7HZ, SA48 7LX, SA48 7YG, SA48 8YD, SA48 9AJ, SA48 9BA, SA48 9BB, SA48 9BD, SA48 9BE, SA48 9BF, SA48 9BG, SA48 9BH, SA48 9BJ, SA48 9BL, SA48 9BN, SA48 9BP, SA48 9BQ, SA48 9BR, SA48 9BS, SA48 9BT, SA48 9BU, SA48 9BW",109,64,45
W00002888,SA40,"SA40 9SX, SA40 9SY, SA40 9TA, SA40 9UH, SA40 9UR, SA40 9UT, SA40 9YB, SA40 9YD, SA48 7LN",295,150,145
W00003768,SA40,"SA40 9AA, SA40 9AB, SA40 9QT, SA40 9QU, SA40 9QX, SA40 9RA, SA40 9RL, SA40 9RN, SA40 9RP, SA40 9RQ, SA40 9RR, SA40 9RW, SA40 9TX, SA40 9TY, SA40 9XR, SA40 9XU",466,230,236
W00002891,SA40,"SA40 9XL, SA40 9YE, SA40 9YG, SA40 9YH, SA40 9YJ, SA40 9YN, SA40 9YP, SA40 9YQ, SA40 9YW, SA44 4UG, SA44 4UH",227,102,125
W00002838,SA40,"SA40 9TH, SA44 4EP, SA44 4ER, SA44 4EW, SA44 4HB, SA44 4HD, SA44 4HE, SA44 4HG, SA44 4XA, SA44 4XB, SA44 4XE, SA44 4XF, SA44 4XG, SA44 4XH, SA44 4XP, SA44 4YB, SA44 4YG, SA44 4YH, SA44 4YS",300,95,205
W00002995,SA41,"SA41 3RY, SA41 3SA, SA41 3SB, SA41 3SD, SA41 3SP, SA41 3SY, SA41 3TA, SA41 3TB, SA41 3TD, SA41 3TE, SA41 3TF, SA41 3TG, SA41 3TH, SA41 3TJ, SA41 3TL, SA41 3TN, SA41 3TP, SA41 3TQ, SA41 3TR, SA41 3TS, SA41 3TT, SA41 3TU, SA41 3TX, SA41 3UA, SA41 3UF, SA41 3UP, SA41 3UR, SA41 3UT, SA41 3UU, SA66 7RB",395,193,202
W00002991,SA41,"SA41 3QJ, SA41 3QL, SA41 3QN, SA41 3QZ, SA41 3RD, SA41 3RP, SA41 3RZ",310,91,219
W00002990,SA41,"SA41 3QD, SA41 3QE, SA41 3QF, SA41 3QG, SA41 3QH, SA41 3QQ, SA41 3RE, SA41 3RF, SA41 3RG, SA41 3RJ, SA41 3RL, SA41 3RN, SA41 3RR, SA41 3RW, SA41 3SJ",448,142,306
W00003290,SA41,"SA41 3PX, SA41 3UW, SA41 3UX, SA41 3UY, SA41 3XH, SA41 3XJ, SA41 3XL, SA41 3XN, SA42 0NF, SA42 0NG, SA42 0NH, SA42 0NN, SA42 0NQ, SA42 0NY, SA42 0PA, SA42 0PB, SA42 0PD, SA43 3PB, SA43 3PD, SA43 3PF, SA43 3PH",246,129,117
W00003291,SA41,"SA41 3TY, SA41 3TZ, SA41 3UB, SA41 3UD, SA41 3UE, SA41 3XA, SA41 3XB, SA41 3XD, SA41 3XE, SA41 3XF, SA41 3XG, SA41 3XW, SA42 0LX, SA42 0LY, SA42 0LZ, SA42 0NA, SA42 0NB, SA42 0NE, SA42 0NJ, SA42 0NL, SA42 0NP, SA42 0NR, SA42 0NT, SA42 0NU, SA42 0NW, SA42 0NX, SA42 0NZ, SA42 0QP, SA42 0QR, SA42 0QS, SA42 0QW, SA65 9TY",298,166,132
W00002996,SA42,"SA42 0YE, SA42 0YG, SA65 9SA, SA65 9SB, SA65 9SD, SA65 9SE, SA65 9SF, SA65 9SG, SA65 9SH, SA65 9SJ, SA65 9SL, SA65 9SN, SA65 9TA, SA65 9TB, SA65 9TD, SA65 9TE, SA65 9TG, SA65 9TH, SA65 9TJ, SA65 9TL, SA65 9TN, SA65 9TP, SA65 9TR, SA65 9TT, SA65 9TU, SA65 9TX, SA65 9UA, SA65 9YA, SA65 9YD, SA65 9YL, SA65 9YN, SA66 7RE",290,128,162
W00002997,SA42,"SA42 0SA, SA42 0SB, SA42 0SF, SA42 0SG, SA42 0SH, SA42 0SL, SA42 0SN, SA42 0SQ, SA42 0SU, SA42 0UJ, SA42 0UN, SA42 0UP, SA42 0UT, SA42 0UY, SA42 0UZ, SA42 0XB, SA42 0XD",281,161,120
W00002998,SA42,"SA42 0SD, SA42 0SE, SA42 0XF, SA42 0XH, SA42 0XJ, SA42 0XL, SA42 0XN, SA42 0XQ, SA42 0XW, SA42 0YA, SA42 0YB",196,101,95
W00002999,SA42,"SA42 0SJ, SA42 0SP, SA42 0SW, SA42 0UH, SA42 0UQ, SA42 0UR, SA42 0UU, SA42 0UW, SA42 0UX, SA42 0XA, SA42 0XE, SA42 0XG, SA42 0XP, SA42 0XR, SA42 0XS, SA42 0XT, SA42 0XU, SA42 0XX, SA42 0XY, SA42 0YD, SA42 0YH, SA65 9ET, SA65 9SP, SA65 9SR",269,166,103
W00003014,SA42,"SA42 0WQ, SA42 0WZ, SA64 0YJ, SA64 0YQ, SA64 0YS, SA64 0ZQ, SA65 0AA, SA65 0AB, SA65 0AD, SA65 0AE, SA65 0AF, SA65 0AG, SA65 0AH, SA65 0AJ, SA65 0AL, SA65 0AN, SA65 0AP, SA65 9AA, SA65 9AB, SA65 9AJ, SA65 9HB, SA65 9HG, SA65 9LU, SA65 9NB, SA65 9NF, SA65 9NQ, SA65 9NR, SA65 9NT, SA65 9NY, SA65 9PA, SA65 9PB, SA65 9PD, SA65 9PE, SA65 9PG, SA65 9WW, SA65 9WY, SA65 9WZ, SA65 9YB, SA65 9YE, SA65 9YF, SA65 9YP, SA65 9YW",261,184,77
W00002733,SA42,"SA42 0ND, SA43 1DB, SA43 1DH, SA43 1DJ, SA43 1DL, SA43 1DP, SA43 1ET, SA43 1EU, SA43 1EX, SA43 1EY, SA43 1FA, SA43 1HA, SA43 1HB, SA43 1HD, SA43 1HE, SA43 1HH, SA43 1HJ, SA43 3AB, SA43 3AD, SA43 3AF, SA43 3AG, SA43 3AH, SA43 3AL",202,122,80
W00003199,SA42,"SA42 0PY, SA42 0PZ, SA42 0QE, SA42 0QF, SA42 0QG, SA42 0QH, SA42 0QJ, SA42 0QL, SA42 0QN, SA42 0QT, SA42 0QU, SA42 0QX, SA42 0QY, SA42 0QZ, SA42 0SR, SA42 0SS, SA42 0ST, SA42 0UE, SA42 0UF, SA42 0UG, SA42 0YF",276,157,119
W00003202,SA42,"SA42 0RH, SA42 0RQ, SA42 0TE, SA42 0TJ, SA42 0TL, SA42 0TN, SA42 0TP, SA42 0TR, SA42 0TT, SA42 0TU",296,142,154
W00003200,SA42,"SA42 0RF, SA42 0RG, SA42 0RJ, SA42 0RN, SA42 0RP, SA42 0RR, SA42 0RS, SA42 0RT, SA42 0RU, SA42 0RW, SA42 0RX, SA42 0RY, SA42 0RZ, SA42 0SX, SA42 0TD, SA42 0TF, SA42 0TG, SA42 0TY, SA42 0TZ, SA42 0UA, SA42 0UB",214,151,63
W00003201,SA42,"SA42 0LT, SA42 0LU, SA42 0PE, SA42 0PF, SA42 0PH, SA42 0PJ, SA42 0PL, SA42 0PN, SA42 0PP, SA42 0PS, SA42 0PT, SA42 0PU, SA42 0QA, SA42 0QB, SA42 0QD, SA42 0QQ, SA42 0RE, SA42 0RL, SA42 0SY, SA42 0TA, SA42 0TB, SA42 0TH, SA42 0TQ, SA42 0TS, SA42 0TW",254,162,92
W00002712,SA43,"SA43 2EB, SA43 2EF, SA43 2EH, SA43 2EJ, SA43 2ET, SA43 2HD",159,84,75
W00002980,SA43,"SA43 2SA, SA43 2SB, SA43 2SD, SA43 2SE, SA43 2SH, SA43 2ST, SA43 2SU, SA43 2SX, SA43 2SY, SA43 2SZ",272,148,124
W00002981,SA43,"SA43 2AQ, SA43 2RU, SA43 2SF, SA43 2SG, SA43 2SL, SA43 2SN, SA43 2SP, SA43 2SR, SA43 2SS, SA43 2TA, SA43 2TF, SA43 2TG",299,155,144
W00002982,SA43,"SA43 2RX, SA43 2SJ, SA43 2TB, SA43 3DD, SA43 3DE, SA43 3DF, SA43 3DG, SA43 3DQ, SA43 3NA, SA43 3NJ, SA43 3NL, SA43 3NN, SA43 3NQ, SA43 3NT, SA43 3NU, SA43 3NW, SA43 3NX",290,147,143
W00002723,SA43,"SA43 1BN, SA43 1NU, SA43 1PL, SA43 1QT, SA43 1QU, SA43 1QX, SA43 1RB",230,121,109
W00002722,SA43,"SA43 1AG, SA43 1AJ, SA43 1AY, SA43 1LU, SA43 1LX, SA43 1NA, SA43 1NJ, SA43 1NN",263,108,155
W00002721,SA43,"SA43 1AH, SA43 1BD, SA43 1BE, SA43 1BG, SA43 1BH, SA43 1BQ",272,97,175
W00002720,SA43,"SA43 1NB, SA43 1ND, SA43 1NE, SA43 1NF, SA43 1NG, SA43 1NH, SA43 1NQ",208,94,114
W00002718,SA43,"SA43 2DH, SA43 2DJ, SA43 2DL, SA43 2DQ",231,97,134
W00002717,SA43,"SA43 1SN, SA43 1SP, SA43 2AH, SA43 2AL, SA43 2BN, SA43 2BW, SA43 2DZ",123,60,63
W00002716,SA43,"SA43 2AP, SA43 2AR, SA43 2AS, SA43 2AU, SA43 2AW, SA43 2AX, SA43 2AY, SA43 2AZ, SA43 2BA, SA43 2BB, SA43 2BE, SA43 2HR",340,192,148
W00002715,SA43,"SA43 1RP, SA43 1RR, SA43 1RS, SA43 1RW, SA43 1SW, SA43 1YG, SA43 2AN, SA43 2BD, SA43 2BP, SA43 2BS, SA43 2DT, SA43 2DU, SA43 2ED, SA43 2HS, SA43 2HT, SA43 2HU, SA43 2HX",225,114,111
W00002923,SA43,"SA43 2NP, SA43 2NQ, SA43 2NS, SA43 2NW, SA43 2PQ",257,120,137
W00002922,SA43,"SA43 2AF, SA43 2LL, SA43 2LS, SA43 2LT, SA43 2LU, SA43 2LX, SA43 2LY, SA43 2NB, SA43 2ND, SA43 2NR, SA43 2NT, SA43 2NU, SA43 2NX, SA43 2PA, SA43 2PS, SA43 2PY, SA43 2QG, SA43 2QH, SA43 2QJ, SA43 2QL, SA43 2QQ, SA43 2YH, SA43 2YN, SA43 2YP, SA43 2YR",281,147,134
W00002711,SA43,"SA43 2DD, SA43 2DF, SA43 2DG, SA43 2DY, SA43 2EN, SA43 2EP, SA43 2EU, SA43 2EX, SA43 2EY, SA43 2EZ, SA43 2HA, SA43 2HB, SA43 2HE, SA43 2HG, SA43 2HH, SA43 2HQ",396,236,160
W00002921,SA43,"SA43 2LR, SA43 2NE, SA43 2NG, SA43 2NH, SA43 2NJ, SA43 2NL, SA43 2NN, SA43 2NY, SA43 2NZ, SA43 2PB, SA43 2PT",324,188,136
W00002920,SA43,"SA43 2JN, SA43 2JQ, SA43 2JS, SA43 2JW, SA44 6PB, SA44 6PD, SA44 6PE, SA44 6PG, SA44 6PX, SA44 6PZ, SA44 6QA, SA44 6QB, SA44 6QD, SA44 6QE, SA44 6QF, SA44 6QH, SA44 6QJ, SA44 6QL, SA44 6QN, SA44 6QU, SA44 6QX, SA44 6QY, SA44 6QZ, SA44 6RA, SA44 6RB, SA44 6RD, SA44 6RF, SA44 6RR, SA44 6RS, SA44 6RU",282,152,130
W00002917,SA43,"SA43 2HP, SA43 2HZ, SA43 2JE, SA43 2JF, SA43 2JG, SA43 2JH, SA43 2JL, SA43 2JP, SA43 2JR",262,153,109
W00002719,SA43,"SA43 1AE, SA43 1AF, SA43 1AN, SA43 1EN, SA43 1JZ, SA43 1PE, SA43 1PF, SA43 1PH, SA43 1PJ, SA43 1PN",456,226,230
W00002724,SA43,"SA43 1AL, SA43 1AP, SA43 1AU, SA43 1AW, SA43 1AX, SA43 1BA, SA43 1BP, SA43 1PG, SA43 1PQ",198,93,105
W00002978,SA43,"SA43 2RS, SA43 2RT, SA43 2RY, SA43 2RZ, SA43 2SQ, SA43 2SW, SA43 2TD, SA43 2TE, SA43 2TH, SA43 2TQ, SA43 2TZ",370,197,173
W00002726,SA43,"SA43 1BR, SA43 1BU, SA43 1BX, SA43 1BY, SA43 1DN, SA43 1DR, SA43 1DU, SA43 1DW, SA43 1DX, SA43 1DY, SA43 1EA, SA43 1ED, SA43 1EE, SA43 1EF, SA43 1EG, SA43 1EH, SA43 1EJ, SA43 1EL, SA43 1ES",227,117,110
W00002710,SA43,"SA43 2BT, SA43 2BU, SA43 2BX, SA43 2DN, SA43 2DP, SA43 2DR, SA43 2DS, SA43 2DW, SA43 2DX",159,92,67
W00002713,SA43,"SA43 2EE, SA43 2EG, SA43 2EL, SA43 2EQ",224,127,97
W00002714,SA43,"SA43 2BH, SA43 2BJ, SA43 2BY, SA43 2BZ, SA43 2DA, SA43 2DB, SA43 2DE, SA43 2EA, SA43 2ER, SA43 2EW",265,152,113
W00002928,SA43,"SA43 1QA, SA43 1QD, SA43 1QE, SA43 1QF, SA43 1QG, SA43 1QH, SA43 1QQ, SA43 1RL, SA43 1RN, SA43 1RT, SA43 1RU, SA43 1SD, SA43 1SG, SA43 1SH, SA43 1SJ, SA43 1SL, SA43 1SQ, SA43 2AD, SA43 2AE, SA43 2AG, SA43 2AJ, SA43 2YT",303,130,173
W00002927,SA43,"SA43 1ER, SA43 1FD, SA43 1QR, SA43 1QZ, SA43 1RA, SA43 1RD, SA43 1RF, SA43 1RG, SA43 1RJ, SA43 1SE, SA43 1SF",238,84,154
W00002926,SA43,"SA43 1FB, SA43 1FE, SA43 1RE, SA43 1RH, SA43 1RQ, SA43 1SA, SA43 1SB, SA43 2LN",242,109,133
W00002925,SA43,"SA43 1PP, SA43 1PR, SA43 1PS, SA43 1PT, SA43 1PU, SA43 1PW, SA43 1PX, SA43 1PY, SA43 1PZ, SA43 1QB, SA43 1QJ, SA43 1RX, SA43 1RY, SA43 1RZ",337,176,161
W00002725,SA43,"SA43 1AQ, SA43 1AR, SA43 1AS, SA43 1AT, SA43 1AZ, SA43 1BB, SA43 1BL, SA43 1EP, SA43 1YH, SA43 1YN, SA43 1YP, SA43 1YR, SA43 1YS, SA43 1YT, SA43 1YU, SA43 1YW, SA43 1YX",194,84,110
W00003295,SA43,"SA43 3BJ, SA43 3BQ, SA43 3JJ, SA43 3JN, SA43 3JP, SA43 3JR, SA43 3JS, SA43 3LL, SA43 3LN, SA43 3LP, SA43 3LR, SA43 3LS, SA43 3LT, SA43 3LU, SA43 3LW, SA43 3LX, SA43 3LY, SA43 3NP, SA43 3NR",193,121,72
W00003294,SA43,"SA43 3DX, SA43 3DY, SA43 3DZ, SA43 3EA, SA43 3EB, SA43 3ED, SA43 3EE, SA43 3EF, SA43 3EG, SA43 3EH, SA43 3EJ, SA43 3EL, SA43 3EP, SA43 3EQ, SA43 3ER, SA43 3EU, SA43 3HR, SA43 3HS, SA43 3HT",242,131,111
W00003296,SA43,"SA43 3EW, SA43 3EX, SA43 3GF, SA43 3HA, SA43 3HB, SA43 3HD, SA43 3HE, SA43 3HF, SA43 3HH, SA43 3JT, SA43 3LH, SA43 3LJ, SA43 3YA, SA43 3YF",224,128,96
W00003292,SA43,"SA43 3DA, SA43 3DS, SA43 3DT, SA43 3DU, SA43 3EN, SA43 3HP, SA43 3HU, SA43 3HX, SA43 3HZ, SA43 3JA, SA43 3JF, SA43 3JG, SA43 3JH, SA43 3JL",287,180,107
W00002727,SA43,"SA43 1LY, SA43 1LZ, SA43 1NL, SA43 1NP, SA43 1NR, SA43 1NS",219,100,119
W00003293,SA43,"SA43 3ES, SA43 3ET, SA43 3EY, SA43 3JX, SA43 3JY, SA43 3JZ, SA43 3LA, SA43 3LD, SA43 3LE, SA43 3LF",243,141,102
W00002729,SA43,"SA43 1BJ, SA43 1EB, SA43 1JD, SA43 1JR, SA43 1JS, SA43 1JT, SA43 1JU, SA43 1JX, SA43 1JY, SA43 1LA, SA43 1LP, SA43 1LW",191,103,88
W00002730,SA43,"SA43 1DQ, SA43 1DS, SA43 1DT, SA43 1EW, SA43 1QY, SA43 2LA",229,143,86
W00002728,SA43,"SA43 1AA, SA43 1AB, SA43 1AD, SA43 1EQ, SA43 1LS, SA43 1LT, SA43 1NT",284,143,141
W00002734,SA43,"SA43 1EZ, SA43 1HF, SA43 1HG, SA43 1HL, SA43 1HN, SA43 1HP, SA43 1HQ, SA43 1HR, SA43 1HS, SA43 1HT, SA43 1HU, SA43 1HX, SA43 1HY, SA43 1JA, SA43 1JE, SA43 1JF, SA43 1NW, SA43 1PA, SA43 3AA, SA43 3AS, SA43 3AT, SA43 3AU, SA43 3AX, SA43 3AY, SA43 3BA",242,154,88
W00002924,SA43,"SA43 2AA, SA43 2AB, SA43 2LB, SA43 2LD, SA43 2LE, SA43 2LF, SA43 2LG, SA43 2LH, SA43 2LJ, SA43 2LP, SA43 2LQ",251,152,99
W00003289,SA43,"SA43 3BH, SA43 3BL, SA43 3BN, SA43 3BP, SA43 3BS, SA43 3BT, SA43 3BU, SA43 3BW, SA43 3BX, SA43 3BY, SA43 3LZ, SA43 3NS, SA43 3NY, SA43 3PA, SA43 3PE, SA43 3PG, SA43 3PJ",279,179,100
W00002731,SA43,"SA43 3AE, SA43 3AN, SA43 3AP, SA43 3AQ, SA43 3AW, SA43 3DP, SA43 3DR, SA43 3DW, SA43 3EZ, SA43 3NG, SA43 3NH",427,247,180
W00003344,SA44,"SA44 4EA, SA62 3BR, SA62 3GB, SA62 3HY, SA62 3JA, SA62 3JD, SA62 3JE, SA62 3JN, SA62 3JP, SA62 3JR, SA62 3JW, SA62 3JZ, SA62 3LA, SA62 3LD, SA62 3LE, SA62 3LX, SA62 3LY, SA62 3LZ, SA62 3NA, SA62 3NB",264,237,27
W00002919,SA44,"SA44 5PJ, SA44 5PL, SA44 5PN, SA44 5PP, SA44 5PR, SA44 5PS, SA44 5QR, SA44 5QS, SA44 5QT, SA44 5QU, SA44 5QX, SA44 5QY, SA44 5RL, SA44 5RN, SA44 5RP, SA44 5RW, SA44 5SN, SA44 5SP, SA44 5SR, SA44 5SS, SA44 5SU, SA44 5SW, SA44 5SX, SA44 6AA, SA44 6AB, SA44 6DY, SA44 6EB, SA44 6HR, SA44 6NX, SA44 6NY, SA44 6PH, SA44 6PJ, SA44 6PL, SA44 6PN, SA44 6PP, SA44 6PR, SA44 6PS, SA44 6RE",345,206,139
W00002918,SA44,"SA44 5ST, SA44 6BD, SA44 6BQ, SA44 6DS, SA44 6DT, SA44 6DU, SA44 6DX, SA44 6EA, SA44 6ED, SA44 6EE, SA44 6EF, SA44 6PY, SA44 6QG, SA44 6QQ, SA44 6QR, SA44 6QS, SA44 6QT, SA44 6RT",362,168,194
W00002914,SA44,"SA44 6AD, SA44 6AF, SA44 6AJ, SA44 6AU, SA44 6AX, SA44 6AY, SA44 6AZ, SA44 6RL, SA44 6RN, SA44 6RP, SA44 6RW, SA44 6SE, SA44 6SH, SA44 6SJ, SA44 6SL, SA44 6SN, SA44 6SP, SA44 6SW, SA44 6WR",233,137,96
W00002916,SA44,"SA44 6AE, SA44 6AG, SA44 6AH, SA44 6AQ, SA44 6AR, SA44 6AS, SA44 6AT, SA44 6DF, SA44 6DH, SA44 6DJ, SA44 6DL, SA44 6HA, SA44 6RH, SA44 6RJ, SA44 6SA, SA44 6SB, SA44 6SD, SA44 6SF, SA44 6SG, SA44 6SQ",196,96,100
W00002915,SA44,"SA44 5PT, SA44 5PU, SA44 5PX, SA44 6AL, SA44 6AN, SA44 6AP, SA44 6AW, SA44 6DB, SA44 6DD, SA44 6DE, SA44 6DG, SA44 6DN, SA44 6DQ, SA44 6EG, SA44 6EH, SA44 6EQ, SA44 6EU, SA44 6EX, SA44 6EY, SA44 6HB, SA44 6HD, SA44 6HE, SA44 6HF, SA44 6HG, SA44 6HN, SA44 6HP, SA44 6HW, SA44 6JF, SA44 6YA",260,148,112
W00002790,SA44,"SA44 4HH, SA44 4PY, SA44 4QA, SA44 4QB, SA44 4TU, SA44 4TY, SA44 4UA, SA44 4UB, SA44 4UD, SA44 4UE",203,96,107
W00002948,SA44,"SA44 4SU, SA44 5JJ, SA44 5JL, SA44 5JP, SA44 5JR, SA44 5JS, SA44 5LA, SA44 5LB, SA44 5LD, SA44 5LE, SA44 5LH, SA44 5LP, SA44 5LQ, SA44 5LR, SA44 5LS, SA44 5LT, SA44 5LU, SA44 5LX, SA44 5LY, SA44 5LZ, SA44 5NA, SA44 5NB, SA44 5ND, SA44 5QB, SA44 5QQ, SA44 5SH, SA44 5UA",265,148,117
W00003700,SA44,"SA44 5HN, SA44 5HR, SA44 5HS, SA44 5HW, SA44 5XH, SA44 5XJ, SA44 5XP, SA44 5YF, SA44 5YG, SA44 5YH, SA44 5YQ",330,159,171
W00002837,SA44,"SA44 5AN, SA44 5NL, SA44 5NN, SA44 5NP, SA44 5NQ, SA44 5NW, SA44 5TD, SA44 5TE, SA44 5TH, SA44 5TL, SA44 5TP, SA44 5TS",360,171,189
W00002839,SA44,"SA44 6BW, SA44 6BX, SA44 6BY, SA44 6BZ, SA44 6DA, SA44 6LD, SA44 6LG, SA44 6LH, SA44 6LQ, SA44 6LR, SA45 9RN, SA45 9RP, SA45 9RR, SA45 9RS, SA45 9RT, SA45 9RW",219,144,75
W00002840,SA44,"SA44 6BE, SA44 6BH, SA44 6BJ, SA44 6BL, SA44 6BN, SA44 6BP, SA44 6BS, SA44 6BT, SA44 6BU, SA44 6EN, SA44 6ES, SA44 6ET, SA44 6HJ, SA44 6LA, SA44 6LB, SA44 6LE, SA44 6LF, SA44 6LS, SA44 6LT",223,135,88
W00002841,SA44,"SA44 4ES, SA44 4ET, SA44 4EU, SA44 4EX, SA44 4EY, SA44 4HA, SA44 4TL, SA44 4TP, SA44 4UX, SA44 4XD, SA44 4XN, SA44 6BG, SA44 6EP, SA44 6ER, SA44 6HL, SA44 6HS, SA44 6HT, SA44 6HU, SA44 6HX, SA44 6JH, SA44 6JJ, SA44 6JL, SA44 6JN, SA44 6JP, SA44 6JR, SA44 6JS, SA44 6JW",272,137,135
W00002850,SA44,"SA44 4AB, SA44 4BD, SA44 4BG, SA44 4BL, SA44 4BN, SA44 4BP, SA44 4BS, SA44 4BU, SA44 4BW, SA44 4BX, SA44 4BY, SA44 4DA, SA44 4DB, SA44 4DE, SA44 4DF, SA44 4DG, SA44 4DH, SA44 4DJ",164,83,81
W00002849,SA44,"SA44 4HS, SA44 4HT, SA44 4JQ",232,105,127
W00002834,SA44,"SA44 4HX, SA44 4HY, SA44 4HZ, SA44 4JA, SA44 4JB, SA44 4SP, SA44 4SR, SA44 4SW, SA44 5BE, SA44 5BG, SA44 5BH, SA44 5BJ, SA44 5BL, SA44 5BN, SA44 5BP, SA44 5BQ, SA44 5BS, SA44 5BW, SA44 5NG, SA44 5NH, SA44 5NJ, SA44 5NR, SA44 5NS, SA44 5NT, SA44 5NU, SA44 5NX, SA44 5NY, SA44 5NZ, SA44 5TJ, SA44 5TN, SA44 5YE, SA44 5YJ, SA44 5YS, SA44 5YY",463,253,210
W00002945,SA44,"SA44 5PE, SA44 5PF, SA44 5PG, SA44 5PH, SA44 5PQ, SA44 5QD, SA44 5QE, SA44 5RE, SA44 5RF, SA44 5RG, SA44 5RY, SA44 5SA, SA44 5SD, SA44 5SL",253,142,111
W00002842,SA44,"SA44 6BA, SA44 6NP, SA44 6NR, SA44 6NU, SA44 6NW, SA45 9RH, SA45 9RJ, SA45 9RL, SA45 9SG, SA45 9SH, SA45 9SJ, SA45 9SL, SA45 9SS, SA45 9SU, SA45 9TB, SA45 9TN, SA45 9TP, SA45 9TR, SA45 9TS, SA45 9TT, SA45 9TU, SA45 9TW, SA45 9TX, SA45 9TY, SA47 0PY, SA47 0PZ, SA47 0QB, SA47 0QD, SA47 0QE",381,257,124
W00002843,SA44,"SA44 6BB, SA44 6LJ, SA44 6LN, SA44 6LW, SA44 6NG, SA44 6NH, SA44 6NJ, SA44 6NL, SA44 6NN, SA44 6NQ, SA44 6NT",296,154,142
W00002844,SA44,"SA44 6JY, SA44 6JZ, SA44 6LP, SA44 6LU, SA44 6LX, SA44 6LY, SA44 6LZ, SA44 6NA, SA44 6NB, SA44 6NS",147,73,74
W00002845,SA44,"SA44 4ED, SA44 4HP, SA44 4HR, SA44 4HU, SA44 4JN, SA44 4JU, SA44 4JW, SA44 4JX, SA44 4JY, SA44 4JZ",282,87,195
W00002846,SA44,"SA44 4BJ, SA44 4DL, SA44 4DQ, SA44 4DR, SA44 4DS, SA44 4DT, SA44 4DU, SA44 4DX, SA44 4LA, SA44 4QJ, SA44 4QL, SA44 4QN, SA44 4QP, SA44 4QS, SA44 4QT, SA44 4QW, SA44 4QX",235,91,144
W00002949,SA44,"SA44 4NR, SA44 4NS, SA44 4SY, SA44 4TA, SA44 4TB, SA44 4TD, SA44 4TE, SA44 4TF, SA44 4TH, SA44 4TJ, SA44 4TN, SA44 4TQ, SA44 5JU, SA44 5JZ, SA44 5SB, SA44 5SE, SA44 5SG",275,106,169
W00002848,SA44,"SA44 4EJ, SA44 4JL, SA44 4LB, SA44 4LD, SA44 4LE, SA44 4LF, SA44 4LG, SA44 4LH, SA44 4LL, SA44 4LQ, SA44 4LT, SA44 4NY, SA44 4PA",189,109,80
W00002788,SA44,"SA44 4EF, SA44 4EG, SA44 4EH, SA44 4EN, SA44 4LP, SA44 4LR, SA44 4LS, SA44 4LU, SA44 4NE, SA44 4NG, SA44 4NH, SA44 4NJ, SA44 4NL, SA44 4NN, SA44 4NQ, SA44 4NW, SA44 4TZ, SA44 4UR, SA44 4UT, SA44 4UU, SA44 4UY",256,146,110
W00002847,SA44,"SA44 4BA, SA44 4BB, SA44 4BE, SA44 4BH, SA44 4BQ, SA44 4BT, SA44 4BZ, SA44 4DD, SA44 4DN, SA44 4DP, SA44 4DW, SA44 4DY, SA44 4EB, SA44 4HL, SA44 4HN, SA44 4HW, SA44 4QU",211,91,120
W00003704,SA44,"SA44 5DU, SA44 5HL, SA44 5UG, SA44 5UQ, SA44 5UU, SA44 5UX, SA44 5UY, SA44 5XA, SA44 5XB, SA44 5XG, SA44 5YA",286,172,114
W00003701,SA44,"SA44 4SD, SA44 4SE, SA44 5AD, SA44 5AE, SA44 5AF, SA44 5AG, SA44 5AH, SA44 5ED, SA44 5EG, SA44 5EQ, SA44 5HB, SA44 5HD, SA44 5HE, SA44 5HF",331,171,160
W00003702,SA44,"SA44 5AL, SA44 5UH, SA44 5UJ, SA44 5UL, SA44 5UZ, SA44 5WA, SA44 5WY, SA44 5YB, SA44 5YD, SA44 5YN",375,185,190
W00002947,SA44,"SA44 4JT, SA44 4SH, SA44 4SJ, SA44 4SL, SA44 4SS, SA44 4ST, SA44 4SX, SA44 4SZ, SA44 5JT, SA44 5JY, SA44 5LN",307,139,168
W00003703,SA44,"SA44 5DS, SA44 5DX, SA44 5EP, SA44 5EU, SA44 5EW, SA44 5EX, SA44 5EY, SA44 5EZ, SA44 5FA, SA44 5HA, SA44 5UR, SA44 5UT, SA44 5UW",271,128,143
W00003705,SA44,"SA44 4RX, SA44 4RY, SA44 4RZ, SA44 4SA, SA44 4SB, SA44 5AA, SA44 5AB, SA44 5AR, SA44 5AS, SA44 5AT, SA44 5AU, SA44 5DA, SA44 5DB, SA44 5DG, SA44 5DL, SA44 5DQ",309,168,141
W00003710,SA44,"SA44 4AJ, SA44 4AN, SA44 4AP, SA44 4AR, SA44 4AS, SA44 4AT, SA44 4AU, SA44 4AW, SA44 4AX, SA44 4AY, SA44 4AZ, SA44 4RP, SA44 4RR, SA44 4RS, SA44 4RW, SA44 4SF, SA44 5AP",166,69,97
W00003709,SA44,"SA44 5DR, SA44 5DY, SA44 5DZ, SA44 5EA, SA44 5EB, SA44 5EE, SA44 5EF, SA44 5EH, SA44 5EJ",319,118,201
W00002820,SA44,"SA44 4XJ, SA44 4XL, SA44 6JA, SA44 6JB, SA44 6JD, SA44 6JE, SA44 6JG, SA44 6JQ, SA44 6JT, SA44 6JU, SA47 0NP, SA47 0NR, SA47 0NS, SA47 0NT, SA47 0NU, SA47 0NX, SA47 0PA, SA47 0PB, SA47 0PD, SA47 0PE, SA47 0PF, SA47 0PG, SA47 0PH, SA47 0PJ, SA47 0PL, SA47 0PN, SA47 0PW, SA47 0QH, SA47 0QJ, SA47 0QL, SA47 0QN, SA47 0QP, SA47 0QR, SA47 0QS, SA47 0QT, SA47 0QU, SA47 0QW, SA47 0QX, SA47 0QY, SA48 7QZ, SA48 7RN, SA48 7RW",476,212,264
W00003707,SA44,"SA44 5AJ, SA44 5AX, SA44 5AY, SA44 5AZ, SA44 5BA, SA44 5BB, SA44 5BD, SA44 5DD, SA44 5DE, SA44 5DF, SA44 5DH, SA44 5DJ, SA44 5DP, SA44 5DW, SA44 5ES, SA44 5ET",254,152,102
W00002822,SA45,"SA45 9SD, SA45 9SN, SA45 9SP, SA45 9SR, SA45 9ST, SA45 9SW, SA47 0NA, SA47 0NJ, SA47 0NZ, SA47 0QA",249,148,101
W00002911,SA45,"SA45 9NJ, SA45 9NN, SA45 9NP, SA45 9NR, SA45 9NS, SA45 9NT, SA45 9NU, SA45 9NX, SA45 9NY, SA45 9NZ, SA45 9PA, SA45 9PF, SA45 9PG, SA45 9PH, SA45 9PJ, SA45 9PL, SA45 9PQ, SA45 9QB, SA45 9YB",125,78,47
W00002913,SA45,"SA45 9NG, SA45 9NH, SA45 9NL, SA45 9NQ, SA45 9NW, SA45 9PD, SA45 9PS, SA45 9PT, SA45 9PU, SA45 9PW, SA45 9PX, SA45 9PY, SA45 9PZ, SA45 9QA, SA45 9QD, SA45 9QE, SA45 9QG, SA45 9QH, SA45 9QJ, SA45 9QN, SA45 9QR, SA45 9SA, SA45 9TD, SA45 9TE",183,93,90
W00002912,SA45,"SA45 9PB, SA45 9PE, SA45 9PN, SA45 9QF, SA45 9QL, SA45 9QP, SA45 9QQ, SA45 9QS, SA45 9QW, SA45 9RD, SA45 9RE, SA45 9RF, SA45 9RQ, SA45 9TG, SA45 9TH, SA45 9TJ",227,119,108
W00002910,SA45,"SA45 9QT, SA45 9QU, SA45 9SB, SA45 9SE, SA45 9SF, SA45 9SQ, SA45 9SY, SA45 9SZ, SA45 9TA, SA45 9TF, SA45 9TL, SA45 9TQ",335,227,108
W00002801,SA46,"SA46 0DE, SA46 0ET, SA46 0EU, SA46 0EX, SA46 0HA, SA46 0HS, SA46 0HU",305,127,178
W00002883,SA46,"SA46 0JR, SA46 0LJ, SA46 0LL, SA46 0LN, SA46 0LP, SA46 0LS, SA46 0LT, SA46 0LU, SA46 0LW, SA46 0LX, SY23 5JL, SY23 5JN",232,119,113
W00002800,SA46,"SA46 0EE, SA46 0EL, SA46 0EY, SA46 0EZ, SA46 0HP, SA46 0HR",190,86,104
W00002704,SA46,"SA46 0AH, SA46 0DP, SA46 0DQ, SA46 0DS, SA46 0DT, SA46 0DU, SA46 0EA, SA46 0EB, SA46 0ED, SA46 0NW",225,89,136
W00002708,SA46,"SA46 0AA, SA46 0AD, SA46 0AE, SA46 0AF, SA46 0AJ, SA46 0AL, SA46 0AN, SA46 0AP, SA46 0AR, SA46 0AX, SA46 0AZ, SA46 0DD, SA46 0DG, SA46 0DH, SA46 0DJ, SA46 0DN, SA46 0DR, SA46 0ER, SA46 0HY, SA46 0JA",188,88,100
W00002709,SA46,"SA46 0AB, SA46 0BH, SA46 0BN, SA46 0BS, SA46 0BW, SA46 0BY, SA46 0DA, SA46 0HZ",198,83,115
W00002803,SA46,"SA46 0HB, SA46 0HD, SA46 0HE, SA46 0HQ, SA47 0RP, SA47 0RR, SA47 0RS, SA47 0RW, SA47 0RY, SA48 7RF, SA48 7RG, SA48 8DQ",252,136,116
W00002802,SA46,"SA46 0HF, SA46 0HG, SA46 0HH, SA46 0HJ, SA46 0HN, SA46 0HT, SA46 0HW, SA46 0HX, SA46 0JE",292,158,134
W00002821,SA46,"SA46 0HL, SA47 0ND, SA47 0NE, SA47 0NF, SA47 0NG, SA47 0NL, SA47 0NN, SA47 0NW, SA47 0NY, SA47 0PP, SA47 0PT, SA47 0PU, SA47 0PX, SA47 0QZ, SA47 0RE, SA47 0RF, SA47 0RG, SA47 0RH, SA47 0RJ, SA47 0RL, SA47 0RQ, SA47 0YA, SA47 0YB",293,161,132
W00002705,SA46,"SA46 0BL, SA46 0BQ, SA46 0DF, SA46 0DL, SA46 0DW, SA46 0DX, SA46 0DY, SA46 0DZ, SA46 0EH, SA46 0EJ, SA46 0EN, SA46 0EP, SA46 0EQ, SA46 0ES, SA46 0EW, SA46 0FA, SA46 0FP, SA46 0PA, SA46 0YD, SA46 0YE, SA46 0ZB, SA48 9SA, SA48 9ZZ",238,77,161
W00002706,SA46,"SA46 0AG, SA46 0AQ, SA46 0AW, SA46 0DB, SA46 0JB, SA46 0JD, SA46 0JF, SA46 0JG, SA46 0JH, SA46 0JJ, SA46 0JL, SA46 0JN, SA46 0JP, SA46 0JQ, SA46 0JW",231,90,141
W00002707,SA46,"SA46 0AS, SA46 0AT, SA46 0AU, SA46 0AY, SA46 0BA, SA46 0BB, SA46 0BD, SA46 0BE, SA46 0BG, SA46 0BJ, SA46 0BP, SA46 0BR, SA46 0BT, SA46 0BU, SA46 0BX",171,86,85
W00002882,SA46,"SA46 0EF, SA46 0EG, SA46 0JS, SA46 0JT, SA46 0JU, SA46 0JX, SA46 0JY, SA46 0LA, SA46 0LB, SA46 0LD, SA46 0LE, SA46 0LR, SA46 0LY, SA46 0YF, SA48 8DL, SY23 5JH, SY23 5JP, SY23 5JW, SY23 5PG, SY23 5WH, SY23 5ZA",248,125,123
W00002824,SA47,"SA47 0NH, SA47 0NQ, SA47 0PS, SA47 0QF",165,98,67
W00003776,SA48,"SA48 8DR, SA48 8EL, SA48 8EW, SA48 8HP, SA48 8JR, SA48 8JS, SA48 8JT",230,88,142
W00002857,SA48,"SA48 7NW, SA48 7PH, SA48 7PJ, SA48 7PL, SA48 7PN, SA48 7PW, SA48 7PZ, SA48 7QE, SA48 7QL, SA48 7QR, SA48 7QS, SA48 7QT",278,99,179
W00010067,SA48,"SA48 7DP, SA48 7DY, SA48 7EA, SA48 7EB, SA48 7ED, SA48 7HA, SA48 7HB, SA48 7HJ, SA48 7HP, SA48 7HR, SA48 7JD",272,206,66
W00002856,SA48,"SA48 7FB, SA48 7HL, SA48 7PG, SA48 8AE, SA48 8AF, SA48 8AG, SA48 8AH, SA48 8BG, SA48 8BH, SA48 8BQ, SA48 8BR",352,127,225
W00002861,SA48,"SA48 8QG, SA48 8QL, SA48 8QN, SA48 8QQ, SA48 8QR, SA48 8QW, SA48 8RA, SA48 8RB, SA48 8RD, SY23 5NS, SY25 6RD, SY25 6RE, SY25 6RF",278,190,88
W00002862,SA48,"SA48 8AQ, SA48 8QA, SA48 8QB, SA48 8QD, SA48 8QE, SA48 8QF, SA48 8QH, SA48 8QJ, SA48 8QP, SA48 8QS, SA48 8QT, SA48 8QY, SA48 8QZ, SA48 8RE, SA48 8RX",301,167,134
W00002864,SA48,"SA48 8LL, SY25 6NP, SY25 6NZ, SY25 6PA, SY25 6PB, SY25 6PD, SY25 6PE, SY25 6PF, SY25 6PG, SY25 6PH, SY25 6PJ, SY25 6PQ, SY25 6PR, SY25 6PS, SY25 6PT, SY25 6PU, SY25 6RP, SY25 6UG, SY25 6UH, SY25 6UJ, SY25 6UL, SY25 6UN, SY25 6UQ, SY25 6UU, SY25 6UW",301,143,158
W00002868,SA48,"SA48 8JE, SA48 8JF, SA48 8LA, SA48 8LB, SA48 8LD, SA48 8LE, SA48 8LG, SA48 8LH, SA48 8LJ, SA48 8LQ, SA48 8ND, SA48 8NL",172,117,55
W00002869,SA48,"SA48 8HX, SA48 8HY, SA48 8HZ, SA48 8JD, SA48 8JZ, SA48 8NE",223,126,97
W00002870,SA48,"SA48 8HJ, SA48 8HU, SA48 8HW, SA48 8JA, SA48 8JB, SA48 8JG, SA48 8JH, SA48 8JQ",194,113,81
W00002871,SA48,"SA48 8AB, SA48 8AP, SA48 8AR, SA48 8LU, SA48 8LX, SA48 8LY, SA48 8NN, SA48 8NX, SA48 8NY, SA48 8PA",207,110,97
W00002872,SA48,"SA48 8LZ, SA48 8NA, SA48 8NB, SA48 8NG, SA48 8NH, SA48 8NJ, SA48 8NP, SA48 8NQ, SA48 8NR, SA48 8NW, SY25 6UP, SY25 6UR",205,102,103
W00002873,SA48,"SA48 8AJ, SA48 8AS, SA48 8AT, SA48 8AU, SA48 8AX, SA48 8AY, SA48 8BL, SA48 8NU, SA48 8PB, SA48 8PD, SA48 8PE, SA48 8YA, SA48 8YG, SA48 8YH, SA48 8YL",177,84,93
W00002874,SA48,"SA48 8PP, SA48 8PR, SA48 8PS, SY25 6PZ, SY25 6QA, SY25 6QB, SY25 6QD, SY25 6QE, SY25 6SN",190,117,73
W00002894,SA48,"SA48 7JR, SA48 7JS, SA48 7JX, SA48 7LB, SA48 7LD, SA48 7LG, SA48 7LL, SA48 7LQ, SA48 7NU, SA48 7NY, SA48 7YH, SA48 7YN",207,80,127
W00002893,SA48,"SA48 7JT, SA48 7JU, SA48 7JY, SA48 7LA, SA48 7LE, SA48 7LF, SA48 7LH, SA48 7LJ, SA48 7LS, SA48 7LT, SA48 7LW, SA48 7LY, SA48 7NT, SA48 7NX, SA48 7YP, SA48 7YR, SA48 7YT",245,114,131
W00002819,SA48,"SA48 7AN, SA48 7AP, SA48 7BE, SA48 7BH, SA48 7BL, SA48 7BU, SA48 7BX, SA48 7BY, SA48 7BZ, SA48 7DA, SA48 7DB, SA48 7DD, SA48 7DE",215,93,122
W00002860,SA48,"SA48 7NJ, SA48 7NL, SA48 7NN, SA48 7NQ, SA48 7PQ, SA48 7QA, SA48 7QB, SA48 7QD, SA48 7SA, SA48 8AD",256,115,141
W00003774,SA48,"SA48 8DN, SA48 8DS, SA48 8DT, SA48 8DU, SA48 8DY, SA48 8EF, SA48 8EH, SA48 8EP, SA48 8ET, SA48 8JN, SA48 8JU, SA48 8JW",307,120,187
W00002881,SA48,"SA48 8DH, SA48 8DJ, SY23 5AJ, SY23 5JG, SY23 5JJ, SY23 5JQ, SY23 5JR, SY23 5JS, SY23 5NE, SY23 5NG, SY23 5NP, SY23 5NQ, SY23 5NR, SY23 5PA, SY23 5PB, SY23 5PE, SY23 5PF, SY23 5PH",303,163,140
W00002811,SA48,"SA48 7BJ, SA48 7BN, SA48 7BP, SA48 7BS, SA48 7BW, SA48 7EW, SA48 7JL, SA48 7JN, SA48 7JP, SA48 7JW, SA48 7PA, SA48 7SB",253,113,140
W00002859,SA48,"SA48 8AZ, SA48 8BA, SA48 8BB, SA48 8BD, SA48 8BE, SA48 8BJ, SA48 8BN, SA48 8BW, SA48 8PF, SA48 8PG, SA48 8PH, SA48 8PJ, SA48 8PL, SA48 8PN, SA48 8PY",181,75,106
W00002813,SA48,"SA48 7ET, SA48 7EU, SA48 7EX, SA48 7JA, SA48 7JB, SA48 7JE, SA48 8AL, SA48 8AW",197,103,94
W00002814,SA48,"SA48 7HS, SA48 7HT, SA48 7HU, SA48 7HY, SA48 7RX, SA48 7RY, SA48 7RZ, SA48 8AA, SA48 8AN, SA48 8BS, SA48 8JY, SA48 8LS, SA48 8LT",369,172,197
W00002799,SA48,"SA48 7PP, SA48 7PR, SA48 7PS, SA48 7PT, SA48 7PU, SA48 7PX, SA48 7RE, SA48 7SG, SA48 7SJ, SA48 7SQ, SA48 7WY, SA48 7WZ, SA48 7XA, SA48 7XS, SA48 7XT, SA48 7XU, SA48 7YB, SA48 7YD, SA48 7YE, SA48 7YS, SA48 8BU, SA48 8DG, SA48 8RF, SA48 8RG",248,117,131
W00002798,SA48,"SA48 8DB, SA48 8QU, SA48 8RH, SA48 8RJ, SA48 8RL, SA48 8RN, SA48 8RP, SA48 8RR, SA48 8RS, SA48 8RT, SA48 8RU",256,124,132
W00002797,SA48,"SA48 7SD, SA48 7SE, SA48 7SF, SA48 7SH, SA48 8BP, SA48 8BX, SA48 8BY, SA48 8BZ, SA48 8DA, SA48 8DD, SA48 8DE, SA48 8DF, SA48 8DP",333,150,183
W00002858,SA48,"SA48 7AD, SA48 7LU, SA48 7LZ, SA48 7NA, SA48 7NB, SA48 7ND, SA48 7NE, SA48 7NF, SA48 7NG, SA48 7NH, SA48 7NP, SA48 7NR, SA48 7NS, SA48 7NZ, SA48 7PB, SA48 7PD, SA48 7QH, SA48 7QJ, SA48 7QN",349,171,178
W00002815,SA48,"SA48 7EL, SA48 7EP, SA48 7EQ, SA48 7ER, SA48 7ES",280,142,138
W00002818,SA48,"SA48 7AA, SA48 7AT, SA48 7BA, SA48 7BG, SA48 7BQ, SA48 7DG, SA48 7DH, SA48 7DQ, SA48 7HD, SA48 7HG",180,109,71
W00002816,SA48,"SA48 7AB, SA48 7AE, SA48 7AF, SA48 7AG, SA48 7AJ, SA48 7AL, SA48 7AQ, SA48 7AR, SA48 7AS, SA48 7AX, SA48 7AY, SA48 7AZ, SA48 7DF, SA48 8JX, SA48 8LF",283,113,170
W00004104,SA5,"SA5 9ND, SA5 9NH, SA5 9PE, SA5 9PF",290,273,17
W00004302,SA5,"SA5 7LX, SA5 7LZ, SA5 7NN, SA5 7NP, SA5 7NR, SA5 7NS, SA6 5RN, SA6 5RS, SA6 5RT, SA6 5RU, SA6 5RW, SA6 5RX, SA6 5RY, SA6 5TF, SA6 5TH, SA6 5TJ, SA6 5TL, SA6 5TN, SA6 5TP, SA6 5XU, SA6 5XX, SA6 5XZ, SA6 5YG, SA6 6JB, SA6 6NY, SA6 6PA, SA6 6PB, SA6 6PD, SA6 6PE, SA6 6PF, SA6 6PG, SA6 6PQ, SA8 4RS, SA8 4RT",293,219,74
W00004103,SA5,"SA5 8PG, SA5 8PQ, SA5 8QN, SA5 8QW",297,270,27
W00004124,SA5,"SA5 8AU, SA5 8QA, SA5 8QB, SA5 8QE",194,183,11
W00004116,SA5,"SA5 9JL, SA5 9JN, SA5 9LP, SA5 9LR, SA5 9LW",269,252,17
W00004123,SA5,"SA5 8AX, SA5 8AY, SA5 8BN, SA5 8NX, SA5 8NY, SA5 9NG",193,180,13
W00004117,SA5,"SA5 8PP, SA5 9HX, SA5 9PN, SA5 9PW, SA5 9YE",302,277,25
W00004118,SA5,"SA5 8PL, SA5 8PN, SA5 8PW, SA5 8QH, SA5 8QJ, SA5 8QL",241,221,20
W00004122,SA5,"SA5 9PD, SA5 9PH, SA5 9PL, SA5 9PP",287,274,13
W00004120,SA5,"SA5 9JR, SA5 9JT, SA5 9PG, SA5 9PJ, SA5 9PQ",302,277,25
W00004121,SA5,"SA5 8AW, SA5 8PX, SA5 8PY, SA5 8PZ, SA5 8QQ",233,217,16
W00004105,SA5,"SA5 8AZ, SA5 8BQ, SA5 8EU, SA5 8EY, SA5 8EZ, SA5 8HD",343,319,24
W00004102,SA5,"SA5 8AN, SA5 8AP, SA5 8AR, SA5 8DZ, SA5 8PT",215,202,13
W00004101,SA5,"SA5 8PH, SA5 8PJ, SA5 8QF, SA5 8QP, SA5 9PA, SA5 9PB",329,308,21
W00004119,SA5,"SA5 9JD, SA5 9JS, SA5 9JU, SA5 9LH, SA5 9LJ",218,199,19
W00004106,SA5,"SA5 9NL, SA5 9NN",213,190,23
W00004100,SA5,"SA5 8AL, SA5 8AS, SA5 8AT, SA5 8BG, SA5 8BH",308,297,11
W00004108,SA5,"SA5 8HA, SA5 8HB, SA5 8LA, SA5 8LE, SA5 8LL",321,298,23
W00004099,SA5,"SA5 9BQ, SA5 9JW, SA5 9JX, SA5 9JY, SA5 9JZ, SA5 9LA, SA5 9LL, SA5 9LT, SA5 9NE",272,261,11
W00004098,SA5,"SA5 7HA, SA5 9HN, SA5 9HP, SA5 9HR, SA5 9HW",289,270,19
W00004097,SA5,"SA5 4BQ, SA5 4SR, SA5 4SX, SA5 4SY, SA5 4TA, SA5 4TB",332,298,34
W00004111,SA5,"SA5 8BA, SA5 8BB, SA5 8BD, SA5 8BE, SA5 8BJ, SA5 8BL, SA5 8BP",289,277,12
W00004096,SA5,"SA5 8DA, SA5 8DB, SA5 8DD, SA5 8EE, SA5 8EH, SA5 8EQ",320,297,23
W00004095,SA5,"SA5 4RQ, SA5 4TD, SA5 4TN, SA5 4TQ",231,213,18
W00004107,SA5,"SA5 8NL, SA5 8NS, SA5 8NU, SA5 8NZ, SA5 8YF, SA5 8YG, SA5 8YL, SA5 9NA, SA5 9NB, SA5 9NF, SA5 9NP",263,253,10
W00004112,SA5,"SA5 8HE, SA5 8HF, SA5 8HQ, SA5 8LB, SA5 8LD, SA5 8LF, SA5 8LH, SA5 8LN, SA5 8LP, SA5 8LR, SA5 8LT, SA5 8LU, SA5 8LW, SA5 8LX",277,253,24
W00004114,SA5,"SA5 7BW, SA5 8AH, SA5 8PR, SA5 8PS, SA5 8PU",243,229,14
W00004115,SA5,"SA5 9JE, SA5 9JF, SA5 9JG, SA5 9JJ, SA5 9JP, SA5 9JQ",252,235,17
W00004094,SA5,"SA5 8EJ, SA5 8JQ, SA5 8ND, SA5 8NE",187,178,9
W00004093,SA5,"SA5 8DE, SA5 8DF, SA5 8DP, SA5 8DT",328,309,19
W00004110,SA5,"SA5 8NN, SA5 8NP, SA5 8NR, SA5 8NT, SA5 8PD, SA5 8PE, SA5 9NR, SA5 9NS, SA5 9NT, SA5 9NU",287,263,24
W00004109,SA5,"SA5 9NJ, SA5 9NQ, SA5 9NX, SA5 9NY",299,285,14
W00004113,SA5,"SA5 9HS, SA5 9HT, SA5 9JH, SA5 9LS",268,248,20
W00004091,SA5,"SA5 4QH, SA5 4QJ, SA5 4QL, SA5 4QN, SA5 4QP, SA5 4QR, SA5 4QW, SA5 4SQ",243,224,19
W00004068,SA5,"SA5 8HN, SA5 8HT, SA5 8HW",139,134,5
W00004089,SA5,"SA5 4AA, SA5 4AB, SA5 4AD, SA5 4AE, SA5 4AF, SA5 4AH, SA5 4AQ, SA5 4DG, SA5 4DH, SA5 4DJ, SA5 4DQ, SA5 4DW, SA5 4EA, SA5 4EE, SA5 4EH, SA5 4EL, SA5 4HD, SA5 5AR, SA5 5AT, SA5 5BG, SA5 5DR, SA5 5DS",258,241,17
W00004471,SA5,"SA5 7AS, SA5 7AT, SA5 7AU, SA5 7AX, SA5 8AF",317,289,28
W00004472,SA5,"SA5 7AH, SA5 7AJ, SA5 7AL, SA5 7AQ, SA5 7AW, SA5 7BJ, SA5 7EL, SA5 7EP",319,304,15
W00004473,SA5,"SA5 7AY, SA5 7AZ, SA5 8AA, SA5 8AE, SA5 8AG",273,259,14
W00004474,SA5,"SA5 7AR, SA5 7ER, SA5 7EW",311,266,45
W00004475,SA5,"SA5 7EN, SA5 7ES, SA5 7ET, SA5 7EZ",284,275,9
W00004476,SA5,"SA5 7BA, SA5 7BB, SA5 7BD, SA5 7BE, SA5 7BG, SA5 8AQ",222,212,10
W00004477,SA5,"SA5 5LP, SA5 5LR, SA5 5PF, SA5 5PG, SA5 5PT, SA5 5PU",398,366,32
W00004478,SA5,"SA5 5NX, SA5 5PJ, SA5 5PL, SA5 5PN, SA5 5PP, SA5 5PR, SA5 5PS, SA5 5PY",334,313,21
W00004446,SA5,"SA5 5NS, SA5 5PX, SA5 5QA, SA5 5QB, SA5 5QD, SA5 5QE, SA5 5QH, SA5 5QQ",384,356,28
W00004445,SA5,"SA5 7HN, SA5 7HT, SA5 7HU, SA5 7HW, SA5 9AR, SA5 9BH",290,243,47
W00004444,SA5,"SA5 7BL, SA5 7BT, SA5 7BU, SA5 7BX, SA5 9AA",290,276,14
W00004443,SA5,"SA5 7JS, SA5 7JT, SA5 7JU",239,217,22
W00004442,SA5,"SA5 7BQ, SA5 7DQ, SA5 7DX, SA5 7HJ, SA5 7JR, SA5 7JX, SA5 7JY, SA5 7JZ, SA5 7LA, SA5 7LL, SA5 7NE, SA5 7NF, SA5 7YD",356,323,33
W00004441,SA5,"SA5 5EY, SA5 5HW, SA5 5LX, SA5 5NB, SA5 5ND, SA5 5NE, SA5 5NG, SA5 5NH, SA5 5NL, SA5 5NN, SA5 5NP, SA5 5NQ, SA5 5NT, SA5 5NU, SA5 5NW, SA5 5NY",326,308,18
W00004246,SA5,"SA5 7HF, SA5 7HG, SA5 7HQ, SA5 7HX, SA5 7JA, SA5 7JB, SA5 7JQ, SA6 6BG, SA6 6EZ, SA6 6HF",432,353,79
W00004401,SA5,"SA5 9ET, SA5 9EY, SA5 9EZ, SA5 9HF, SA5 9YF, SA5 9YG, SA5 9YN",275,267,8
W00004400,SA5,"SA5 7DN, SA5 7DP, SA5 7DR, SA5 7DW, SA5 9DZ, SA5 9EA, SA5 9EE, SA5 9EP, SA5 9EW",238,220,18
W00004470,SA5,"SA5 7EJ, SA5 7EU, SA5 7EX, SA5 7EY",241,233,8
W00004399,SA5,"SA5 9DH, SA5 9DJ, SA5 9DN, SA5 9DP, SA5 9DR",267,253,14
W00004469,SA5,"SA5 5EE, SA5 5EH, SA5 5EJ, SA5 5EL, SA5 5EN",316,275,41
W00004467,SA5,"SA5 7AA, SA5 7BR, SA5 7BS",240,218,22
W00004450,SA5,"SA5 5HH, SA5 5HJ, SA5 5HL, SA5 5HQ, SA5 5NF",275,263,12
W00004451,SA5,"SA5 9AE, SA5 9AF, SA5 9AG, SA5 9AN, SA5 9BE",310,284,26
W00004452,SA5,"SA5 9AB, SA5 9AJ, SA5 9AQ",259,237,22
W00004453,SA5,"SA5 5JH, SA5 5JJ, SA5 5LF, SA5 5LG, SA5 5LH, SA5 5LJ, SA5 5LL, SA5 5NA",358,341,17
W00004454,SA5,"SA5 5HP, SA5 5HR, SA5 5HS, SA5 5HT, SA5 5HX",260,232,28
W00004455,SA5,"SA5 7BY, SA5 7DB, SA5 7DE, SA5 7DF, SA5 7DJ, SA5 7HB",309,284,25
W00004456,SA5,"SA5 5JX, SA5 5JY, SA5 7HH, SA5 7JN, SA5 7JP, SA5 7JW",293,270,23
W00004457,SA5,"SA5 7EA, SA5 7ED, SA5 7EH",273,256,17
W00004458,SA5,"SA5 5JS, SA5 5JT, SA5 5LA, SA5 5LB",280,267,13
W00004459,SA5,"SA5 5JQ, SA5 7AB, SA5 7AD",234,229,5
W00004449,SA5,"SA5 5JN, SA5 5JP, SA5 5JR, SA5 5JW, SA5 5JZ, SA5 5LN, SA5 5LQ, SA5 5LW, SA5 5NR, SA5 5QJ",452,418,34
W00004461,SA5,"SA5 5EX, SA5 5JU, SA5 5LD, SA5 5LE",284,276,8
W00004462,SA5,"SA5 5ED, SA5 5EG, SA5 5EQ, SA5 5HZ, SA5 5JA, SA5 5YA, SA5 5YD, SA5 5YE, SA5 5YF, SA5 5YG, SA5 5YH, SA5 5YL",249,227,22
W00004463,SA5,"SA5 5AE, SA5 5AG, SA5 5AH, SA5 5AQ, SA5 5ET, SA5 5EU, SA5 5GH",327,300,27
W00004464,SA5,"SA5 5DQ, SA5 5EF, SA5 5ER, SA5 5JD, SA5 5JE, SA5 5JF",279,259,20
W00004465,SA5,"SA5 7EB, SA5 7EE, SA5 7EF, SA5 9EX",204,174,30
W00004466,SA5,"SA5 7AN, SA5 7AP, SA5 7EG, SA5 7EQ",238,227,11
W00004468,SA5,"SA5 5AF, SA5 7AE, SA5 7AF, SA5 7AG, SA5 7BH, SA5 7BN, SA5 7BP",233,219,14
W00004398,SA5,"SA5 7BZ, SA5 7DD, SA5 7DH, SA5 7DL, SA5 9EU, SA5 9HG",248,231,17
W00004397,SA5,"SA5 9BN, SA5 9BU, SA5 9EH, SA5 9EL, SA5 9EN, SA5 9EQ, SA5 9FA",302,275,27
W00004396,SA5,"SA5 7DA, SA5 7DG, SA5 7DS, SA5 7DT, SA5 9AX, SA5 9EJ",273,251,22
W00004064,SA5,"SA5 4QB, SA5 4QE, SA5 4QG, SA5 4QX, SA5 4QY, SA5 4RB, SA5 4RL",285,247,38
W00004065,SA5,"SA5 4RD, SA5 4RS, SA5 4RY, SA5 4RZ",326,284,42
W00004066,SA5,"SA5 4RE, SA5 4RF, SA5 4RG, SA5 4RH",181,172,9
W00004067,SA5,"SA5 8DG, SA5 8HP, SA5 8HR, SA5 8HS, SA5 8JD, SA5 8JF, SA5 8JH, SA5 8JJ, SA5 8JL, SA5 8JN, SA5 8JP, SA5 8JW, SA5 8JZ, SA5 8LG, SA5 8LS, SA5 8LY, SA5 8LZ, SA5 8NB",307,292,15
W00004069,SA5,"SA5 4TF, SA5 4TJ, SA5 4TL, SA5 4TW",175,159,16
W00004070,SA5,"SA5 5AL, SA5 5AU, SA5 5AZ, SA5 5BH, SA5 5DA, SA5 8HU, SA5 8HX",251,235,16
W00004074,SA5,"SA5 8ER, SA5 8ES, SA5 8ET, SA5 8EX, SA5 8JU, SA5 8JX, SA5 8JY, SA5 8LJ",232,210,22
W00004078,SA5,"SA5 4BH, SA5 4BP, SA5 4BR, SA5 4BS, SA5 4BT, SA5 4BW, SA5 4HJ, SA5 4LD, SA5 4LE, SA5 4LH, SA5 4NG, SA5 4NU",416,358,58
W00004079,SA5,"SA5 4HW, SA5 4JA, SA5 4JD, SA5 4NA, SA5 4NB, SA5 4ND, SA5 4NH, SA5 4NQ, SA5 4NX, SA5 4NY, SA5 4SG, SA5 4TG, SA5 4YA, SA5 4YD, SA5 4YN",331,289,42
W00004080,SA5,"SA5 4AN, SA5 4BA, SA5 4LJ, SA5 4LL, SA5 5DU, SA5 5DW, SA5 5DX, SA5 5DZ",252,231,21
W00004081,SA5,"SA5 5DD, SA5 5DE, SA5 5DF, SA5 5DG, SA5 5DJ, SA5 5DN, SA5 5DP",277,240,37
W00004082,SA5,"SA5 5AP, SA5 5DL, SA5 5DY, SA5 5EA, SA5 5EB",353,327,26
W00004083,SA5,"SA5 4AL, SA5 4AP, SA5 4AR, SA5 4AS, SA5 4AT, SA5 4AU, SA5 4AX, SA5 4DX, SA5 5DT",255,236,19
W00004084,SA5,"SA5 4AY, SA5 4AZ, SA5 4BB, SA5 4BL, SA5 4BN, SA5 4DL, SA5 4DN, SA5 4DP, SA5 4DR, SA5 4DS, SA5 4DT, SA5 4DU, SA5 4DY, SA5 4EJ, SA5 4ER, SA5 4HA, SA5 4HB, SA5 4HE, SA5 4RW",287,256,31
W00004085,SA5,"SA5 4BG, SA5 4QQ, SA5 4QS, SA5 4RA, SA5 4SH, SA5 4SJ, SA5 4SL, SA5 4SN",371,319,52
W00004087,SA5,"SA5 4EB, SA5 4ED, SA5 4EG, SA5 4EQ, SA5 4HF, SA5 4HG, SA5 4HL, SA5 5AB, SA5 5AX, SA5 5AY, SA5 5BD, SA5 5BJ, SA5 5BL, SA5 5BN, SA5 5BP, SA5 5BQ, SA5 5BS",221,198,23
W00004088,SA5,"SA5 5AN, SA5 5AS, SA5 5AW, SA5 5DH, SA5 8EG",318,293,25
W00004063,SA5,"SA5 4AG, SA5 5AD, SA5 5BA, SA5 5BB, SA5 5BE",248,226,22
W00004062,SA5,"SA5 8AJ, SA5 8DU, SA5 8DX, SA5 8DY, SA5 8YA, SA5 8YB, SA5 8YD, SA5 8YN",316,292,24
W00004061,SA5,"SA5 8DN, SA5 8DQ, SA5 8DW, SA5 8EN, SA5 8JR",255,237,18
W00004060,SA5,"SA5 4QD, SA5 4QF, SA5 4QT, SA5 4QU, SA5 4QZ",275,239,36
W00004395,SA5,"SA5 9BR, SA5 9BS, SA5 9BT, SA5 9BY, SA5 9BZ, SA5 9DL",281,258,23
W00004394,SA5,"SA5 9DB, SA5 9DF, SA5 9DG, SA6 7PS",284,256,28
W00004393,SA5,"SA5 9BL, SA6 7PB, SA6 7PD, SA6 7PE, SA6 7PJ",297,245,52
W00004392,SA5,"SA5 7HD, SA5 9AH, SA5 9AP, SA5 9AS, SA5 9AY, SA5 9AZ, SA5 9BA, SA5 9BD",276,238,38
W00004389,SA5,"SA5 7HR, SA5 9AT, SA5 9AU, SA5 9BB, SA5 9BW, SA6 7PF",253,219,34
W00004384,SA5,"SA5 7HE, SA5 7HP, SA5 7HS, SA5 7JG, SA6 7NT, SA6 7NU",289,250,39
W00004382,SA5,"SA5 7HZ, SA6 7LG, SA6 7LL, SA6 7LN, SA6 8BS",391,357,34
W00004380,SA5,"SA5 7HY, SA6 7JY, SA6 7LH, SA6 7LJ",263,228,35
W00004090,SA5,"SA5 8BT, SA5 8DR, SA5 8DS",334,313,21
W00004373,SA5,"SA5 9EB, SA5 9ER, SA5 9ES, SA5 9HA, SA5 9HB, SA5 9HD, SA5 9HE, SA5 9HJ, SA5 9HL",266,259,7
W00004340,SA5,"SA5 8LQ, SA5 8NA, SA6 7BZ, SA6 8HU, SA6 8HY, SA6 8HZ, SA6 8JA, SA6 8LR, SA6 8NB, SA6 8ND, SA6 8YJ, SA6 8YL, SA6 8YR, SA6 8YS, SA6 8YT, SA6 8YW, SA6 8YX, SA6 8YY, SA6 8YZ, SA6 8ZA, SA6 8ZB",326,298,28
W00004244,SA5,"SA5 7JD, SA5 7JE, SA5 7JF, SA5 7JH, SA5 7JJ, SA6 6BX",225,194,31
W00004241,SA5,"SA5 7JL, SA6 6BH, SA6 6BL, SA6 6BN, SA6 6BQ, SA6 6DD, SA6 6DF, SA6 6DQ, SA6 6ES",263,229,34
W00004233,SA5,"SA5 9DT, SA6 8LP, SA6 8NX, SA6 8NY, SA6 8PA, SA6 8PB, SA6 8PD",285,248,37
W00004056,SA5,"SA5 4BJ, SA5 4BU, SA5 4BX, SA5 4BY, SA5 4BZ, SA5 4DA, SA5 4EP, SA5 4ES, SA5 4HR, SA5 4HY, SA5 4JB, SA5 4JR, SA5 4JS, SA5 4JT, SA5 4JU, SA5 4LA, SA5 4LB, SA5 4NE",237,207,30
W00004057,SA5,"SA5 5AA, SA5 5AJ, SA5 8BU, SA5 8BX, SA5 8BZ",300,285,15
W00004058,SA5,"SA5 8AB, SA5 8AD, SA5 8BR, SA5 8BS, SA5 8BY",333,313,20
W00004059,SA5,"SA5 8EL, SA5 8EP, SA5 8EW, SA5 8JS, SA5 8JT",278,253,25
W00004372,SA5,"SA5 9BP, SA5 9BX, SA5 9DA, SA5 9DD, SA5 9DE, SA5 9DQ, SA5 9DU, SA5 9DW",385,345,40
W00004448,SA5,"SA5 9AD, SA5 9AL, SA5 9AW, SA5 9BG, SA5 9BJ",222,209,13
W00004460,SA5,"SA5 4PG, SA5 4PH, SA5 5EW, SA5 5HU, SA5 5HY, SA5 5JB",238,216,22
W00010261,SA5,"SA5 4NZ, SA5 4PB",320,271,49
W00010262,SA5,"SA5 5EZ, SA5 5HN, SA5 5PA, SA5 5PB, SA5 5PH",210,198,12
W00010263,SA5,"SA5 4BD, SA5 4BE, SA5 4NF",276,242,34
W00010446,SA5,"SA5 8JA, SA5 8JB, SA5 8JE, SA5 8JG",224,207,17
W00004333,SA6,"SA6 8BJ, SA6 8BR, SA6 8DE, SA6 8DF, SA6 8DG, SA6 8DX, SA6 8EN",226,209,17
W00004236,SA6,"SA6 8JJ, SA6 8JT, SA6 8JU, SA6 8LB, SA6 8LE, SA6 8LF",272,248,24
W00004386,SA6,"SA6 7EE, SA6 7EF, SA6 7HH, SA6 7LE, SA6 7LF, SA6 7NX, SA6 7NY, SA6 7PL",323,279,44
W00004235,SA6,"SA6 8LJ, SA6 8LN, SA6 8LQ, SA6 8LU, SA6 8LX",260,239,21
W00004360,SA6,"SA6 6DX, SA6 6DY, SA6 6EH, SA6 6EJ, SA6 6JQ",245,227,18
W00004362,SA6,"SA6 6DU, SA6 6DZ, SA6 6EE, SA6 6ER, SA6 6EU, SA6 6HA",265,233,32
W00004242,SA6,"SA6 6DG, SA6 6EX, SA6 6FB, SA6 6FD, SA6 6FE",344,301,43
W00004363,SA6,"SA6 6AG, SA6 6AJ, SA6 6AW, SA6 6DR, SA6 6DS, SA6 6DT, SA6 6HE",348,268,80
W00004234,SA6,"SA6 8AX, SA6 8JF, SA6 8JL, SA6 8JN, SA6 8JP, SA6 8JR, SA6 8JW, SA6 8LH, SA6 8LL",265,233,32
W00004385,SA6,"SA6 7JZ, SA6 7LD, SA6 7LQ, SA6 7NS",250,229,21
W00004364,SA6,"SA6 6GH, SA6 6GJ, SA6 6HN, SA6 6HR, SA6 6HW, SA6 8ER",253,222,31
W00004361,SA6,"SA6 6JF, SA6 6JR, SA6 6JZ, SA6 6LB",164,151,13
W00004243,SA6,"SA6 6BY, SA6 6DA, SA6 6DB, SA6 6DE, SA6 6DW, SA6 6EF, SA6 6EW",383,343,40
W00004387,SA6,"SA6 7QE, SA6 7QF, SA6 7QH, SA6 7QQ, SA6 8PG",272,251,21
W00004388,SA6,"SA6 7EB, SA6 7ED, SA6 7NZ, SA6 7PA, SA6 7PQ, SA6 7QG, SA6 7YF, SA6 7YG",314,281,33
W00004350,SA6,"SA6 6QN, SA6 6QP, SA6 6QW, SA6 6RH, SA6 6RW",256,215,41
W00004351,SA6,"SA6 6NE, SA6 6PY, SA6 6QE, SA6 6QG, SA6 6RT",291,261,30
W00004352,SA6,"SA6 6EA, SA6 6JW, SA6 6LA, SA6 6LJ, SA6 6LT, SA6 6PR, SA6 6SF, SA6 6SG",289,252,37
W00004353,SA6,"SA6 6AN, SA6 6LP, SA6 6LR, SA6 6LS",267,231,36
W00004354,SA6,"SA6 6NB, SA6 6PZ, SA6 6QJ, SA6 6QS, SA6 6RR, SA6 6RS",254,227,27
W00004355,SA6,"SA6 6JL, SA6 6JP, SA6 6LU, SA6 6LX",305,279,26
W00004356,SA6,"SA6 6NA, SA6 6RU, SA6 6SA, SA6 6SB",284,246,38
W00004357,SA6,"SA6 6QH, SA6 6RX, SA6 6RY, SA6 6RZ",284,269,15
W00004358,SA6,"SA6 6JG, SA6 6JT, SA6 6JU",262,239,23
W00004359,SA6,"SA6 6EB, SA6 6ED, SA6 6EL, SA6 6EN, SA6 6EP, SA6 6LH, SA6 6ND, SA6 6XZ, SA6 6YA, SA6 6YD, SA6 6YP, SA6 6YS, SA6 6YT, SA6 6YX, SA6 6YZ, SA6 6ZR",243,211,32
W00004391,SA6,"SA6 7PG, SA6 7PH, SA6 7PN, SA6 7PP, SA6 7PR",256,236,20
W00004301,SA6,"SA6 5RJ, SA6 5SY, SA6 5SZ, SA6 5TA, SA6 5TB, SA6 5TD, SA6 5TE, SA6 5TQ, SA6 5TR",308,234,74
W00004390,SA6,"SA6 7PW, SA6 8PE, SA6 8PF",291,263,28
W00004304,SA6,"SA6 5RB, SA6 5RD, SA6 5RE, SA6 5RZ",180,145,35
W00004305,SA6,"SA6 5RA, SA6 5RF, SA6 5RG, SA6 5RH, SA6 5RL, SA6 5RP, SA6 5RQ, SA6 5RR",370,249,121
W00004383,SA6,"SA6 7EX, SA6 7HJ, SA6 7HL, SA6 7HN, SA6 7HR, SA6 7HU, SA6 7HW",258,236,22
W00004381,SA6,"SA6 7HP, SA6 7HS, SA6 7HX, SA6 7JS, SA6 7JU, SA6 7JX, SA6 7LA, SA6 7LB, SA6 7LT, SA6 7LW",340,314,26
W00004379,SA6,"SA6 7HT, SA6 7HY, SA6 7JA, SA6 7JB, SA6 7JD, SA6 7JE, SA6 7JF, SA6 7LY, SA6 7LZ, SA6 7NB, SA6 7NE, SA6 7NF",395,359,36
W00004365,SA6,"SA6 6AL, SA6 6HP, SA6 6HS, SA6 6JA, SA6 6JD, SA6 6LD, SA6 6QB, SA6 6QD",288,256,32
W00004042,SA6,"SA6 5AU, SA6 5DS, SA6 5DU, SA6 5EA, SA6 5EB",270,232,38
W00004041,SA6,"SA6 5HA, SA6 5HB, SA6 5HD",266,218,48
W00004040,SA6,"SA6 5DF, SA6 5DH, SA6 5DQ, SA6 5DW",307,273,34
W00004039,SA6,"SA6 5LT, SA6 5LY, SA6 5QD, SA6 5QE, SA6 8NR",187,159,28
W00004038,SA6,"SA6 5DP, SA6 5DR, SA6 5DX",230,201,29
W00004037,SA6,"SA6 5NJ, SA6 5PU, SA6 5PY, SA6 5PZ, SA6 5QB, SA6 5QU",272,211,61
W00004036,SA6,"SA6 5EJ, SA6 5EL, SA6 5EN, SA6 5LE, SA6 5LF, SA6 5LG, SA6 5LH, SA6 5LJ, SA6 5LL, SA6 5LQ, SA6 5LW, SA6 5LZ, SA6 5QP, SA6 5QR",275,238,37
W00004035,SA6,"SA6 5FB, SA6 5HR, SA6 5HS, SA6 5HU, SA6 5HX, SA6 5HY, SA6 5HZ",304,241,63
W00004034,SA6,"SA6 5GA, SA6 5HL, SA6 5JZ, SA6 5LS, SA6 5PG, SA6 5PL, SA6 5PN",304,237,67
W00004033,SA6,"SA6 5HF, SA6 5LA, SA6 5LD, SA6 5LX, SA6 5NG, SA6 5NQ, SA6 5NW, SA7 9RU",436,325,111
W00004032,SA6,"SA6 5EP, SA6 5ER, SA6 5ES, SA6 5ET, SA6 5EW, SA6 5HP, SA6 5HT, SA6 5YF, SA6 5YL, SA6 5YR, SA6 5YU",337,257,80
W00004031,SA6,"SA6 5NR, SA6 5NS, SA6 5NT, SA6 5NU, SA6 5NX, SA6 5NY, SA6 5PA, SA6 5PE, SA6 5PP, SA7 9HR, SA7 9JA, SA7 9JD, SA7 9JG",336,239,97
W00004030,SA6,"SA6 5HE, SA6 5HH, SA6 5JN, SA6 5JP, SA6 5JW, SA6 5LB, SA6 5NP",351,285,66
W00004220,SA6,"SA6 8LD, SA6 8LG, SA6 8NL, SA6 8NN, SA6 8NP, SA6 8NQ, SA6 8NS, SA6 8NT, SA6 8NU, SA6 8NW",301,274,27
W00004232,SA6,"SA6 8LS, SA6 8LT, SA6 8LW, SA6 8LY, SA6 8LZ, SA6 8NA",284,264,20
W00004043,SA6,"SA6 5AT, SA6 5BB, SA6 5BG, SA6 5BJ, SA6 5BQ, SA6 5BU, SA6 5BX, SA6 5BY, SA6 5BZ, SA6 5DA, SA6 5DB, SA6 5DD, SA6 5DE, SA6 5DG, SA6 5DT, SA6 5EG, SA6 5EH",335,271,64
W00004349,SA6,"SA6 6QR, SA6 6RJ, SA6 6RL, SA6 6RN, SA6 6RP",243,211,32
W00004044,SA6,"SA6 5EU, SA6 5EX, SA6 5EY, SA6 5FA, SA6 5LN, SA6 5LP, SA6 5LR, SA6 5LU",330,279,51
W00004378,SA6,"SA6 7LP, SA6 7LR, SA6 7LS, SA6 7LU, SA6 7LX",235,229,6
W00004366,SA6,"SA6 6GY, SA6 6HD, SA6 6HG, SA6 6HH, SA6 6HQ",307,264,43
W00004367,SA6,"SA6 6AF, SA6 6DH, SA6 6DJ, SA6 6DN, SA6 6DP, SA6 7AX, SA6 7BE, SA6 7DN, SA6 7DP, SA6 7DW",319,276,43
W00004368,SA6,"SA6 6AB, SA6 6HT, SA6 6HU, SA6 6HX, SA6 8BB, SA6 8EB, SA6 8ED, SA6 8EE, SA6 8EG, SA6 8EH, SA6 8EJ, SA6 8EQ",337,315,22
W00004369,SA6,"SA6 6AD, SA6 6AE, SA6 6HB, SA6 6HJ, SA6 6HY, SA6 6HZ, SA6 6LE, SA6 6LF",279,258,21
W00004370,SA6,"SA6 6AA, SA6 6HL, SA6 7AA, SA6 7AB, SA6 7AD, SA6 7AE, SA6 7AF, SA6 7AG, SA6 7AH, SA6 7AQ, SA6 7AU, SA6 7BA, SA6 8AL, SA6 8AP, SA6 8AR, SA6 8AU, SA6 8AW",309,286,23
W00004371,SA6,"SA6 6AP, SA6 6AS, SA6 6AX, SA6 6BA, SA6 6BE",275,257,18
W00004374,SA6,"SA6 6BS, SA6 6BT, SA6 6BU, SA6 6BZ, SA6 7HG, SA6 7JL, SA6 7NA, SA6 7ND, SA99 1AA, SA99 1AB, SA99 1AD, SA99 1AE, SA99 1AF, SA99 1AG, SA99 1AH, SA99 1AJ, SA99 1AL, SA99 1AN, SA99 1AP, SA99 1AQ, SA99 1AR, SA99 1AS, SA99 1AT, SA99 1AU, SA99 1AW, SA99 1AX, SA99 1AY, SA99 1AZ, SA99 1BA, SA99 1BB, SA99 1BD, SA99 1BE, SA99 1BF, SA99 1BG, SA99 1BH, SA99 1BJ, SA99 1BL, SA99 1BN, SA99 1BP, SA99 1BQ, SA99 1BR, SA99 1BS, SA99 1BT, SA99 1BU, SA99 1BW, SA99 1BX, SA99 1BY, SA99 1BZ, SA99 1DA, SA99 1DB, SA99 1DD, SA99 1DE, SA99 1DF, SA99 1DG, SA99 1DH, SA99 1DJ, SA99 1DL, SA99 1DN, SA99 1DP, SA99 1DQ, SA99 1DR, SA99 1DS, SA99 1DT, SA99 1DU, SA99 1DW, SA99 1DX, SA99 1DY, SA99 1DZ, SA99 1ST, SA99 1TU, SA99 1YW, SA99 1YX, SA99 1ZA, SA99 1ZB, SA99 1ZU, SA99 1ZW, SA99 1ZX, SA99 1ZY, SA99 1ZZ",253,222,31
W00004054,SA6,"SA6 5PD, SA6 5PF, SA6 5PJ, SA6 5PW, SA8 4DQ",257,201,56
W00004053,SA6,"SA6 5JH, SA6 5JJ, SA6 5JL, SA6 5JR",239,194,45
W00004052,SA6,"SA6 5PB, SA6 5PX, SA8 4DF, SA8 4DG, SA8 4DU, SA8 4DX",247,167,80
W00004051,SA6,"SA6 5HJ, SA6 5JS, SA6 5JT, SA6 5JU",224,182,42
W00004050,SA6,"SA6 5DJ, SA6 5DL, SA6 5DN, SA6 5EZ, SA6 5JB, SA6 5JD, SA6 5JE, SA6 5JG",288,238,50
W00004049,SA6,"SA6 5NA, SA6 5NB, SA6 5ND, SA6 5NE, SA6 5NF",299,240,59
W00004048,SA6,"SA6 5HG, SA6 5HQ, SA6 5JF, SA6 5JX, SA6 5JY, SA6 5NH",190,161,29
W00004047,SA6,"SA6 5HN, SA6 5HW, SA6 5JA, SA6 5JQ, SA6 5ST, SA6 5SU, SA6 5SX",279,225,54
W00004045,SA6,"SA6 5ED, SA6 5EE, SA6 5EF, SA6 5EQ",286,263,23
W00004332,SA6,"SA6 8AB, SA6 8AD, SA6 8AE, SA6 8AQ, SA6 8AS, SA6 8AY, SA6 8AZ, SA6 8BA, SA6 8BH, SA6 8BT, SA6 8BZ, SA6 8DL, SA6 8DN, SA6 8DQ, SA6 8DR, SA6 8DS, SA6 8DT, SA6 8DU, SA6 8DY, SA6 8DZ, SA6 8EA, SA6 8PX, SA6 8PY",300,281,19
W00004377,SA6,"SA6 6AY, SA6 6AZ, SA6 6BB, SA6 6BD, SA6 7JG, SA6 7JQ",254,235,19
W00010259,SA6,"SA6 8AN, SA6 8JD, SA6 8PJ, SA6 8PP, SA6 8PS, SA6 8PT, SA6 8QG, SA6 8QJ, SA6 8QL, SA6 8QQ, SA6 8QR, SA6 8RU, SA6 8RX, SA6 8WB, SA7 0AE, SA7 0AF, SA7 0AG, SA7 0AH, SA7 0AJ, SA7 0AL, SA7 0AP, SA7 0AQ, SA7 0NE, SA7 0NF, SA7 0NG, SA7 0NH, SA7 9DN, SA7 9DW, SA7 9DZ, SA7 9RX",331,266,65
W00005037,SA6,"SA6 5WX, SA6 5WY, SA6 5WZ, SA6 5YA, SA6 5YB, SA6 5YD, SA6 5YE, SA6 5YH, SA6 5YN, SA6 5YS, SA6 5YT, SA6 5YW, SA6 5ZR, SA6 5ZW, SA8 3HZ, SA8 3WZ, SA8 3YG, SA8 3YL, SA8 3YN, SA8 3YP, SA8 3YR, SA8 3ZB, SA8 4EL, SA8 4HH, SA8 4HL, SA8 4LP, SA8 4PD, SA8 4PE, SA8 4PH, SA8 4PQ, SA8 4PX, SA8 4WJ, SA8 4WL, SA8 4WN, SA8 4WP, SA8 4WQ, SA8 4WR, SA8 4WS, SA8 4WT, SA8 4WU, SA8 4WW, SA8 4WX, SA8 4WY, SA8 4WZ, SA8 4YA, SA8 4YB, SA8 4YD, SA8 4YE, SA8 4YF, SA8 4YG, SA8 4YH, SA8 4YL, SA8 4YN, SA8 4YQ, SA8 4YS, SA8 4YU, SA8 4YW, SA8 4ZB, SA8 9AB, SA8 9AD, SA8 9AE, SA8 9AG, SA8 9AH, SA8 9AJ, SA8 9AL, SA8 9AN, SA8 9AP, SA8 9AQ, SA8 9AR, SA8 9AS, SA8 9AT, SA8 9AU, SA8 9AW, SA8 9AX, SA8 9AY, SA8 9AZ, SA8 9BA, SA8 9BB, SA8 9BD, SA8 9BE, SA8 9BF, SA8 9BG, SA9 1WX, SA9 1YA, SA9 1YE, SA9 5AA, SA9 5AB, SA9 5AG",302,206,96
W00004247,SA6,"SA6 6EG, SA6 6FP",162,155,7
W00004291,SA6,"SA6 8EL, SA6 8EZ, SA6 8NE, SA6 8PL, SA6 8PN, SA6 8PZ, SA6 8QA, SA6 8QB, SA6 8QE, SA6 8QF, SA6 8QH, SA6 8QN, SA6 8QP, SA6 8QW, SA6 8QX, SA6 8RA, SA6 8RB, SA6 8RD, SA6 8RF, SA6 8RH, SA6 8RN, SA6 8RP, SA6 8YB, SA6 8YE, SA6 8YF, SA6 8YG, SA6 8YN, SA6 8YP, SA7 9AA, SA7 9AB, SA7 9AD, SA7 9AE, SA7 9AF, SA7 9AG, SA7 9AH, SA7 9AJ, SA7 9AN, SA7 9AP, SA7 9AQ, SA7 9AR, SA7 9AS, SA7 9AT, SA7 9AW, SA7 9BY, SA7 9DB, SA7 9DD, SA7 9DE, SA7 9DF, SA7 9DG, SA7 9DH, SA7 9DJ, SA7 9DL, SA7 9EF, SA7 9EG, SA7 9EH, SA7 9EL, SA7 9EQ, SA7 9FB, SA7 9FD, SA7 9FE, SA7 9FF, SA7 9FG, SA7 9FH, SA7 9FL, SA7 9FN, SA7 9FP, SA7 9FR, SA7 9FS, SA7 9FU, SA7 9FW, SA7 9FX, SA7 9FY, SA7 9FZ, SA7 9GH, SA7 9HG, SA7 9HW, SA7 9HZ, SA7 9LZ, SA7 9RD, SA7 9RG, SA7 9RH, SA7 9RL, SA7 9RQ, SA7 9RT",310,257,53
W00004322,SA6,"SA6 6NG, SA6 6NH, SA6 6NN, SA6 6NQ, SA6 6RA, SA6 6TF",248,229,19
W00004337,SA6,"SA6 7BP, SA6 7BT, SA6 7BX, SA6 7BY, SA6 7DB, SA6 8HH, SA6 8HJ",255,228,27
W00004336,SA6,"SA6 8DD, SA6 8DJ, SA6 8EF, SA6 8ES, SA6 8ET, SA6 8EU, SA6 8EW, SA6 8EX, SA6 8HD, SA6 8PU",259,243,16
W00004335,SA6,"SA6 7BG, SA6 7DD, SA6 8BL, SA6 8BN",243,220,23
W00004334,SA6,"SA6 7EG, SA6 7EH, SA6 7EN, SA6 7EQ",226,206,20
W00010084,SA6,"SA6 5SH, SA6 5SJ, SA6 5SL, SA6 5SN, SA6 5SP, SA6 5SR, SA6 6NL, SA6 6NP, SA6 6NS, SA6 6NT, SA6 6NW, SA6 6PL, SA6 6PS, SA6 6PU, SA6 6PX, SA6 6QA",343,292,51
W00010260,SA6,"SA6 8AJ, SA6 8PW, SA6 8QD, SA6 8QS, SA6 8QU, SA6 8QZ, SA6 8RT, SA7 0AA, SA7 0AB, SA7 0AD, SA7 0AN, SA7 0AR, SA7 0AS, SA7 0AT, SA7 0EA, SA7 0EE, SA7 0EP, SA7 0ER, SA7 0ES, SA7 0ET, SA7 0EU, SA7 0NJ, SA7 0NT, SA7 9GF, SA7 9GG, SA7 9RJ, SA7 9RN, SA7 9RW",380,282,98
W00004376,SA6,"SA6 6AH, SA6 6AR, SA6 6AT, SA6 6AU",178,154,24
W00010256,SA6,"SA6 6LG, SA6 6LZ, SA6 6PJ, SA6 6SN, SA6 6TN, SA6 6TU, SA6 6TW, SA6 6YE, SA6 6YF, SA6 6YG, SA6 6YH",333,302,31
W00004316,SA6,"SA6 7DX, SA6 7EJ, SA6 7EL, SA6 7ER",264,228,36
W00004317,SA6,"SA6 8AA, SA6 8AG, SA6 8BD, SA6 8BE, SA6 8BP, SA6 8BQ, SA6 8BU, SA6 8EP",372,350,22
W00010250,SA6,SA6 5BS,388,325,63
W00010249,SA6,"SA6 6PN, SA7 0HH, SA7 0HL, SA7 0HP, SA7 0HY, SA7 0PN",422,340,82
W00004318,SA6,"SA6 8HL, SA6 8HN, SA6 8HS, SA6 8HT, SA6 8HW, SA6 8HX, SA6 8JB",252,234,18
W00004320,SA6,"SA6 5AA, SA6 5AB, SA6 5AE, SA6 5AP, SA6 5AW, SA6 5AX, SA6 5AY, SA6 5BP, SA6 6QL",330,261,69
W00004321,SA6,"SA6 6SP, SA6 6SR, SA6 6ST, SA6 6SW, SA6 6SY, SA6 6TE",250,237,13
W00004338,SA6,"SA6 7BS, SA6 7BW, SA6 8BG, SA6 8BY, SA6 8DA, SA6 8DB, SA6 8DH, SA6 8EY, SA6 8HA, SA6 8HB, SA6 8HF, SA6 8HG, SA6 8HP, SA6 8HQ, SA6 8HR, SA6 8JE, SA6 8JG, SA6 8JH, SA6 8PR",252,234,18
W00004341,SA6,"SA6 5AL, SA6 5BA, SA6 5BD, SA6 5BE, SA6 5BH, SA6 5BW, SA6 5DY, SA6 5DZ, SA6 5SS",344,261,83
W00004339,SA6,"SA6 7BH, SA6 7BJ, SA6 7BL, SA6 7BN, SA6 7BQ, SA6 7BU, SA6 8BW, SA6 8HE",306,284,22
W00004343,SA6,"SA6 6SS, SA6 6SU, SA6 6SX, SA6 6SZ, SA6 6TQ",268,245,23
W00004324,SA6,"SA6 6FF, SA6 6FG, SA6 6FH, SA6 6FJ, SA6 6LL, SA6 6LN, SA6 6LW, SA6 6TP",318,280,38
W00004323,SA6,"SA6 5QY, SA6 6QT, SA6 6TG, SA6 6TH, SA6 6TJ",218,194,24
W00004342,SA6,"SA6 6TA, SA6 6TB, SA6 6TR, SA6 6TX",249,220,29
W00004330,SA6,"SA6 7AN, SA6 7AR, SA6 7AZ, SA6 7BB, SA6 7BD, SA6 7BR, SA6 7ES, SA6 7EU, SA6 7QJ, SA6 7QL, SA6 8PQ",249,228,21
W00004329,SA6,"SA6 7DS, SA6 7DU, SA6 7EP, SA6 7ET, SA6 7EW, SA6 7YB",298,270,28
W00004327,SA6,"SA6 6AQ, SA6 6JE, SA6 6JX, SA6 6JY",309,276,33
W00004325,SA6,"SA6 6LY, SA6 6NF, SA6 6PH, SA6 6PP, SA6 6PW",248,229,19
W00004326,SA6,"SA6 6JH, SA6 6JJ, SA6 6JN, SA6 6JS",326,307,19
W00004348,SA6,"SA6 6QQ, SA6 6QU, SA6 6QX, SA6 6QY, SA6 6SE",254,222,32
W00004347,SA6,"SA6 6LQ, SA6 6NJ, SA6 6NZ, SA6 6PT, SA6 6RB, SA6 6RD",250,220,30
W00004346,SA6,"SA6 6TD, SA6 6TL, SA6 6TS, SA6 6TT",264,232,32
W00004345,SA6,"SA6 6QF, SA6 6QZ, SA6 6RE, SA6 6RF, SA6 6RG, SA6 6RQ, SA6 6SD",264,234,30
W00004344,SA6,"SA6 5AD, SA6 5AF, SA6 5AG, SA6 5AH, SA6 5AJ, SA6 5AN, SA6 5AQ, SA6 5AR, SA6 5AS, SA6 6SH",324,259,65
W00004245,SA6,"SA6 6BJ, SA6 6EQ, SA6 6ET, SA6 6EY",190,168,22
W00003137,SA61,"SA61 1LU, SA61 1LW, SA61 1LX, SA61 1LY, SA61 1NB, SA61 1XG, SA61 1XL, SA62 4LA",233,208,25
W00003139,SA61,"SA61 1JL, SA61 1LE, SA61 1LG, SA61 1LJ, SA61 1UJ, SA62 4ES",391,353,38
W00003063,SA61,"SA61 1BF, SA61 1EL, SA61 1EP, SA61 1JH, SA61 1NT, SA61 1PE, SA61 1PF, SA61 1PG, SA61 1PH, SA61 1PQ, SA61 1SZ, SA61 1WA, SA61 1WE, SA61 1WH, SA61 1WN, SA61 1WP, SA61 1WQ, SA61 1WR, SA61 1WT, SA61 1XA, SA61 1XT, SA61 1XU, SA61 1YA, SA61 1YB, SA61 1YD, SA61 1YE, SA61 1YF, SA61 1YH, SA61 1YL, SA61 1YN, SA61 1YQ, SA61 1YR, SA61 1YS, SA61 2BS, SA61 2WA, SA61 2WR, SA61 2WX, SA61 2WY, SA61 2XR, SA61 2XZ, SA61 2YA, SA61 2YD, SA61 2YG, SA61 2YP, SA61 2YQ, SA61 2YR, SA61 2YU, SA61 2YW, SA61 2YZ, SA61 2ZW, SA61 9AA, SA61 9AB, SA61 9AD, SA61 9AE, SA61 9AF, SA61 9AG, SA61 9AH, SA61 9AJ, SA61 9AL, SA61 9AN, SA61 9AP, SA61 9AQ, SA61 9AR, SA61 9AS, SA61 9AT, SA61 9AU, SA61 9AW, SA61 9AX, SA61 9AY, SA61 9AZ, SA61 9BA, SA61 9BB, SA61 9DA, SA61 9DB, SA61 9DD, SA61 9DE, SA61 9DF, SA61 9DG, SA61 9DH, SA61 9DJ, SA61 9DL, SA61 9DN, SA61 9DP, SA61 9DQ, SA61 9DR, SA61 9DS, SA61 9DT, SA61 9DU, SA61 9DW, SA61 9DX, SA61 9DY, SA61 9DZ, SA61 9EA, SA61 9EB, SA61 9EE, SA61 9EF, SA61 9EG, SA61 9EH, SA61 9EJ, SA61 9ZZ, SA62 3WZ, SA62 3YA, SA62 3YB, SA62 3YD, SA62 3YE, SA62 3YN, SA62 3YT, SA62 3YU, SA62 3ZA, SA62 4WZ, SA62 4YA, SA62 4YF, SA62 4YG, SA62 4YJ, SA62 4YN, SA62 4YS, SA62 4YT, SA62 4YU, SA62 4ZW, SA62 5WA, SA62 5WR, SA62 5WU, SA62 5WW, SA62 5WY, SA62 5WZ, SA62 5XZ, SA62 5YE, SA62 5YF, SA62 5YG, SA62 5YN, SA62 5YU, SA62 6WA, SA62 6WZ, SA62 6YG, SA62 6YH, SA62 6YR, SA62 6YS, SA62 6YT, SA62 6YU, SA62 6YW, SA62 6YX, SA62 6YY, SA63 4WR, SA63 4WY, SA63 4WZ, SA63 4YA, SA73 3ER, SA73 3JD, SA73 9AA, SA73 9AH, SA73 9AJ, SA73 9AL, SA73 9AN, SA73 9AP",231,205,26
W00003062,SA61,"SA61 1RQ, SA61 1RU, SA61 1RX, SA61 1RZ, SA61 1SE, SA61 1SL, SA61 1TJ",255,223,32
W00003138,SA61,"SA61 1AD, SA61 1HN, SA61 1JJ, SA61 1JN, SA61 1JP, SA61 1JW, SA61 1LR, SA61 1XB, SA61 1XD, SA61 1XE, SA61 1XF, SA61 1XJ, SA61 1XN, SA61 1XS, SA61 1XX, SA61 1YG",373,330,43
W00003135,SA61,"SA61 1LB, SA61 1LQ, SA61 1NA",319,274,45
W00003136,SA61,"SA61 1JS, SA61 1JT, SA61 1JU, SA61 1LN, SA61 1LS, SA61 1LT, SA61 1LZ",278,242,36
W00003134,SA61,"SA61 1LA, SA61 1LP, SA61 1ND, SA61 1NN, SA61 1NW",309,268,41
W00003064,SA61,"SA61 1PD, SA61 1SG, SA61 1SQ, SA61 1TL",248,213,35
W00003060,SA61,"SA61 1RY, SA61 1SN, SA61 1SW, SA61 1UH",170,148,22
W00003140,SA61,"SA61 1JX, SA61 1LD, SA61 1LF, SA61 1LH, SA61 1LL",237,211,26
W00003059,SA61,"SA61 1TN, SA61 1TR, SA61 1TS, SA61 1TT, SA61 1TU, SA61 1TW, SA61 1TX, SA61 1TY, SA61 1UG, SA61 2AH, SA61 2LH, SA61 2LY, SA61 2LZ, SA61 2NR",287,245,42
W00003042,SA61,"SA61 2RZ, SA61 2SA, SA61 2SE, SA61 2SG, SA61 2SQ, SA61 2TZ, SA61 2UB, SA61 2UG, SA61 2UH",240,220,20
W00003057,SA61,"SA61 2QF, SA61 2QN, SA61 2QP, SA61 2QR, SA61 2QS, SA61 2QW, SA61 2RF, SA61 2RH, SA61 2RJ",340,293,47
W00003041,SA61,"SA61 2DL, SA61 2HA, SA61 2HF, SA61 2HU, SA61 2JR, SA61 2SH, SA61 2SJ, SA61 2UN, SA61 2UR, SA61 2YB, SA61 2YE, SA61 2YH, SA61 2YN, SA61 2YS, SA61 2YX",263,227,36
W00003044,SA61,"SA61 1AE, SA61 1AT, SA61 1BU, SA61 1PJ, SA61 1PL, SA61 1PP, SA61 1TB, SA61 1TD, SA61 2EJ, SA61 2EL, SA61 2EN",258,220,38
W00003039,SA61,"SA61 2AU, SA61 2TD, SA61 2TE, SA61 2TG, SA61 2UA",219,191,28
W00003038,SA61,"SA61 2RU, SA61 2RX, SA61 2RY, SA61 2SB, SA61 2SD",310,288,22
W00003045,SA61,"SA61 1BY, SA61 2EH, SA61 2RL, SA61 2RN, SA61 2RP, SA61 2RR, SA61 2SF, SA61 2ST",361,326,35
W00003046,SA61,"SA61 1BS, SA61 1BX, SA61 1DX, SA61 1DZ, SA61 1EA, SA61 1JA, SA61 2BE",371,327,44
W00003047,SA61,"SA61 2AY, SA61 2AZ, SA61 2BA, SA61 2BB, SA61 2BD, SA61 2BG, SA61 2TQ",369,337,32
W00003048,SA61,"SA61 1DA, SA61 1DB, SA61 1DD, SA61 1DE, SA61 1DF, SA61 1DG, SA61 1DH, SA61 1DJ, SA61 1DL, SA61 1DQ, SA61 1DS, SA61 2XA",243,211,32
W00003049,SA61,"SA61 1BP, SA61 1BT, SA61 1BW, SA61 1BZ, SA61 2AX, SA61 2BQ",278,250,28
W00003050,SA61,"SA61 1DN, SA61 1DP, SA61 1DR, SA61 1DT, SA61 1DU, SA61 1DW, SA61 1HZ, SA61 2TF",235,206,29
W00003051,SA61,"SA61 1BN, SA61 1EG, SA61 1EH, SA61 1EJ, SA61 1EQ, SA61 1ER, SA61 1JB, SA61 1JF, SA61 1JG",243,199,44
W00003052,SA61,"SA61 2QX, SA61 2RA, SA61 2RD, SA61 2RE, SA61 2RQ",241,221,20
W00003053,SA61,"SA61 2BJ, SA61 2EX, SA61 2NN, SA61 2NS, SA61 2NW, SA61 2PA, SA61 2PB, SA61 2PL, SA61 2PN, SA61 2PP, SA61 2PY, SA61 2PZ, SA61 2QA",267,228,39
W00003054,SA61,"SA61 2PF, SA61 2QJ, SA61 2QQ, SA61 2QT, SA61 2QU, SA61 2RB, SA61 2XF, SA61 2XN",289,255,34
W00003055,SA61,"SA61 2LG, SA61 2ND, SA61 2NE, SA61 2NF, SA61 2NL, SA61 2NP, SA61 2NT, SA61 2NU, SA61 2NX, SA61 2NZ, SA61 2PD, SA61 2PE, SA61 2PW, SA61 2QY, SA61 2RG",309,275,34
W00002966,SA61,"SA61 2UF, SA61 2UX, SA61 2UY, SA61 2UZ, SA61 2WL, SA62 3HS, SA62 3LG, SA62 3LL, SA62 3LQ, SA62 3LR, SA62 3LS, SA62 3NR",216,186,30
W00003281,SA61,"SA61 1UP, SA61 1UT, SA61 2XG, SA61 2XQ, SA61 2YF, SA61 2YT, SA61 2YY, SA62 4AA, SA62 4AB, SA62 4AD, SA62 4AE, SA62 4AG, SA62 4AH, SA62 4AJ, SA62 4AL, SA62 4AQ, SA62 4AW, SA62 4PA, SA62 4PB, SA62 4YH, SA62 4YL, SA62 4YP, SA62 4YR",189,162,27
W00003282,SA61,"SA61 1TZ, SA61 1UA, SA61 1UB, SA61 1UD, SA61 1UE, SA61 1UF, SA61 1UR, SA61 2XE, SA61 2XH",350,279,71
W00009987,SA61,"SA61 1ED, SA61 1ES, SA61 1ET, SA61 1EW, SA61 1FA, SA61 1FB, SA61 1FD, SA61 1HD, SA61 1HG, SA61 1HH",329,282,47
W00009986,SA61,"SA61 1DY, SA61 1HJ, SA61 1HL, SA61 1HP, SA61 1HQ, SA61 1HR, SA61 1HS, SA61 1HT, SA61 1HU, SA61 1HX, SA61 1HY, SA61 1JD, SA61 1JE",291,242,49
W00003056,SA61,"SA61 2PG, SA61 2PH, SA61 2PJ, SA61 2PQ, SA61 2PU, SA61 2PX, SA61 2QB, SA61 2QD, SA61 2QE, SA61 2QG, SA61 2QH, SA61 2QL, SA61 2QZ, SA61 2SX",338,294,44
W00003058,SA61,"SA61 1BQ, SA61 1NX, SA61 1NY, SA61 1NZ, SA61 1PA, SA61 1PB, SA61 1SF, SA61 1SH, SA61 1SJ, SA61 1YP",221,197,24
W00003043,SA61,"SA61 2RS, SA61 2RT, SA61 2SL, SA61 2SN, SA61 2SP, SA61 2SS",241,220,21
W00003040,SA61,"SA61 2TA, SA61 2TB, SA61 2TJ, SA61 2TL",333,290,43
W00003065,SA61,"SA61 1EB, SA61 1EE, SA61 1EF, SA61 1EN, SA61 1EU, SA61 1EX, SA61 1EY, SA61 1EZ, SA61 1FE, SA61 1HA, SA61 1HB, SA61 1XP, SA61 1XQ, SA61 1XR",464,394,70
W00003027,SA61,"SA61 1AB, SA61 1AG, SA61 1AJ, SA61 1AL, SA61 1AN, SA61 1AQ, SA61 1AR, SA61 1AU, SA61 1AW, SA61 1AX, SA61 1BE, SA61 1PT, SA61 1PU, SA61 1PW, SA61 1PY, SA61 1PZ, SA61 1QA, SA61 1QB, SA61 1QD, SA61 1QR, SA61 1QX, SA61 1QY, SA61 1QZ, SA61 1RB, SA61 1RD, SA61 1RG, SA61 1RJ, SA61 1RL, SA61 1SB, SA61 1TE",274,244,30
W00010679,SA61,"SA61 2AT, SA62 4BB, SA62 4BL, SA62 4BP, SA62 4BQ, SA62 4BU, SA62 4BW, SA62 4BY, SA62 4DF, SA62 4DG, SA62 4FG",315,257,58
W00010680,SA61,"SA61 2PS, SA61 2PT, SA62 4AF",293,240,53
W00003028,SA61,"SA61 1NE, SA61 1NU, SA61 1QE, SA61 1QN, SA61 1QS, SA61 1QT, SA61 1QU, SA61 1QW, SA61 1RE, SA61 1RF, SA61 1RH, SA61 1RN, SA61 1RP, SA61 1RR, SA61 1RS, SA61 1RT, SA61 1RW, SA61 1SA, SA61 1SD, SA61 1TH, SA61 1UL, SA61 1UU, SA61 1WB, SA61 1WD, SA61 1WF, SA61 1WG, SA61 1WJ, SA61 1WL, SA61 1WS, SA61 2DN",252,238,14
W00003029,SA61,"SA61 2HP, SA61 2HQ, SA61 2HR, SA61 2HS, SA61 2HT",235,196,39
W00003030,SA61,"SA61 2AJ, SA61 2HD, SA61 2HE, SA61 2HG, SA61 2HH, SA61 2HJ, SA61 2HL, SA61 2HN, SA61 2HW, SA61 2HX, SA61 2HY, SA61 2HZ, SA61 2JA, SA61 2JB, SA61 2JE, SA61 2JF, SA61 2JL, SA61 2JN, SA61 2JQ",316,258,58
W00003031,SA61,"SA61 1AA, SA61 1BA, SA61 1BB, SA61 1BD, SA61 1BG, SA61 1BH, SA61 1PR, SA61 1PS, SA61 1PX, SA61 1TP, SA61 1ZA, SA61 2AA, SA61 2AB, SA61 2AD, SA61 2AE, SA61 2AF, SA61 2AG, SA61 2AL, SA61 2AN, SA61 2AP, SA61 2AQ, SA61 2AR, SA61 2AS, SA61 2AW, SA61 2BH, SA61 2BN, SA61 2BP, SA61 2BT, SA61 2BU, SA61 2BW, SA61 2DA, SA61 2DB, SA61 2DE, SA61 2DF, SA61 2DG, SA61 2DH, SA61 2DJ, SA61 2DQ, SA61 2DW, SA61 2EB, SA61 2EE, SA61 2EF, SA61 2EG, SA61 2EP, SA61 2ET, SA61 2EU, SA61 2EW, SA61 2EY, SA61 2EZ, SA61 2HB, SA61 2JG, SA61 2JH, SA61 2JJ, SA61 2JP, SA61 2JX, SA61 2JY, SA61 2JZ, SA61 2LA, SA61 2LB, SA61 2LE, SA61 2LF, SA61 2LJ, SA61 2LP, SA61 2LQ, SA61 2LR, SA61 2LS, SA61 2LU, SA61 2LX, SA61 2NA, SA61 2NB, SA61 2NG, SA61 2PR, SA61 9SA, SA61 9SB",349,305,44
W00003032,SA61,"SA61 1NF, SA61 1NG, SA61 1NH, SA61 1NJ, SA61 1NL, SA61 1NP, SA61 1NQ, SA61 1QF, SA61 1QG, SA61 1QH, SA61 1QQ, SA61 2DD, SA61 2DP, SA61 2DR, SA61 2DS, SA61 2LD",301,261,40
W00003033,SA61,"SA61 1SP, SA61 1SR, SA61 1SS, SA61 1ST, SA61 1SU, SA61 1TG, SA61 1UN, SA61 2DT, SA61 2DU, SA61 2DX, SA61 2DY, SA61 2DZ, SA61 2EA, SA61 2ED, SA61 2JD",267,248,19
W00003034,SA61,"SA61 1NR, SA61 1NS, SA61 1QJ, SA61 1QL, SA61 1QP, SA61 1RA, SA61 1SX, SA61 1SY, SA61 1TA, SA61 1TF, SA61 1TQ",255,220,35
W00003035,SA61,"SA61 2TH, SA61 2TT, SA61 2TU, SA61 2TX, SA61 2TY",223,198,25
W00003037,SA61,"SA61 2GA, SA61 2GB, SA61 2GD, SA61 2GE, SA61 2GF, SA61 2GG, SA61 2GH",252,212,40
W00003101,SA61,"SA61 1BL, SA62 4AZ, SA62 4EA, SA62 4EU, SA62 4EX, SA62 4EY, SA62 4FB, SA62 4HA, SA62 4HB, SA62 4HD, SA62 4HE, SA62 4LD, SA62 4LG, SA62 4NJ, SA62 4NN",279,237,42
W00003210,SA61,"SA61 1BJ, SA73 1EP, SA73 1ER, SA73 1FA, SA73 1HJ, SA73 1HL, SA73 1HN, SA73 1HP, SA73 1HR, SA73 1HS, SA73 1HT, SA73 1HU, SA73 1HX, SA73 1JD, SA73 1JE, SA73 1JF, SA73 1QN, SA73 1QS, SA73 1QT, SA73 1QU, SA73 1QW, SA73 1QZ, SA73 1YH, SA73 1YR, SA73 1YS",317,292,25
W00003036,SA61,"SA61 2TN, SA61 2TP, SA61 2TR, SA61 2TS, SA61 2TW, SA61 2UD, SA61 2UE",353,325,28
W00003316,SA62,"SA62 5UL, SA62 5UN, SA65 9PR, SA65 9PT, SA65 9PU, SA65 9PX, SA65 9PY, SA65 9QA, SA65 9QB, SA65 9QD, SA65 9QE, SA65 9QF, SA65 9RD, SA65 9RE, SA65 9RH, SA65 9RN, SA65 9RP, SA65 9RR, SA65 9RS, SA65 9RT, SA65 9RU, SA65 9RW, SA65 9RY",314,207,107
W00003072,SA62,"SA62 3HA, SA62 3NF, SA62 3PF, SA62 3PG, SA62 3PQ, SA62 3PS, SA62 3PT, SA62 3PU, SA62 3PX, SA62 3PY, SA62 3QT, SA62 3QW",443,401,42
W00010683,SA62,"SA62 3HG, SA62 3HJ, SA62 4NL, SA73 1JG, SA73 1JH, SA73 1JJ, SA73 1JQ, SA73 1JX, SA73 1JY, SA73 1LT, SA73 1LU",294,271,23
W00002972,SA62,"SA62 3LF, SA62 3LH, SA62 3ND, SA62 3NE, SA62 3NG, SA62 3NH, SA62 3NJ, SA62 3NL, SA62 3NN, SA62 3NP, SA62 3NS, SA62 3NW, SA62 6AE, SA62 6AF, SA62 6AP, SA62 6AR, SA62 6BD, SA62 6BE, SA62 6EQ, SA62 6ET, SA62 6HA, SA62 6HB, SA62 6HF, SA62 6HR",362,307,55
W00002970,SA62,"SA62 6AG, SA62 6AQ, SA62 6BG, SA62 6BQ, SA62 6FA, SA62 6FF, SA62 6FG, SA62 6HD",274,239,35
W00002969,SA62,"SA62 5LW, SA62 5PN, SA62 5YH, SA62 5YJ, SA62 6DQ, SA62 6HG, SA62 6HH, SA62 6HQ, SA62 6JA, SA62 6JD, SA62 6JF, SA62 6JG, SA62 6JL, SA62 6JN, SA62 6JP, SA62 6JQ, SA62 6JR, SA62 6JS, SA62 6JW, SA62 6LF",423,347,76
W00002968,SA62,"SA62 5YQ, SA62 6ED, SA62 6FE, SA62 6HJ, SA62 6HN, SA62 6HT, SA62 6HU, SA62 6HW, SA62 6HX, SA62 6HY, SA62 6HZ, SA62 6JB, SA62 6JE, SA62 6JH, SA62 6JJ",246,215,31
W00010689,SA62,"SA62 3LN, SA62 3LP, SA62 6AA, SA62 6AB, SA62 6BJ, SA62 6DZ, SA62 6EA, SA62 6EB, SA62 6EH, SA62 6EJ, SA62 6EZ, SA62 6HP",326,284,42
W00002967,SA62,"SA62 6DY, SA62 6EF, SA62 6EG, SA62 6EN, SA62 6EP, SA62 6ER, SA62 6ES, SA62 6EU, SA62 6EX, SA62 6EY",316,268,48
W00002963,SA62,"SA62 4JQ, SA62 4JR, SA62 4JT, SA73 1LR, SA73 1LW, SA73 1NF, SA73 1NJ, SA73 1NL, SA73 1NS, SA73 1NT, SA73 1NU, SA73 1NZ, SA73 1PD, SA73 1PE, SA73 1PG",343,310,33
W00002962,SA62,"SA62 4JS, SA62 4NP, SA62 4NR, SA62 4NS, SA62 4NT, SA62 4NU, SA62 4NW, SA62 4NX, SA73 1LD, SA73 1LE, SA73 1LX, SA73 1LY, SA73 1LZ, SA73 1NG",258,234,24
W00002960,SA62,"SA62 4NQ, SA73 1NA, SA73 1NB, SA73 1ND, SA73 1NE, SA73 1NH, SA73 1NN, SA73 1NP, SA73 1NQ, SA73 1NR, SA73 1NW, SA73 1PQ",420,369,51
W00003130,SA62,"SA62 4QD, SA62 4YB, SA62 4YD, SA62 4YE, SA66 7HR, SA67 8AQ, SA67 8BT, SA67 8DF, SA67 8DL, SA67 8DN, SA67 8DT, SA67 8DU, SA67 8DX, SA67 8EB, SA67 8ED, SA67 8EL, SA67 8EN, SA67 8EP, SA67 8ER, SA67 8ES, SA67 8ET, SA67 8HN, SA67 8HR, SA67 8HS",292,231,61
W00003285,SA62,"SA62 6NJ, SA62 6NR, SA62 6NT, SA62 6NX, SA62 6NY, SA62 6NZ, SA62 6SF, SA62 6SN, SA62 6SS, SA62 6ST, SA62 6SW, SA62 6SY",310,235,75
W00003133,SA62,"SA62 4AN, SA62 4AP, SA62 4AR, SA62 4AS, SA62 4AT, SA62 4AU, SA62 4AX, SA62 4AY, SA62 4BA, SA62 4BD, SA62 4PD, SA62 4PE",136,112,24
W00003073,SA62,"SA62 3NU, SA62 3PJ, SA62 3PP, SA62 3PR, SA62 3QE, SA62 3QG, SA62 3QH, SA62 3QJ, SA62 3QQ",451,396,55
W00003343,SA62,"SA62 3GA, SA62 3HP, SA62 3HR, SA62 3HT, SA62 3HU, SA62 3HW, SA62 3JG, SA62 3JH, SA62 3JJ, SA62 3JQ, SA62 3JS, SA62 3JT, SA62 3JU, SA62 3JX, SA62 3JY, SA62 3LU, SA62 3TU, SA62 3TY",259,236,23
W00003345,SA62,"SA62 3AG, SA62 3SH, SA62 3SJ, SA62 3SL, SA62 3SN, SA62 3UA, SA62 3UB, SA62 3UD, SA62 3UE, SA62 3UF, SA62 3UG, SA62 3UH, SA62 3UJ, SA62 3UL, SA62 3UN, SA62 3UP, SA62 3UQ, SA62 3UR, SA62 3US, SA62 3UT, SA62 3UU, SA62 3UX, SA62 3UY, SA62 3XA, SA62 3XB, SA62 3XD, SA62 3XE",228,192,36
W00003071,SA62,"SA62 3AQ, SA62 3EX, SA62 3EY, SA62 3HB, SA62 3HD, SA62 3HE, SA62 3HF, SA62 3HH, SA62 3HL, SA62 3HQ, SA62 3LJ",438,404,34
W00003283,SA62,"SA62 6BP, SA62 6BS, SA62 6NQ, SA62 6NS, SA62 6NU, SA62 6PD, SA62 6PE, SA62 6PY, SA62 6QA, SA62 6QB, SA62 6QD, SA62 6RD, SA62 6RF, SA62 6RH, SA62 6RN, SA62 6RP, SA62 6RR, SA62 6RS, SA62 6RW, SA62 6SE, SA62 6SJ, SA62 6SL, SA62 6SP, SA62 6SU",284,215,69
W00003280,SA62,"SA62 4BJ, SA62 4BN, SA62 4BR, SA62 4BS, SA62 4BT, SA62 4DH, SA62 4DJ, SA62 4DN, SA62 4DQ, SA62 4EF, SA62 4EP, SA62 4EQ, SA62 4ER, SA62 4EW, SA62 4EZ, SA62 4FD, SA62 4FE, SA62 5QJ",448,380,68
W00003111,SA62,"SA62 5AN, SA62 5DW, SA62 5EJ, SA62 5ER, SA62 5ES, SA62 5EW, SA62 5HE, SA62 5HG, SA62 5HH, SA62 5HJ, SA62 5HL, SA62 5HN, SA62 5JB, SA62 5JD, SA62 5JE, SA62 5JG, SA62 5JH, SA62 5JJ, SA62 5JQ",230,154,76
W00003279,SA62,"SA62 4DD, SA62 4DL, SA62 4DP, SA62 4DR, SA62 4DS, SA62 4DW, SA62 4DZ, SA62 4EN",265,222,43
W00003277,SA62,"SA62 4BX, SA62 4DA, SA62 4DB, SA62 4DE, SA62 4DT, SA62 4DU, SA62 4DX, SA62 4DY, SA62 4EB, SA62 4ED, SA62 4EE, SA62 4EG, SA62 4EH, SA62 5LN, SA62 5PE, SA62 5PG",183,156,27
W00003001,SA62,"SA62 5DJ, SA62 5DN, SA62 5DP, SA62 5RP, SA62 5RR, SA62 5RS, SA62 5RT, SA62 5RU, SA62 5TE, SA62 5TG, SA62 5TS, SA63 4TJ, SA63 4TP, SA63 4TR, SA63 4TS, SA63 4TT, SA63 4TU, SA63 4TX, SA63 4TY, SA63 4UA, SA63 4UB, SA63 4UD, SA63 4UE, SA65 9TS, SA66 7RA, SA66 7RD, SA66 7RG",276,140,136
W00003000,SA62,"SA62 5DL, SA62 5RH, SA62 5RJ, SA62 5RL, SA62 5RN, SA62 5RW, SA62 5TB, SA62 5TD, SA62 5TH, SA62 5TP, SA62 5TR",260,140,120
W00003112,SA62,"SA62 5EH, SA62 5EL, SA62 5EN, SA62 5EP, SA62 5EQ, SA62 5EX, SA62 5EY, SA62 5EZ, SA62 5FA, SA62 5HA, SA62 5HB, SA62 5HD, SA62 5HF, SA62 5HQ, SA62 5HZ, SA62 5JA, SA62 5LL, SA62 5NP, SA62 5QF",294,192,102
W00003353,SA62,"SA62 4PN, SA62 4PP, SA62 4QA, SA63 4AA, SA63 4UG, SA63 4UH, SA63 4UJ, SA63 4UP, SA63 4UR, SA63 4UT, SA63 4UU, SA63 4UW, SA63 4UX, SA63 4UY, SA63 4WA, SA63 4XB",374,293,81
W00003352,SA62,"SA62 4BE, SA62 4EJ, SA62 4EL, SA62 4PG, SA62 4PH, SA62 4PJ, SA62 4PL, SA62 4PR, SA62 4PS, SA62 4PT, SA62 4PU, SA62 4PW, SA62 4PX, SA62 4PY, SA62 4PZ, SA62 4QB, SA63 4AB, SA63 4QJ, SA63 4QL, SA63 4QN, SA63 4QP, SA63 4QR, SA63 4QS, SA63 4SX, SA63 4UN, SA67 8DY, SA67 8DZ, SA67 8EA",369,301,68
W00003350,SA62,"SA62 5DB, SA62 5QQ, SA62 5QR, SA62 5QS, SA62 5QU, SA62 5RE, SA62 5RF, SA62 5RG",223,196,27
W00003349,SA62,"SA62 5DA, SA62 5QH, SA62 5QL, SA62 5QN, SA62 5QP, SA62 5QT, SA62 5QW, SA62 5RX",242,196,46
W00003348,SA62,"SA62 5DG, SA62 5DH, SA62 5DQ, SA62 5DR, SA62 5DS, SA62 5DU, SA62 5QX, SA62 5QY, SA62 5QZ, SA62 5RA, SA62 5RB, SA62 5RD, SA63 4TB, SA63 4TD, SA63 4TE, SA63 4TG, SA63 4TH, SA63 4TL, SA63 4TN",382,276,106
W00003347,SA62,"SA62 3AE, SA62 3DJ, SA62 3DS, SA62 3DT, SA62 3DU, SA62 3DX, SA62 3DY, SA62 3DZ, SA62 3EA, SA62 3EB, SA62 3ED, SA62 3EE, SA62 3EG, SA62 3QP, SA62 3SA, SA62 3SB, SA62 3SD, SA62 3SE, SA62 3SG, SA62 3TT, SA62 3TX, SA62 3YF, SA62 3YG, SA62 3YL, SA73 3FB, SA73 3TH, SA73 3TJ, SA73 3TL, SA73 3TN, SA73 3TQ, SA73 3TW",316,283,33
W00003346,SA62,"SA62 3HX, SA62 3HZ, SA62 3JB, SA62 3JF, SA62 3JL, SA62 3LB, SA62 3LW",322,281,41
W00003297,SA62,"SA62 3BL, SA62 3QX, SA62 3QY, SA62 3QZ, SA62 3RA, SA62 3RB, SA62 3RD, SA62 3RE, SA62 3RF, SA62 3RG, SA62 3RH, SA62 3RJ, SA62 3RL, SA62 3RN, SA62 3RP, SA62 3RQ, SA62 3RR, SA62 3RS, SA62 3RT",179,161,18
W00003299,SA62,"SA62 3AF, SA62 3AH, SA62 3AJ, SA62 3AL, SA62 3AN, SA62 3AP, SA62 3AS, SA62 3AT, SA62 3AU, SA62 3AW, SA62 3AX, SA62 3AY, SA62 3AZ, SA62 3BA, SA62 3BB, SA62 3BD, SA62 3BE, SA62 3BG, SA62 3BH, SA62 3BJ, SA62 3BN, SA62 3BQ, SA62 3DF, SA62 3QR, SA62 3QU, SA62 3SP",317,268,49
W00003284,SA62,"SA62 6BW, SA62 6FH, SA62 6NW, SA62 6PA, SA62 6QE, SA62 6QF, SA62 6QG, SA62 6QH, SA62 6QJ, SA62 6QQ, SA62 6QT, SA62 6QU, SA62 6QW, SA62 6QZ, SA62 6RY",284,212,72
W00003300,SA62,"SA62 3SU, SA62 3SY, SA62 3TA, SA62 3TB, SA62 3TD, SA62 3TG, SA62 3TH, SA62 3TJ, SA62 3TP, SA62 3TR",231,205,26
W00003097,SA62,"SA62 5PZ, SA62 5SE, SA62 5SF, SA62 5SJ, SA62 5SL, SA62 5SN, SA62 5SQ, SA62 5SR, SA62 5SS, SA62 5SZ, SA62 5TF, SA62 5UA, SA62 5UB",398,267,131
W00003095,SA62,"SA62 5AA, SA62 5AQ, SA62 5HR, SA62 5HS, SA62 5HT, SA62 5HU, SA62 5HX, SA62 5HY, SA62 5NR, SA62 5NS, SA62 5NT, SA62 5NU, SA62 5NX, SA62 5NY, SA62 5PP, SA62 5PR, SA62 5PS, SA62 5PT, SA62 5PU, SA62 5PW, SA62 5PY, SA62 5QA, SA62 5QB, SA62 5QD, SA62 5QE, SA62 5QG, SA62 6HE",446,311,135
W00003286,SA62,"SA62 6FJ, SA62 6PB, SA62 6QX, SA62 6QY, SA62 6RA, SA62 6RZ, SA62 6SA, SA62 6SB, SA62 6SD, SA62 6SR",210,168,42
W00003287,SA62,"SA62 6BR, SA62 6BT, SA62 6BU, SA62 6BX, SA62 6BY, SA62 6BZ, SA62 6DA, SA62 6DB, SA62 6DD, SA62 6DE, SA62 6DG, SA62 6DH, SA62 6DJ, SA62 6DL, SA62 6DN, SA62 6DX, SA62 6PG, SA62 6PH, SA62 6PJ, SA62 6PL, SA62 6PN, SA62 6PP, SA62 6PQ, SA62 6PR, SA62 6PS, SA62 6PT, SA62 6PU, SA62 6PW, SA62 6PX, SA62 6QL, SA62 6QN, SA62 6QP, SA62 6QR, SA62 6QS, SA62 6UG, SA62 6UH, SA62 6XE, SA62 6XG, SA62 6XS, SA62 6XT, SA62 6XU, SA62 6XX",400,297,103
W00003288,SA62,"SA62 6BN, SA62 6DF, SA62 6RB, SA62 6RE, SA62 6RG, SA62 6RJ, SA62 6RL, SA62 6RQ, SA62 6RT, SA62 6SG, SA62 6SH, SA62 6SQ",242,181,61
W00003314,SA62,"SA62 5ET, SA62 5EU, SA62 5UP, SA62 5UR, SA62 5UT, SA62 5UU, SA62 5UX, SA62 5UY, SA62 5XA, SA64 0HR, SA64 0HU, SA64 0HX, SA64 0HY, SA64 0JA, SA64 0JB, SA64 0JD, SA64 0JE, SA64 0JG, SA64 0JH, SA64 0JJ, SA64 0JL, SA64 0JN, SA64 0JQ, SA64 0JY, SA64 0LA, SA64 0LB, SA64 0LD, SA64 0LE, SA64 0LF, SA64 0LG, SA64 0LH, SA64 0LJ, SA64 0LL, SA64 0LN, SA64 0LP, SA64 0LR, SA64 0LS, SA64 0LT, SA64 0LU, SA64 0LW, SA64 0LX",409,274,135
W00003323,SA62,"SA62 6RU, SA62 6TL, SA62 6TN, SA62 6TQ, SA62 6TR, SA62 6TS, SA62 6TT, SA62 6UA, SA62 6UF, SA62 6UN, SA62 6UP, SA62 6UU, SA62 6XA",191,157,34
W00003322,SA62,"SA62 6LP, SA62 6LR, SA62 6UB, SA62 6UD, SA62 6UE, SA62 6US, SA62 6UT, SA62 6UX, SA62 6UY, SA62 6XB, SA62 6XD, SA62 6XH, SA62 6XJ, SA62 6XL, SA62 6XN, SA62 6XP, SA62 6XR, SA62 6YL",150,127,23
W00003098,SA62,"SA62 5AW, SA62 5EE, SA62 5EG, SA62 5RQ, SA62 5RY, SA62 5RZ, SA62 5SA, SA62 5SB, SA62 5SD, SA62 5SG, SA62 5SW, SA62 5SY, SA62 5TA, SA62 5TT, SA62 5UG, SA62 5UH, SA62 5UJ, SA62 5XJ",422,281,141
W00010654,SA62,"SA62 6AH, SA62 6AJ, SA62 6AL, SA62 6AN, SA62 6AW, SA62 6AZ, SA62 6JU",201,179,22
W00003320,SA62,"SA62 6TE, SA62 6TF, SA62 6TJ, SA62 6TP, SA62 6TU, SA62 6TW, SA62 6TX, SA62 6UL, SA62 6XW",219,162,57
W00003319,SA62,"SA62 5LA, SA62 5LB, SA62 5LD, SA62 6AU, SA62 6BB, SA62 6BH, SA62 6BL, SA62 6LA, SA62 6LJ, SA62 6LS, SA62 6LT, SA62 6LU, SA62 6LW, SA62 6LX, SA62 6LY, SA62 6NA, SA62 6NB, SA62 6NN",510,423,87
W00003318,SA62,"SA62 5AB, SA62 5LE, SA62 5LG, SA62 5LH, SA62 5LQ, SA62 5PX, SA62 6AS, SA62 6AT, SA62 6AX, SA62 6AY, SA62 6BA, SA62 6HS, SA62 6JX, SA62 6JY, SA62 6JZ, SA62 6LB, SA62 6LD, SA62 6LE, SA62 6LG, SA62 6LH, SA62 6LL, SA62 6LN, SA62 6NE, SA62 6NF, SA62 6NG, SA62 6NH, SA62 6NL, SA62 6NP",380,279,101
W00003078,SA62,"SA62 3AA, SA62 3AB, SA62 3AD, SA62 3BW, SA62 3BX, SA62 3BY, SA62 3BZ, SA62 3DA, SA62 3DB, SA62 3DD, SA62 3DE, SA62 3DG, SA62 3DH, SA62 3DP, SA62 3DW, SA62 3EN, SA62 3EP, SA62 3ER, SA62 3ES, SA62 3ET, SA62 3EW, SA62 3HN, SA62 3LT, SA62 3NQ, SA62 3PD, SA62 3TS, SA62 3XG, SA62 3XH, SA73 3UH, SA73 3UJ, SA73 3UL, SA73 3UN, SA73 3UQ, SA73 3UW, SA73 3WA, SA73 3WB, SA73 3WD, SA73 3WE",434,361,73
W00003076,SA62,"SA62 3QA, SA62 3QB, SA62 3QD",242,218,24
W00003317,SA62,"SA62 5TJ, SA62 5TL, SA62 5TN, SA62 5XB, SA62 5XD, SA62 5XE, SA62 5XG, SA62 5XH, SA62 5XP, SA62 5XR, SA62 5XT, SA62 5XU, SA62 5XX, SA62 5XY, SA62 5YA, SA62 5YB, SA62 5YD, SA65 9RJ, SA65 9RL",382,269,113
W00003075,SA62,"SA62 3BP, SA62 3BU, SA62 3EJ, SA62 3EL, SA62 3NX, SA62 3NY, SA62 3NZ, SA62 3PA, SA62 3PB, SA62 3PE, SA62 3PH, SA62 3QF, SA62 3QL, SA62 3QN",341,306,35
W00003074,SA62,"SA62 3EU, SA62 3PL, SA62 3PN, SA62 3PW, SA62 3PZ",246,222,24
W00003321,SA62,"SA62 6FD, SA62 6TA, SA62 6TB, SA62 6TD, SA62 6TG, SA62 6TH, SA62 6TY, SA62 6TZ, SA62 6UJ, SA62 6UQ, SA62 6UR",231,183,48
W00003099,SA62,"SA62 5DD, SA62 5DE, SA62 5DX, SA62 5DZ, SA62 5LP, SA62 5LR, SA62 5LS, SA62 5LT, SA62 5LU, SA62 5LX, SA62 5PH, SA62 5PJ, SA62 5PL, SA62 5PQ, SA62 5YL, SA62 5YR",316,240,76
W00003096,SA62,"SA62 5SH, SA62 5SP, SA62 5ST, SA62 5SU, SA62 5SX",410,267,143
W00010672,SA62,"SA62 6AD, SA62 6EE, SA62 6EL, SA62 6EW, SA62 6FB, SA62 6HL",281,243,38
W00003301,SA62,"SA62 3AR, SA62 3DL, SA62 3DN, SA62 3DQ, SA62 3DR, SA62 3QS, SA62 3SF, SA62 3SR, SA62 3SS, SA62 3ST, SA62 3SW, SA62 3SX, SA62 3SZ, SA62 3TE, SA62 3TL, SA62 3TN",214,197,17
W00003102,SA62,"SA62 4ET, SA62 4LB, SA62 4LE, SA62 4LJ, SA62 4LQ, SA62 4PF",310,275,35
W00003110,SA62,"SA62 5AF, SA62 5AJ, SA62 5AL, SA62 5AP, SA62 5AR, SA62 5AS, SA62 5AU, SA62 5AX, SA62 5AY",212,138,74
W00003103,SA62,"SA62 4HG, SA62 4HL, SA62 4HN, SA62 4HY, SA62 4JD, SA62 4JH, SA62 4JL, SA62 4JN, SA62 4JP, SA62 4JW, SA62 4JX, SA62 4NH",269,248,21
W00003104,SA62,"SA62 4HH, SA62 4HJ, SA62 4HP, SA62 4HR, SA62 4HS, SA62 4HW, SA62 4NG",316,280,36
W00003105,SA62,"SA62 4HT, SA62 4HU, SA62 4HX, SA62 4JA, SA62 4JB, SA62 4JE, SA62 4JF, SA62 4JG, SA62 4JJ",221,199,22
W00003109,SA62,"SA62 5AE, SA62 5AG, SA62 5AH, SA62 5AT, SA62 5AZ, SA62 5BA, SA62 5BB, SA62 5BD, SA62 5BE, SA62 5BG, SA62 5BH, SA62 5BJ, SA62 5BL, SA62 5BN, SA62 5BP, SA62 5BQ, SA62 5BT, SA62 5BW, SA62 5HP, SA62 5JL, SA62 5JY, SA62 6DP, SA62 6DR, SA62 6DS, SA62 6DT, SA62 6DU, SA62 6DW, SA62 6ND, SA62 6XY, SA62 6YA, SA62 6YB, SA62 6YD, SA62 6YE, SA62 6YF, SA62 6YN, SA62 6YP",336,216,120
W00003106,SA62,"SA62 4JU, SA62 4LR, SA62 4LU, SA62 4LW, SA62 4LX, SA62 4LY, SA62 4LZ, SA62 4NA",438,397,41
W00003108,SA62,"SA62 5AD, SA62 5BS, SA62 5BU, SA62 5HW, SA62 5JN, SA62 5JP, SA62 5JR, SA62 5JS, SA62 5JT, SA62 5JU, SA62 5JW, SA62 5JX, SA62 5JZ, SA62 5LF, SA62 6XZ",308,166,142
W00003107,SA62,"SA62 4LF, SA62 4LH, SA62 4LL, SA62 4LN, SA62 4LP, SA62 4LS, SA62 4LT, SA62 4NB, SA62 4ND, SA62 4NE, SA62 4NF, SA62 4NY, SA62 4NZ",428,373,55
W00003100,SA62,"SA62 5DT, SA62 5DY, SA62 5EA, SA62 5LY, SA62 5LZ, SA62 5NA, SA62 5NB, SA62 5ND, SA62 5NE, SA62 5NF, SA62 5NG, SA62 5NH, SA62 5NJ, SA62 5NL, SA62 5NN, SA62 5PA, SA62 5TU, SA62 5UD, SA62 5UE, SA62 5UF",318,211,107
W00003119,SA63,"SA63 4RB, SA63 4RD, SA63 4RE, SA63 4RG, SA63 4RH, SA63 4RJ, SA63 4RL, SA63 4RN, SA63 4RP, SA63 4RQ, SA63 4RR, SA63 4RS, SA63 4RT, SA63 4RU, SA63 4RX, SA63 4RY, SA63 4SA, SA63 4SB, SA63 4SD, SA63 4SE, SA63 4SF, SA63 4SG, SA63 4SR, SA63 4SS, SA66 7HS, SA66 7HT, SA66 7HU, SA66 7HX, SA66 7HY, SA66 7JA, SA66 7JB, SA66 7JG, SA66 7JQ, SA66 7PY, SA66 7RL",411,276,135
W00003351,SA63,"SA63 4QH, SA63 4QT, SA63 4QU, SA63 4QX, SA63 4QY, SA63 4QZ, SA63 4RA, SA63 4SJ, SA63 4SL, SA63 4SN, SA63 4SP, SA63 4ST, SA63 4SU, SA63 4SW, SA63 4SY, SA63 4TA, SA63 4UL, SA63 4UZ, SA63 4XA, SA63 4XD, SA63 4XE, SA63 4XG, SA63 4XH, SA63 4XJ, SA63 4YB",370,277,93
W00003021,SA64,"SA64 0BD, SA64 0BJ, SA64 0BL, SA64 0BN, SA64 0BP, SA64 0BS, SA64 0DG, SA64 0DH, SA64 0DJ, SA64 0DP, SA64 0DR, SA64 0ER, SA64 0ES, SA64 0ET, SA64 0EX, SA64 0HG",291,210,81
W00003023,SA64,"SA64 0AA, SA64 0AB, SA64 0AD, SA64 0AF, SA64 0AG, SA64 0AH, SA64 0AL, SA64 0BA, SA64 0BB, SA64 0BH, SA64 0DE, SA64 0EJ, SA64 0EL",393,259,134
W00003024,SA64,"SA64 0AP, SA64 0AR, SA64 0AS, SA64 0AT, SA64 0AU, SA64 0AX, SA64 0JT, SA64 0JU, SA64 0JZ",313,230,83
W00003022,SA64,"SA64 0AE, SA64 0AJ, SA64 0AN, SA64 0AY, SA64 0AZ, SA64 0BE, SA64 0EH, SA64 0EN, SA64 0EP, SA64 0EU, SA64 0JX, SA64 0LY",326,242,84
W00003025,SA64,"SA64 0AQ, SA64 0BT, SA64 0BU, SA64 0BX, SA64 0BY, SA64 0DS, SA64 0DT, SA64 0DU, SA64 0DX, SA64 0DY, SA64 0DZ, SA64 0EA, SA64 0EB, SA64 0HS, SA64 0HT",251,203,48
W00003026,SA64,"SA64 0DL, SA64 0DN, SA64 0EY, SA64 0EZ, SA64 0HA, SA64 0HB, SA64 0HD, SA64 0HE, SA64 0HF, SA64 0HH, SA64 0HP",395,278,117
W00003018,SA65,"SA65 9BG, SA65 9BH, SA65 9BJ, SA65 9BL, SA65 9BN, SA65 9BP, SA65 9BS, SA65 9BT, SA65 9BW, SA65 9BX, SA65 9BY, SA65 9BZ, SA65 9DZ",242,158,84
W00003016,SA65,"SA65 9HA, SA65 9HD, SA65 9HE, SA65 9HH, SA65 9HN, SA65 9HP, SA65 9HQ, SA65 9HS, SA65 9HY, SA65 9JA, SA65 9JB, SA65 9JU, SA65 9YG",293,191,102
W00003013,SA65,"SA65 9DP, SA65 9DU, SA65 9DX, SA65 9EB, SA65 9ED, SA65 9EE, SA65 9EH, SA65 9EJ, SA65 9EL, SA65 9EN, SA65 9EP, SA65 9EQ, SA65 9NU, SA65 9NX, SA65 9PL, SA65 9PN",279,195,84
W00003012,SA65,"SA65 9DJ, SA65 9DN, SA65 9DY, SA65 9EA, SA65 9EF, SA65 9EG, SA65 9ER, SA65 9NL, SA65 9NP, SA65 9NS, SA65 9NW, SA65 9NZ",319,245,74
W00003011,SA65,"SA65 9AX, SA65 9AY, SA65 9AZ, SA65 9HR, SA65 9HX, SA65 9LP, SA65 9LR, SA65 9LY, SA65 9SS, SA65 9YH",323,230,93
W00003315,SA65,"SA65 9QG, SA65 9QS, SA65 9QT, SA65 9QU, SA65 9QX, SA65 9QY, SA65 9QZ, SA65 9RA, SA65 9RB, SA65 9RF, SA65 9RG, SA65 9RQ",378,289,89
W00003010,SA65,"SA65 9LE, SA65 9LL, SA65 9LN, SA65 9LQ, SA65 9LW, SA65 9LZ",373,258,115
W00003017,SA65,"SA65 9HT, SA65 9HU, SA65 9JD, SA65 9JE, SA65 9JG, SA65 9JH, SA65 9JL, SA65 9JP, SA65 9JR, SA65 9JS, SA65 9JT",384,274,110
W00003015,SA65,"SA65 9HJ, SA65 9HL, SA65 9LA, SA65 9LB, SA65 9LD, SA65 9LF, SA65 9LG, SA65 9LH, SA65 9LJ, SA65 9LS, SA65 9LT, SA65 9LX, SA65 9NA, SA65 9ND",244,178,66
W00003019,SA65,"SA65 9AD, SA65 9DA, SA65 9DB, SA65 9DD, SA65 9DE, SA65 9DF, SA65 9DH, SA65 9DL, SA65 9DR, SA65 9DS, SA65 9DT, SA65 9DW, SA65 9NG, SA65 9NH, SA65 9NJ, SA65 9NN",288,193,95
W00003020,SA65,"SA65 9AE, SA65 9AF, SA65 9AG, SA65 9AH, SA65 9AL, SA65 9AN, SA65 9AP, SA65 9AQ, SA65 9AR, SA65 9AS, SA65 9AT, SA65 9AU, SA65 9AW, SA65 9BA, SA65 9BB, SA65 9BD, SA65 9BE, SA65 9BU, SA65 9JJ, SA65 9JN, SA65 9PS, SA65 9QH, SA65 9QJ, SA65 9QL",343,250,93
W00003116,SA66,"SA66 7JU, SA66 7JX, SA66 7LE, SA66 7LF, SA66 7LG, SA66 7LQ, SA66 7QP, SA66 7QR, SA66 7QS, SA66 7QT, SA66 7QU, SA66 7QX, SA66 7QY, SA66 7RH, SA66 7RJ",346,156,190
W00003189,SA66,"SA66 7WA, SA66 7WW, SA66 7WX, SA66 7WY, SA66 7WZ, SA66 7YA, SA66 7YB, SA66 7YD, SA66 7YE, SA66 7YW, SA66 7ZR, SA67 7AD, SA67 7AG, SA67 7AJ, SA67 7AL, SA67 7AN, SA67 7AP, SA67 7AQ, SA67 7AR, SA67 7AS, SA67 7AU, SA67 7BG, SA67 7BL, SA67 7BN, SA67 7BQ, SA67 7BW, SA67 7DF, SA67 7EN, SA67 7WW, SA67 7WX, SA67 7WY, SA67 7WZ, SA67 7YE, SA67 7YG, SA67 8WW, SA67 8WX, SA67 8WY, SA67 8WZ, SA67 8YA, SA67 8YB, SA67 8YD, SA67 8YF, SA67 8YG, SA67 8YL, SA67 8YN, SA67 8YQ, SA67 8YS, SA67 8ZU, SA67 9AA, SA67 9AF, SA67 9AG, SA67 9AH, SA67 9AJ, SA67 9AL, SA67 9AS, SA68 0WX, SA68 0WY, SA68 0WZ",225,171,54
W00003117,SA66,"SA66 7JR, SA66 7JS, SA66 7QL, SA66 7QW, SA66 7RT, SA66 7SE, SA66 7SF, SA66 7SG, SA66 7SH, SA66 7SJ, SA66 7SL, SA66 7SN, SA66 7XJ, SA66 7XL, SA66 7XN, SA66 7XP",299,194,105
W00003118,SA66,"SA66 7RU, SA66 7RX, SA66 7RY, SA66 7SA, SA66 7SB, SA66 7SD",193,128,65
W00003129,SA66,"SA66 7HD, SA66 7HH, SA67 8DG, SA67 8DH, SA67 8DJ, SA67 8DP, SA67 8DR, SA67 8DS, SA67 8DW, SA67 8EJ, SA67 8EU, SA67 8EX, SA67 8EY, SA67 8HE, SA67 8HF, SA67 8HG, SA67 8HH, SA67 8HJ, SA67 8HL, SA67 8HP, SA67 8HQ, SA67 8HT, SA67 8HU, SA67 8HW",334,263,71
W00003195,SA66,"SA66 7HJ, SA67 7ES, SA67 7ET, SA67 7FE, SA67 8BS, SA67 8BU, SA67 8EH, SA67 8HA, SA67 8RD, SA67 8RE, SA67 8RH, SA67 8RJ, SA67 8TB, SA67 8UB, SA67 8UW",398,325,73
W00003120,SA66,"SA66 7NB, SA66 7NG, SA66 7NN, SA66 7NP, SA66 7NQ, SA66 7NR, SA66 7NW",361,208,153
W00003122,SA66,"SA66 7JP, SA66 7NH, SA66 7NJ, SA66 7NL, SA66 7PN, SA66 7PS, SA66 7PT, SA66 7PU, SA66 7PX, SA66 7QE, SA66 7QG, SA66 7QH, SA66 7SR, SA66 7SS, SA66 7ST, SA66 7TU, SA66 7TX, SA66 7TY, SA66 7UA, SA66 7UB, SA66 7UD, SA66 7UP, SA66 7UR",263,148,115
W00003121,SA66,"SA66 7HE, SA66 7HG, SA66 7HL, SA66 7HN, SA66 7HP, SA66 7HQ, SA66 7HW, SA66 7JH, SA66 7NA, SA66 7ND, SA66 7NE, SA66 7NF, SA66 7NS, SA66 7NY, SA66 7PA, SA66 7PL, SA67 7PJ",304,186,118
W00003115,SA66,"SA66 7JD, SA66 7JE, SA66 7JF, SA66 7JT, SA66 7JY, SA66 7LA, SA66 7LB, SA66 7LD, SA66 7LH, SA66 7LJ, SA66 7LL, SA66 7LN, SA66 7LP, SA66 7QJ, SA66 7QN, SA66 7XR, SA66 7XS, SA66 7XT",387,211,176
W00003114,SA66,"SA66 7JJ, SA66 7LR, SA66 7LS, SA66 7LT, SA66 7QD, SA66 7SZ, SA66 7TA, SA66 7TD, SA66 7TG, SA66 7TH, SA66 7TJ, SA66 7TL, SA66 7TN, SA66 7TP, SA66 7TQ, SA66 7TR, SA66 7TS, SA66 7TT, SA66 7UE",252,116,136
W00003113,SA66,"SA66 7AE, SA66 7PP, SA66 7PR, SA66 7SU, SA66 7SX, SA66 7SY, SA66 7TB, SA66 7TE, SA66 7TF",212,97,115
W00003190,SA67,"SA67 7AA, SA67 7AF, SA67 7AW, SA67 7AZ, SA67 7BP, SA67 7BR, SA67 7BS, SA67 7BT, SA67 7DW, SA67 9AE, SA67 9AN, SA67 9AP, SA67 9AQ, SA67 9AR, SA67 9AT, SA67 9AU, SA67 9AW, SA67 9AX, SA67 9AY, SA67 9AZ, SA67 9BA, SA67 9BB, SA67 9BD, SA67 9BE, SA67 9BF",260,208,52
W00002959,SA67,"SA67 8LP, SA67 8LR, SA67 8LZ, SA67 8NS, SA67 8NT, SA67 8NU, SA67 8NX, SA67 8NY, SA69 9AU",253,221,32
W00002958,SA67,"SA67 8JL, SA67 8JN, SA67 8JP, SA67 8JW, SA67 8JZ, SA67 8LF, SA67 8LH, SA67 8LL, SA67 8LN, SA67 8LQ, SA67 8LS, SA67 8LT, SA67 8NZ, SA67 8PE, SA67 8PG, SA67 8PH, SA67 8PJ, SA67 8PL, SA67 8PN, SA67 8PP, SA67 8PW, SA67 8QJ, SA67 8QL, SA67 8QN",373,339,34
W00003088,SA67,"SA67 8HX, SA67 8HY, SA67 8HZ, SA67 8JA, SA67 8JE, SA67 8JF, SA67 8JG, SA67 8JH, SA67 8JQ, SA67 8LA, SA67 8LB, SA67 8LD, SA67 8LG, SA67 8TD, SA67 8TE, SA67 8TF, SA67 8TW, SA67 8UD, SA67 8UE",446,393,53
W00003192,SA67,"SA67 7AB, SA67 7AE, SA67 7AH, SA67 7DQ, SA67 7EE, SA67 7EF, SA67 7EP, SA67 7EU, SA67 7EW, SA67 7EZ, SA67 7FA, SA67 7FB, SA67 7FF, SA67 7UH, SA67 7UN, SA67 7UP, SA67 7YB, SA67 7YD, SA67 7YH, SA67 7YL, SA67 7YN",482,378,104
W00003132,SA67,"SA67 8AL, SA67 8AN, SA67 8BA, SA67 8BE, SA68 0PL, SA68 0PN, SA68 0PP, SA68 0PR, SA68 0PS, SA68 0PT, SA68 0PU, SA68 0PW, SA68 0PY, SA68 0PZ, SA68 0QA, SA68 0QB",232,205,27
W00003193,SA67,"SA67 7UJ, SA67 7UL, SA67 7UW, SA67 7YA, SA67 7YF",313,265,48
W00003194,SA67,"SA67 7EX, SA67 7EY, SA67 7NX, SA67 8HB, SA67 8HD, SA67 8TA, SA67 8TX, SA67 8TY, SA67 8UA, SA67 8UF",233,180,53
W00003131,SA67,"SA67 8AA, SA67 8AB, SA67 8AD, SA67 8AF, SA67 8AG, SA67 8AH, SA67 8AJ, SA67 8AP, SA67 8AR, SA67 8AS, SA67 8AT, SA67 8AU, SA67 8AW, SA67 8AX, SA67 8AY, SA67 8AZ, SA67 8BB, SA67 8BD, SA67 8BG, SA67 8BH, SA67 8BJ, SA67 8BL, SA67 8DB, SA67 8DD, SA67 8DE, SA68 0PX, SA68 0QD",339,289,50
W00003081,SA67,"SA67 8JJ, SA67 8JR, SA67 8JS, SA67 8JT, SA67 8JU, SA67 8JX, SA67 8SP, SA67 8SS, SA68 0NJ, SA68 0PB, SA68 0PD, SA68 0PE, SA68 0PG, SA68 0PH, SA68 0PJ, SA68 0XL",266,232,34
W00003198,SA67,"SA67 8BN, SA67 8RY, SA67 8RZ, SA67 8SA, SA67 8SD, SA67 8SF, SA67 8SL, SA67 8SR, SA67 8SZ, SA67 8TL, SA67 8TU, SA67 8UX",338,294,44
W00003197,SA67,"SA67 8RS, SA67 8RT, SA67 8RU, SA67 8RX, SA67 8SB, SA67 8SG, SA67 8SH, SA67 8SJ, SA67 8SN, SA67 8ST, SA67 8SU, SA67 8SX, SA67 8SY, SA67 8TT, SA67 8TZ, SA67 8US, SA67 8YH",408,346,62
W00003196,SA67,"SA67 8BX, SA67 8BY, SA67 8BZ, SA67 8DA, SA67 8QQ, SA67 8RF, SA67 8RG, SA67 8RL, SA67 8RN, SA67 8RP, SA67 8RQ, SA67 8RR, SA67 8RW, SA67 8SE, SA67 8SQ",299,245,54
W00003188,SA67,"SA67 7AY, SA67 7BU, SA67 7BX, SA67 7BY, SA67 7BZ, SA67 7DA, SA67 7DB, SA67 7DD, SA67 7DE, SA67 7DG, SA67 7DH, SA67 7DL, SA67 7DR, SA67 7ED",247,188,59
W00003191,SA67,"SA67 7AT, SA67 7AX, SA67 7BA, SA67 7BB, SA67 7BD, SA67 7BE, SA67 7BH, SA67 7BJ, SA67 7DZ, SA67 7ER, SA67 8QR, SA67 8QS, SA67 8QT, SA67 8QU, SA67 8QW, SA67 8QX, SA67 8QY, SA67 8QZ, SA67 8RA, SA67 8RB, SA67 8SW",274,221,53
W00002957,SA67,"SA67 8LU, SA67 8LW, SA67 8LX, SA67 8LY, SA67 8NA, SA67 8NB, SA67 8ND, SA67 8NE, SA67 8NF, SA67 8NG, SA67 8NH, SA67 8NJ, SA67 8NL, SA67 8NN, SA67 8NQ",207,191,16
W00003187,SA67,"SA67 7DJ, SA67 7DN, SA67 7DP, SA67 7DS, SA67 7DT, SA67 7DU, SA67 7DX, SA67 7DY, SA67 7EA, SA67 7EB, SA67 7FD, SA67 7FG, SA67 7FH, SA67 7FJ, SA67 7FL",498,375,123
W00003008,SA67,"SA67 8AE, SA68 0NL, SA68 0NS, SA68 0NT, SA68 0NU, SA68 0NX, SA68 0NY, SA68 0PA, SA68 0SH, SA68 0SL, SA68 0SP, SA68 0SR, SA68 0SS, SA68 0ST, SA68 0SW, SA68 0TE, SA68 0TF, SA68 0TG, SA68 0TH, SA68 0TQ, SA68 0TY",230,201,29
W00002977,SA68,"SA68 0TN, SA68 0TP, SA70 8NX, SA70 8NY, SA70 8PA, SA70 8PB, SA70 8PD, SA70 8PE, SA70 8PG, SA70 8PH, SA70 8PJ, SA70 8PL, SA70 8PN, SA70 8PP, SA70 8PR, SA70 8PS, SA70 8PT, SA70 8SL, SA70 8SN, SA70 8SP, SA70 8SR, SA70 8ST, SA70 8SU, SA72 4SG, SA72 4SJ",338,311,27
W00003006,SA68,"SA68 0QY, SA69 9BH, SA69 9BN, SA69 9BP, SA69 9BQ, SA69 9BR, SA69 9BT, SA69 9BU, SA69 9BZ, SA69 9DB",368,327,41
W00003005,SA68,"SA68 0QP, SA68 0QR, SA68 0QS, SA68 0QT, SA68 0QU, SA68 0QW, SA68 0QX, SA69 9BW, SA69 9BY",248,222,26
W00003004,SA68,"SA68 0RH, SA68 0RJ, SA68 0RL, SA68 0RN, SA68 0RS, SA68 0RY, SA68 0RZ",253,215,38
W00003003,SA68,"SA68 0RP, SA68 0RR, SA68 0RW, SA69 9DU, SA69 9DX, SA69 9DZ, SA70 8GR, SA70 8PW, SA70 8RR, SA70 8RS, SA70 8RT, SA70 8RU, SA70 8RZ",296,264,32
W00003002,SA68,"SA68 0RA, SA68 0RB, SA68 0RD, SA68 0SA, SA68 0SB, SA69 9BJ, SA69 9BL",282,255,27
W00003085,SA68,"SA68 0AD, SA68 0QZ, SA68 0UE, SA68 0UF, SA68 0UG, SA68 0UH, SA68 0XR, SA68 0XS, SA68 0XT, SA68 0XU, SA68 0XX, SA68 0XY, SA68 0YA, SA68 0YD, SA68 0YU, SA68 0ZA, SA68 0ZB",439,395,44
W00003083,SA68,"SA68 0TW, SA68 0UD, SA68 0UP, SA68 0UR, SA68 0UT, SA68 0YB",202,190,12
W00003084,SA68,"SA68 0AA, SA68 0PF, SA68 0XA, SA68 0XB, SA68 0XD, SA68 0XE, SA68 0XF, SA68 0XG, SA68 0XH, SA68 0XJ, SA68 0XN, SA68 0YL, SA68 0YN",420,372,48
W00003080,SA68,"SA68 0NH, SA68 0SE, SA68 0YE, SA68 0YF, SA68 0YG, SA68 0YH, SA68 0YJ, SA68 0YP, SA68 0YR, SA68 0YS, SA68 0YT, SA68 0YW, SA68 0YX",333,279,54
W00003079,SA68,"SA68 0AB, SA68 0TZ, SA68 0UA, SA68 0UJ, SA68 0UL, SA68 0UN, SA68 0US, SA68 0UU, SA68 0UX, SA68 0UY, SA68 0YQ",341,320,21
W00003009,SA68,"SA68 0NN, SA68 0NP, SA68 0NR, SA68 0NZ, SA68 0RE, SA68 0RF, SA68 0RG, SA68 0RQ, SA68 0RT, SA68 0RU, SA68 0RX, SA68 0SD, SA68 0SG, SA68 0SJ, SA68 0SN, SA70 8RX",323,276,47
W00002974,SA68,"SA68 0SU, SA68 0SX, SA68 0SY, SA68 0TA, SA68 0TB, SA68 0TD, SA68 0TJ, SA68 0TL, SA68 0TR, SA68 0TT, SA68 0TU, SA68 0TX",295,266,29
W00002975,SA68,"SA68 0TS, SA70 8AY, SA70 8DS, SA70 8RP, SA70 8RQ, SA70 8RW, SA70 8RY, SA70 8SA, SA70 8SB, SA70 8SD, SA70 8SG, SA70 8SH, SA70 8SQ, SA70 8SS, SA70 8SX, SA70 8SY, SA70 8TA, SA70 8TB, SA70 8TD, SA70 8TE, SA70 8TQ",492,424,68
W00003082,SA68,"SA68 0UB, SA68 0UQ, SA68 0UW, SA68 0UZ, SA68 0WA, SA68 0XZ",241,218,23
W00003308,SA69,"SA69 9HH, SA69 9HJ, SA69 9HL, SA69 9HN, SA69 9HS, SA69 9HT, SA69 9HZ, SA69 9NE, SA69 9NG, SA69 9NN",171,158,13
W00003306,SA69,"SA69 9DR, SA69 9HP, SA69 9HR, SA69 9HW, SA69 9HX, SA69 9HY, SA69 9PG, SA69 9PL, SA69 9PQ",212,188,24
W00003007,SA69,"SA69 9BS, SA69 9DA, SA69 9DY",367,316,51
W00003307,SA69,"SA69 9NH, SA69 9NJ, SA69 9NL, SA69 9NP, SA69 9NR, SA69 9NS, SA69 9NT, SA69 9NU",107,95,12
W00003309,SA69,"SA69 9PH, SA69 9PJ, SA69 9PR, SA69 9PS, SA69 9PT, SA69 9PU, SA7 4TH",176,155,21
W00003313,SA69,"SA69 9JP, SA69 9JR, SA69 9LL, SA69 9LN, SA69 9LR, SA69 9LW",191,171,20
W00003312,SA69,"SA69 9AB, SA69 9LD, SA69 9LP, SA69 9LQ, SA69 9LS, SA69 9LT",261,228,33
W00003305,SA69,"SA69 9AF, SA69 9EJ, SA69 9EL, SA69 9EN, SA69 9EP, SA69 9ER, SA69 9ES, SA69 9ET, SA69 9EW, SA69 9HA, SA69 9HE, SA69 9HG, SA69 9JG",174,153,21
W00003302,SA69,"SA69 9BG, SA69 9BX, SA69 9DS, SA69 9DT, SA69 9EA, SA69 9EB, SA69 9ED, SA69 9LA, SA69 9LB, SA69 9LU, SA69 9LX, SA69 9LY, SA69 9LZ, SA69 9NA, SA69 9NQ",327,299,28
W00003303,SA69,"SA69 9AD, SA69 9AQ, SA69 9HF, SA69 9JH, SA69 9JJ, SA69 9JL, SA69 9JN, SA69 9JQ, SA69 9JU, SA69 9JW, SA69 9JX, SA69 9JY, SA69 9JZ, SA69 9LE, SA69 9LF, SA69 9LG, SA69 9LH, SA69 9LJ, SA69 9NB, SA69 9ND, SA69 9ZD",217,206,11
W00003275,SA69,"SA69 9DH, SA69 9DP, SA69 9DQ, SA69 9DW, SA69 9EE, SA69 9EF, SA70 8BD, SA70 8BE, SA70 8BR, SA70 8RA, SA70 8RB, SA70 8RE, SA70 8RG, SA70 8TG, SA70 8TJ, SA70 8TL, SA70 8TN, SA70 8TR, SA70 8TS, SA70 8YA, SA70 8YB, SA70 8YD, SA70 8YE, SA70 8YF, SA70 8YG, SA70 8YJ, SA70 8YN",589,520,69
W00003276,SA69,"SA69 9DD, SA69 9DE, SA69 9DF, SA69 9DG, SA69 9DJ, SA69 9DL, SA69 9DN, SA69 9NY, SA69 9PA, SA69 9PN, SA69 9PW, SA69 9YR, SA70 8TP",282,239,43
W00003304,SA69,"SA69 9AA, SA69 9AE, SA69 9AG, SA69 9AH, SA69 9AJ, SA69 9AX, SA69 9EU, SA69 9EX, SA69 9EY, SA69 9HB, SA69 9HD, SA69 9JE",173,153,20
W00003311,SA69,"SA69 9AL, SA69 9AN, SA69 9AP, SA69 9AR, SA69 9AS, SA69 9AT, SA69 9AW, SA69 9AY, SA69 9BA, SA69 9BB, SA69 9BD, SA69 9BE",125,107,18
W00003338,SA69,"SA69 9WY, SA69 9WZ, SA69 9YA, SA69 9ZA, SA69 9ZB, SA69 9ZE, SA69 9ZL, SA69 9ZX, SA70 7AL, SA70 7AU, SA70 7JP, SA70 7JR, SA70 7JY, SA70 7LA, SA70 7LB, SA70 7LD, SA70 7LE, SA70 7LF, SA70 7LL, SA70 7LN, SA70 7LW, SA70 7LZ, SA70 7NG, SA70 7NH, SA70 7NJ, SA70 7NW, SA70 7WD, SA70 7WE, SA70 7WF, SA70 7WH, SA70 7WJ, SA70 7WN, SA70 7WP, SA70 7WQ, SA70 7WR, SA70 7WS, SA70 7WT, SA70 7WU, SA70 7WW, SA70 7WX, SA70 7WY, SA70 7XA, SA70 7YA, SA70 7YD, SA70 7YG, SA70 7YN, SA70 7YP, SA70 7YT, SA70 7YU, SA70 7ZW, SA70 8EQ, SA70 8ES, SA70 8ET, SA70 8WA, SA70 8WY, SA70 8WZ, SA70 8YH, SA70 8YL, SA70 8YP, SA70 8YR, SA70 8ZT, SA70 9AA, SA70 9AE, SA70 9AF, SA70 9AG, SA70 9AH, SA70 9AJ, SA70 9AL, SA70 9AN, SA70 9AP, SA70 9AQ, SA70 9AR, SA70 9AS, SA70 9AT, SA70 9AU, SA70 9AW, SA70 9AY, SA70 9AZ",205,172,33
W00003310,SA69,"SA69 9NX, SA69 9PB, SA69 9PD, SA69 9PE, SA69 9PF, SA69 9PP",190,171,19
W00004272,SA7,"SA7 9ET, SA7 9EU, SA7 9EW, SA7 9EX, SA7 9EY, SA7 9FA, SA7 9HA, SA7 9HB, SA7 9HD",285,239,46
W00004279,SA7,"SA7 9ST, SA7 9SU, SA7 9UU, SA7 9UX, SA7 9XB",253,226,27
W00004280,SA7,"SA7 9SG, SA7 9SH, SA7 9SZ, SA7 9TB, SA7 9TD, SA7 9TE, SA7 9TG, SA7 9TP",262,234,28
W00004263,SA7,"SA7 9DY, SA7 9EB, SA7 9ED, SA7 9JY, SA7 9LS",292,262,30
W00004278,SA7,"SA7 9SA, SA7 9SB, SA7 9SP, SA7 9SR, SA7 9SS, SA7 9UQ, SA7 9WJ",250,228,22
W00004281,SA7,"SA7 9UJ, SA7 9UN, SA7 9UP, SA7 9UW, SA7 9WR",322,302,20
W00004274,SA7,"SA7 9BA, SA7 9BD, SA7 9BG, SA7 9BH, SA7 9BJ, SA7 9BL, SA7 9BN, SA7 9BP, SA7 9BQ, SA7 9BR, SA7 9BS, SA7 9BW, SA7 9DT, SA7 9ZB, SA7 9ZH, SA7 9ZN, SA7 9ZT",325,275,50
W00004277,SA7,"SA7 9TN, SA7 9WA, SA7 9WB, SA7 9WD, SA7 9WE, SA7 9WF, SA7 9WP, SA7 9WS, SA7 9XF, SA7 9XZ",447,392,55
W00004276,SA7,"SA7 9SD, SA7 9SE, SA7 9SJ, SA7 9SY",365,327,38
W00004275,SA7,"SA7 9RZ, SA7 9SF, SA7 9SL, SA7 9SN",324,292,32
W00004282,SA7,"SA7 9UF, SA7 9UH, SA7 9UR, SA7 9UT",203,183,20
W00004271,SA7,"SA7 9EP, SA7 9EZ, SA7 9HE, SA7 9HF, SA7 9HQ",276,232,44
W00004284,SA7,"SA7 9TL, SA7 9US, SA7 9XQ, SA7 9XX",362,327,35
W00004262,SA7,"SA7 9JZ, SA7 9LP, SA7 9LQ, SA7 9LR, SA7 9LT, SA7 9LU, SA7 9LY",304,272,32
W00010264,SA7,"SA7 0NA, SA7 0NB, SA7 0ND, SA7 0NU, SA7 0NX, SA7 9NU, SA7 9NX",274,223,51
W00004046,SA7,"SA7 9HP, SA7 9HS, SA7 9HT, SA7 9HU, SA7 9HX, SA7 9HY, SA7 9JB, SA7 9JF, SA7 9JH, SA7 9JQ",253,213,40
W00004256,SA7,"SA7 0HD, SA7 9EE, SA7 9EJ, SA7 9EN, SA7 9ER, SA7 9ES, SA7 9HH, SA7 9HJ, SA7 9HL, SA7 9HN, SA7 9NN, SA7 9NP, SA7 9NR, SA7 9TH",570,453,117
W00004283,SA7,"SA7 9SQ, SA7 9UY, SA7 9UZ, SA7 9XD, SA7 9XE, SA7 9XG",218,197,21
W00004257,SA7,"SA7 9EA, SA7 9NA, SA7 9NB, SA7 9NG, SA7 9QA, SA7 9QD, SA7 9QJ",344,282,62
W00004258,SA7,"SA7 9GE, SA7 9LF, SA7 9LG, SA7 9LJ, SA7 9LL, SA7 9LN",378,341,37
W00004259,SA7,"SA7 9NF, SA7 9QG, SA7 9QH, SA7 9TF",353,322,31
W00004286,SA7,"SA7 9WL, SA7 9WN, SA7 9XA, SA7 9XH, SA7 9XJ, SA7 9XL, SA7 9XN, SA7 9XU",450,414,36
W00004288,SA7,"SA7 9RB, SA7 9SX, SA7 9TA, SA7 9TR",280,238,42
W00004260,SA7,"SA7 9ND, SA7 9NE, SA7 9NH, SA7 9NL, SA7 9NQ",303,254,49
W00004261,SA7,"SA7 9JX, SA7 9NW, SA7 9NY, SA7 9NZ, SA7 9PG, SA7 9PQ, SA7 9PY, SA7 9PZ",269,233,36
W00004289,SA7,"SA7 9QL, SA7 9RY, SA7 9SW, SA7 9UG",337,283,54
W00004290,SA7,"SA7 9AU, SA7 9AX, SA7 9AY, SA7 9AZ, SA7 9BE, SA7 9DA, SA7 9QN, SA7 9QP, SA7 9QR, SA7 9QS, SA7 9QT, SA7 9QZ",333,291,42
W00004292,SA7,"SA7 9AL, SA7 9BZ, SA7 9QF, SA7 9QQ, SA7 9QU, SA7 9QX, SA7 9QY, SA7 9RA, SA7 9RF",251,213,38
W00004264,SA7,"SA7 9GJ, SA7 9GL, SA7 9GN, SA7 9GP, SA7 9GQ, SA7 9JU, SA7 9LD, SA7 9LH, SA7 9LX, SA7 9NJ",356,325,31
W00004293,SA7,"SA7 9TS, SA7 9TT, SA7 9TU, SA7 9TW, SA7 9TX",242,205,37
W00004269,SA7,"SA7 9JS, SA7 9PA, SA7 9PD, SA7 9PH, SA7 9RP",296,277,19
W00010248,SA7,"SA7 0HA, SA7 0HE, SA7 0HG, SA7 0HN",443,369,74
W00010247,SA7,"SA7 0HB, SA7 0HF, SA7 0HJ",387,331,56
W00010243,SA7,"SA7 9DP, SA7 9DR, SA7 9DS, SA7 9DU, SA7 9DX",262,221,41
W00004732,SA7,"SA7 9JE, SA8 3AU, SA8 3BA, SA8 3ET, SA8 3EU, SA8 3HY, SA8 3JA, SA8 3JG",365,255,110
W00004265,SA7,"SA7 9GR, SA7 9PP, SA7 9PR, SA7 9PS, SA7 9PT, SA7 9QB, SA7 9QE, SA7 9RE",364,344,20
W00004266,SA7,"SA7 9GA, SA7 9GB, SA7 9GD, SA7 9LW, SA7 9NT",482,421,61
W00004267,SA7,"SA7 9JT, SA7 9LE, SA7 9PJ, SA7 9PL",375,353,22
W00004268,SA7,"SA7 9PN, SA7 9PU, SA7 9PW, SA7 9PX",273,248,25
W00004270,SA7,"SA7 9BT, SA7 9BU, SA7 9BX, SA7 9JJ, SA7 9JR, SA7 9NS, SA7 9PB, SA7 9PE, SA7 9PF",254,214,40
W00003124,SA70,"SA70 7SB, SA70 7SD, SA70 7SE, SA70 7SF, SA70 7SG, SA70 7TE, SA70 7TG, SA70 7TH, SA70 7TJ, SA70 7TL, SA70 7TN, SA70 7TW, SA70 7TY",282,249,33
W00003094,SA70,"SA70 8PQ, SA70 8PU, SA71 5JR, SA71 5JU, SA71 5NS, SA71 5NT, SA71 5NU, SA71 5NX, SA71 5NY, SA71 5PA, SA71 5PB, SA71 5PD, SA71 5PE, SA71 5PL",295,261,34
W00003123,SA70,"SA70 7SZ, SA70 7TA, SA70 7TB, SA70 8AX, SA70 8LQ, SA70 8PX, SA70 8PY, SA70 8QD, SA70 8QE, SA70 8QG, SA70 8QH, SA70 8QJ, SA70 8QL, SA70 8QN, SA70 8QP, SA70 8QR, SA70 8QS, SA70 8QU, SA70 8QW, SA70 8RF",325,294,31
W00002976,SA70,"SA70 8SE, SA70 8SF, SA70 8SJ, SA70 8SW, SA70 8SZ, SA70 8TF",363,324,39
W00003272,SA70,"SA70 7NQ, SA70 7NR, SA70 7NS, SA70 7NT, SA70 7NU, SA70 7NX, SA70 7NY, SA70 7NZ, SA70 7PD, SA70 7PF, SA70 7PG, SA70 7RE, SA70 7RG",252,214,38
W00003273,SA70,"SA70 7PA, SA70 7PB, SA70 7PE, SA70 7PH, SA70 7PJ, SA70 7PL, SA70 7PN, SA70 7PP, SA70 7PQ, SA70 7PR, SA70 7PS, SA70 7PT, SA70 7PU, SA70 7PW, SA70 7PX, SA70 7PZ, SA70 7QB, SA70 7QD, SA70 7QN, SA70 7RA, SA70 7RB, SA70 7RD, SA70 7WA, SA70 7WG, SA70 7YF, SA70 7YS, SA70 7YW, SA70 7YX, SA70 7YY, SA70 7YZ",234,196,38
W00003274,SA70,"SA70 7PY, SA70 7QA, SA70 7QE, SA70 7QF, SA70 7QG, SA70 7QH, SA70 7QJ, SA70 7QL, SA70 7QP, SA70 7QR, SA70 7QW, SA70 7QY, SA70 7RH, SA70 7RJ, SA70 7RL, SA70 7RN, SA70 7RP, SA70 7RQ, SA70 7RU, SA70 7RX, SA70 7RY, SA70 7SA, SA70 8LA, SA70 8LB, SA70 8ND, SA70 8NE, SA70 8NF",316,279,37
W00003128,SA70,"SA70 8DZ, SA70 8LE, SA70 8LF, SA70 8LH, SA70 8LJ, SA70 8LL, SA70 8LN, SA70 8LU, SA70 8LW, SA70 8LX, SA70 8LY, SA70 8LZ, SA70 8NA, SA70 8NB, SA70 8NJ",415,378,37
W00003127,SA70,"SA70 8BA, SA70 8LP, SA70 8LR, SA70 8LS, SA70 8LT, SA70 8NG, SA70 8NH, SA70 8NL, SA70 8NP, SA70 8NQ, SA70 8NR, SA70 8NS, SA70 8NT, SA70 8NU, SA70 8RD, SA70 8RH, SA70 8RJ, SA70 8RL, SA70 8RN",366,326,40
W00003336,SA70,"SA70 8BG, SA70 8BJ, SA70 8BN, SA70 8BQ, SA70 8BT, SA70 8BX, SA70 8ED, SA70 8EN",369,320,49
W00003126,SA70,"SA70 7SH, SA70 7TP, SA70 7TR, SA70 7TS, SA70 7TT, SA70 7TU, SA70 7TX",323,279,44
W00003331,SA70,"SA70 8HB, SA70 8HP, SA70 8HR, SA70 8HS, SA70 8HT, SA70 8HU, SA70 8HX, SA70 8HY, SA70 8JB, SA70 8JL",256,220,36
W00003335,SA70,"SA70 8DR, SA70 8DT, SA70 8EA",192,173,19
W00003334,SA70,"SA70 7DP, SA70 7EA, SA70 7ED, SA70 7EE, SA70 7EH, SA70 7EL, SA70 7EN, SA70 7NA",156,138,18
W00003333,SA70,"SA70 7AQ, SA70 7DR, SA70 7DU, SA70 7DX, SA70 7DY, SA70 7EB, SA70 7EG, SA70 7EJ, SA70 7EP, SA70 7HP, SA70 7HR, SA70 7NN, SA70 7NP, SA70 7UH, SA70 7UJ, SA70 7WB, SA70 7WL, SA70 7YB, SA70 7YE, SA70 7YH, SA70 7YL, SA70 7YR, SA70 8EL, SA70 8EP, SA70 8ER, SA70 8EU, SA70 8EW, SA70 8EX",171,156,15
W00003332,SA70,"SA70 7AA, SA70 7AB, SA70 7AD, SA70 7AE, SA70 7AF, SA70 7AG, SA70 7AH, SA70 7AJ, SA70 7AP, SA70 7AR, SA70 7AW, SA70 7AZ, SA70 7BY, SA70 7DG, SA70 7DL, SA70 7EU, SA70 7EX, SA70 7EY, SA70 7EZ, SA70 7JD, SA70 7JE, SA70 7JF, SA70 7JG",120,112,8
W00003339,SA70,"SA70 8BU, SA70 8DA, SA70 8DU, SA70 8DX, SA70 8DY, SA70 8EB, SA70 8EE, SA70 8EF, SA70 8EG, SA70 8EH, SA70 8EJ",266,230,36
W00003330,SA70,"SA70 8JD, SA70 8JE, SA70 8JG, SA70 8JH, SA70 8JJ, SA70 8TH, SA70 8TT",250,213,37
W00003329,SA70,"SA70 8AE, SA70 8HA, SA70 8HD, SA70 8HE, SA70 8HF, SA70 8HG, SA70 8HQ",225,198,27
W00003328,SA70,"SA70 8AB, SA70 8AD, SA70 8AG, SA70 8AQ, SA70 8AS, SA70 8AT, SA70 8AU, SA70 8BB, SA70 8JF",232,212,20
W00003327,SA70,"SA70 8BH, SA70 8BL, SA70 8BP, SA70 8BS, SA70 8DF",226,203,23
W00003326,SA70,"SA70 8DE, SA70 8DG, SA70 8DH, SA70 8DJ, SA70 8DL, SA70 8DQ, SA70 8EY, SA70 8HW",277,254,23
W00003325,SA70,"SA70 8BY, SA70 8BZ, SA70 8DB, SA70 8DD, SA70 8DN, SA70 8DP, SA70 8DW, SA70 8JA",278,250,28
W00003340,SA70,"SA70 7DF, SA70 7DH, SA70 7DJ, SA70 7JH, SA70 7JJ, SA70 7JL, SA70 7JN, SA70 7JQ, SA70 7JS, SA70 7JT, SA70 7JU, SA70 7JW, SA70 7JX, SA70 7LP, SA70 7LR, SA70 7LS",166,155,11
W00003324,SA70,"SA70 7AN, SA70 7ES, SA70 7ET, SA70 7LG, SA70 7LH, SA70 7LJ, SA70 8AA, SA70 8AF, SA70 8AH, SA70 8AJ, SA70 8AL, SA70 8AN, SA70 8AP, SA70 8AR, SA70 8AW",211,188,23
W00003341,SA70,"SA70 7DW, SA70 7EF, SA70 7ER, SA70 7JZ, SA70 7LQ, SA70 7LT, SA70 7LU, SA70 7LX, SA70 7LY, SA70 7NB, SA70 7ND, SA70 7NE, SA70 7NF",153,137,16
W00003342,SA70,"SA70 7BD, SA70 7BH, SA70 7DN, SA70 7DS, SA70 7DT, SA70 7DZ, SA70 7HE, SA70 7HF, SA70 7HG, SA70 7HH, SA70 7HJ, SA70 7HL, SA70 7HN, SA70 7HQ, SA70 7HS, SA70 7HT, SA70 7HU, SA70 7HW, SA70 7HX, SA70 7HY, SA70 7HZ, SA70 7JA, SA70 7JB, SA70 8AZ",153,136,17
W00003125,SA70,"SA70 7SJ, SA70 7SL, SA70 7SN, SA70 7SP, SA70 7SQ, SA70 7SR, SA70 7SS, SA70 7ST, SA70 7SU, SA70 7SW, SA70 7SX, SA70 7SY, SA70 7TD, SA70 8BW, SA70 8LD, SA70 8LG, SA70 8QA, SA70 8QB, SA70 8QF, SA70 8QQ, SA70 8QT",310,288,22
W00003337,SA70,"SA70 7AS, SA70 7AT, SA70 7AX, SA70 7AY, SA70 7BA, SA70 7BB, SA70 7BE, SA70 7BG, SA70 7BJ, SA70 7BL, SA70 7BN, SA70 7BP, SA70 7BQ, SA70 7BS, SA70 7BT, SA70 7BU, SA70 7BW, SA70 7BX, SA70 7BZ, SA70 7DA, SA70 7HA, SA70 7HB, SA70 7HD",104,95,9
W00003255,SA71,"SA71 4NH, SA71 4NN, SA71 4NQ, SA71 4NU, SA71 4NY, SA71 4NZ, SA71 4PA, SA71 4PB, SA71 4PD, SA71 4PE, SA71 4QG, SA71 4QH, SA71 4QT, SA71 4RH, SA71 4RJ, SA71 4RL",365,330,35
W00003253,SA71,"SA71 5TS, SA71 5TT, SA71 5TU, SA71 5TX, SA71 5TY",334,298,36
W00003252,SA71,"SA71 4HS, SA71 4JE, SA71 4JF, SA71 4JG, SA71 4JJ, SA71 4JQ, SA71 4NA",352,332,20
W00003251,SA71,"SA71 4JN, SA71 4LE, SA71 4LW, SA71 4NE, SA71 4NF, SA71 4NG",344,321,23
W00003250,SA71,"SA71 4BX, SA71 4BZ, SA71 4FA, SA71 4HX, SA71 4JA, SA71 4JB, SA71 4JD, SA71 4JH, SA71 4JP, SA71 4ND",355,346,9
W00003249,SA71,"SA71 4EU, SA71 4EX, SA71 4EY, SA71 4HA, SA71 4HR, SA71 4LH, SA71 4LL, SA71 4LN, SA71 4LP, SA71 4LR, SA71 5EP, SA71 5ER",248,227,21
W00003248,SA71,"SA71 4HP, SA71 4HT, SA71 4HU, SA71 4JL, SA71 4LS, SA71 4LT, SA71 4LU, SA71 4LX, SA71 4LZ, SA71 4NB",301,288,13
W00003066,SA71,"SA71 5AB, SA71 5AD, SA71 5AF, SA71 5AH, SA71 5AJ, SA71 5AL, SA71 5AN, SA71 5AP, SA71 5AR, SA71 5AS, SA71 5AT, SA71 5AU, SA71 5AW, SA71 5AX, SA71 5AY, SA71 5AZ, SA71 5BA, SA71 5BB, SA71 5BD, SA71 5BE, SA71 5BG",300,282,18
W00003067,SA71,"SA71 5EB, SA71 5HE, SA71 5HG, SA71 5HH, SA71 5HJ, SA71 5HL, SA71 5HN, SA71 5HP, SA71 5HQ, SA71 5HR, SA71 5HS, SA71 5HT, SA71 5HW",155,137,18
W00003068,SA71,"SA71 5AA, SA71 5AG, SA71 5EH, SA71 5EU, SA71 5EX, SA71 5EY, SA71 5EZ, SA71 5HA, SA71 5HB, SA71 5HD, SA71 5HY, SA71 5QX, SA71 5RA, SA71 5RF, SA71 5RP, SA71 5RR, SA71 5RS, SA71 5RT, SA71 5RU, SA71 5RW, SA71 5RX, SA71 5SH, SA71 5SJ, SA71 5SN, SA71 5SP, SA71 5SQ, SA71 5SS, SA71 5ST, SA71 5SU, SA71 5SW, SA71 5SX, SA71 5SY, SA71 5SZ, SA71 5TA, SA71 5TB, SA71 5TD, SA71 5TE, SA71 5TF, SA71 5TG, SA71 5TH, SA71 5TJ, SA71 5TL, SA71 5TN, SA71 5TP, SA71 5TQ, SA71 5TR, SA71 5TW",396,351,45
W00003256,SA71,"SA71 4BS, SA71 4PU, SA71 4PX, SA71 4QA, SA71 4QF, SA71 4QQ, SA71 4SZ, SA71 4TA, SA71 4TB, SA71 4TD, SA71 4TE, SA71 4TG, SA71 4TH, SA71 4TJ, SA71 4TL",310,287,23
W00003257,SA71,"SA71 4BY, SA71 4NX, SA71 4PG, SA71 4PH, SA71 4PJ, SA71 4PL, SA71 4PP, SA71 4PQ, SA71 4PW, SA71 4PY, SA71 4PZ, SA71 4QD, SA71 4QE, SA71 4QJ",341,321,20
W00003258,SA71,"SA71 4BT, SA71 4BU, SA71 4PF, SA71 4PN, SA71 4PR, SA71 4PS, SA71 4PT, SA71 4QU, SA71 4QX",406,382,24
W00003259,SA71,"SA71 4DZ, SA71 4EF, SA71 4EH, SA71 4EQ, SA71 4EW, SA71 4EZ, SA71 4FB, SA71 4HB, SA71 5BT",275,249,26
W00003260,SA71,"SA71 4ED, SA71 4EE, SA71 4EL, SA71 4EN, SA71 4FD, SA71 5BS",305,288,17
W00003261,SA71,"SA71 4BP, SA71 4DB, SA71 4DE, SA71 4DF, SA71 4DG, SA71 4DQ, SA71 4DR, SA71 4DS, SA71 4DT, SA71 4DU, SA71 4DX, SA71 4DY, SA71 4HL, SA71 4HN, SA71 4HW",283,262,21
W00003262,SA71,"SA71 4DA, SA71 4DD, SA71 4DW, SA71 4EA, SA71 4EB, SA71 4EP, SA71 4HH, SA71 4HJ, SA71 4JS, SA71 4JT, SA71 4JU, SA71 4JX, SA71 4JY, SA71 4JZ, SA71 4LA, SA71 4LB, SA71 4LD, SA71 4LF, SA71 4NP, SA71 4NR, SA71 4NS, SA71 4NT, SA71 4NW",253,233,20
W00003263,SA71,"SA71 4EG, SA71 4EJ, SA71 4ER, SA71 4ES, SA71 4ET, SA71 4HD, SA71 4LG, SA71 4LJ, SA71 4LQ",278,235,43
W00003264,SA71,"SA71 4AF, SA71 5NH, SA71 5PS, SA71 5PT, SA71 5PU, SA71 5PX, SA71 5PY, SA71 5QA, SA71 5QH, SA71 5QJ, SA71 5QL",268,245,23
W00003265,SA71,"SA71 4AQ, SA71 4BB, SA71 4BG, SA71 5JB, SA71 5JD, SA71 5JG, SA71 5JQ",282,267,15
W00003266,SA71,"SA71 4AN, SA71 4BD, SA71 4BE, SA71 4BH, SA71 4BJ, SA71 4BL, SA71 4BN, SA71 4BW, SA71 5PN, SA71 5PP, SA72 4SP",269,249,20
W00003267,SA71,"SA71 4AG, SA71 5JN, SA71 5JP, SA71 5JW, SA71 5JZ, SA71 5NJ",291,254,37
W00003268,SA71,"SA71 5JA, SA71 5JE, SA71 5JF, SA71 5JH, SA71 5JJ, SA71 5JL, SA71 5LQ",403,375,28
W00003269,SA71,"SA71 5PF, SA71 5PR, SA71 5PZ, SA71 5QB, SA71 5QD, SA71 5QE, SA71 5QN, SA71 5QQ, SA71 5QW, SA71 5QY",298,271,27
W00003069,SA71,"SA71 5ES, SA71 5ET, SA71 5EW, SA71 5QP, SA71 5QR, SA71 5QS, SA71 5QT, SA71 5QU, SA71 5RB, SA71 5RD, SA71 5RE, SA71 5RG, SA71 5RH, SA71 5RJ, SA71 5RL, SA71 5RN, SA71 5RQ, SA71 5RY, SA71 5RZ",440,407,33
W00003070,SA71,"SA71 5BU, SA71 5BX, SA71 5BY, SA71 5BZ, SA71 5DA, SA71 5DB, SA71 5DD, SA71 5DE, SA71 5DF, SA71 5DG, SA71 5DH, SA71 5DJ, SA71 5DL, SA71 5DN, SA71 5DP, SA71 5DQ, SA71 5DR, SA71 5DS, SA71 5DT, SA71 5DU, SA71 5DW, SA71 5DX, SA71 5DY, SA71 5DZ, SA71 5EA, SA71 5ED, SA71 5EE, SA71 5EG, SA71 5EQ, SA71 5HU, SA71 5HX, SA71 5HZ, SA71 5LR, SA71 5LS, SA71 5LT, SA71 5NZ, SA71 5SL",393,354,39
W00003091,SA71,"SA71 4SY, SA71 5PG, SA71 5PH, SA71 5PJ, SA71 5PQ, SA71 5SR, SA72 4RX, SA72 4RY, SA72 4SA, SA72 4SB, SA72 4SD, SA72 4SF, SA72 4SL, SA72 4SN, SA72 4SR, SA72 4SS, SA72 4SU, SA72 4SX, SA72 4TU, SA72 4TX, SA72 4UA, SA72 4UB, SA72 4UD, SA72 4UH, SA72 4UN, SA72 4UP",404,366,38
W00003271,SA71,"SA71 4AA, SA71 4AB, SA71 4AD, SA71 4AH, SA71 4AJ, SA71 4AL, SA71 4AP, SA71 4AW, SA71 4DH, SA71 4DJ, SA71 4DL, SA71 4DN, SA71 4DP, SA71 5BP, SA71 5BQ, SA71 5QG",258,224,34
W00003224,SA71,"SA71 4RF, SA72 6LS, SA72 6LU, SA72 6LX, SA72 6LZ, SA72 6NB",301,280,21
W00003093,SA71,"SA71 5LA, SA71 5LB, SA71 5LE, SA71 5LF, SA71 5LG, SA71 5LH, SA71 5LJ, SA71 5LL, SA71 5LN, SA71 5LP, SA71 5LU, SA71 5LW, SA71 5LX, SA71 5LY, SA71 5LZ",248,226,22
W00003225,SA71,"SA71 4RE, SA71 4RG, SA72 4RW, SA72 6LJ, SA72 6LP, SA72 6LY, SA72 6ND, SA72 6NE, SA72 6NG",264,250,14
W00003092,SA71,"SA71 5JS, SA71 5JT, SA71 5JX, SA71 5JY, SA71 5LD, SA71 5NA, SA71 5NL, SA71 5NN, SA71 5NP, SA71 5NR, SA71 5NW",327,293,34
W00003270,SA71,"SA71 4AE, SA71 4AR, SA71 4AS, SA71 4AT, SA71 4AU, SA71 4AX, SA71 4AY, SA71 4AZ, SA71 4BA",304,280,24
W00003221,SA71,"SA71 4WZ, SA71 4YA, SA71 4YB, SA71 4YD, SA71 4YE, SA71 4YH, SA71 5AE, SA71 5WA, SA71 5WW, SA71 5WX, SA71 5WY, SA71 5WZ, SA71 5YA, SA71 5YB, SA71 5YD, SA71 5YE, SA71 5YF, SA72 6AG, SA72 6AH, SA72 6AJ, SA72 6AL, SA72 6AN, SA72 6BS, SA72 6BY, SA72 6BZ, SA72 6DB, SA72 6DD, SA72 6HX, SA72 6JA, SA72 6JB, SA72 6JD, SA72 6JE, SA72 6UT, SA72 6UX, SA72 6UY, SA72 6UZ, SA72 6WA, SA72 6WB, SA72 6WD, SA72 6WE, SA72 6WF, SA72 6WG, SA72 6WH, SA72 6WJ, SA72 6WP, SA72 6WQ, SA72 6WR, SA72 6WW, SA72 6WY, SA72 6WZ, SA72 6XA, SA72 6XD, SA72 6ZE, SA72 6ZR, SA72 6ZT, SA72 6ZW, SA72 9AA, SA72 9AB, SA72 9AD, SA72 9AE, SA72 9AF, SA72 9AG, SA72 9AH, SA72 9AJ, SA72 9AL, SA72 9AN, SA72 9AP, SA72 9AQ, SA72 9AR, SA72 9AS, SA72 9AU",264,238,26
W00010686,SA71,"SA71 4TN, SA71 4TP, SA71 4TQ, SA71 4TR, SA71 4TS",350,302,48
W00010692,SA71,"SA71 4QB, SA71 4QL, SA71 4QN, SA71 4QP, SA71 4QR, SA71 4QS, SA71 4QY",268,246,22
W00003230,SA72,"SA72 6AF, SA72 6DP, SA72 6DR, SA72 6DS, SA72 6DT, SA72 6DW, SA72 6HA, SA72 6HN, SA72 6TT, SA72 6UR",346,320,26
W00003222,SA72,"SA72 6HB, SA72 6HF, SA72 6HH, SA72 6HJ, SA72 6HL, SA72 6HP, SA72 6HR",319,285,34
W00003228,SA72,"SA72 4AA, SA72 4RA, SA72 4RR, SA72 4RS, SA72 4RT, SA72 4RU, SA72 4RZ, SA72 6LT, SA72 6TU, SA72 6TX, SA72 6TY, SA72 6UA, SA72 6UB, SA72 6UG, SA72 6UJ, SA72 6UN, SA72 6UQ",299,279,20
W00003227,SA72,"SA72 6BW, SA72 6DU, SA72 6DX, SA72 6EH, SA72 6EL, SA72 6EN, SA72 6ER, SA72 6ES, SA72 6ET, SA72 6EW, SA72 6EY, SA72 6TQ, SA72 6TR",277,238,39
W00003226,SA72,"SA72 6DY, SA72 6DZ, SA72 6ED, SA72 6EG, SA72 6EJ, SA72 6FB, SA72 6FD, SA72 6HZ, SA72 6TG, SA72 6TS, SA72 6TZ, SA72 6UD, SA72 6UP",285,258,27
W00003232,SA72,"SA72 6AE, SA72 6SX, SA72 6SY, SA72 6TB, SA72 6TD, SA72 6TE, SA72 6TF, SA72 6TH, SA72 6TW, SA72 6UF, SA72 6WS, SA72 6WT, SA72 6WX, SA72 6XG, SA72 6XP, SA72 6XQ, SA72 6XR, SA72 6XS, SA72 6XT, SA72 6XU, SA72 6XX, SA72 6YA, SA72 6YB, SA72 6YD, SA72 6YG, SA72 6YH, SA72 6YJ, SA72 6YL, SA72 6YN, SA72 6YP, SA72 6YR, SA72 6YS, SA72 6YT, SA72 6YX, SA72 6ZF",291,274,17
W00003233,SA72,"SA72 6AP, SA72 6AR, SA72 6AS, SA72 6AW, SA72 6DG, SA72 6EX, SA72 6WL, SA72 6WN, SA72 6YU, SA72 6YY, SA72 6ZD",287,258,29
W00003223,SA72,"SA72 6LH, SA72 6LN, SA72 6LR, SA72 6LW, SA72 6NA, SA72 6UH",271,254,17
W00003234,SA72,"SA72 6BH, SA72 6DQ, SA72 6HD, SA72 6HE, SA72 6HQ, SA72 6PG",293,272,21
W00003231,SA72,"SA72 6BP, SA72 6HS, SA72 6HT, SA72 6HU, SA72 6HW, SA72 6LE, SA72 6LF, SA72 6LG, SA72 6LL, SA72 6LQ",326,305,21
W00003229,SA72,"SA72 6DF, SA72 6EA, SA72 6EB, SA72 6EE, SA72 6EF, SA72 6EQ, SA72 6EU, SA72 6EZ, SA72 6XY",276,263,13
W00003236,SA72,"SA72 6TJ, SA72 6TL, SA72 6TN, SA72 6TP, SA72 6XW, SA72 6YE, SA72 6YF, SA72 6YQ",246,234,12
W00003219,SA72,"SA72 6JG, SA72 6JQ, SA72 6JS, SA72 6JW, SA72 6XB",208,191,17
W00003218,SA72,"SA72 6JL, SA72 6JN, SA72 6JP, SA72 6JR, SA72 6LA, SA72 6XE",271,257,14
W00003217,SA72,"SA72 6JF, SA72 6JH, SA72 6JJ, SA72 6JT, SA72 6JU, SA72 6JX, SA72 6JY, SA72 6JZ, SA72 6UE, SA72 6UL",213,199,14
W00003247,SA72,"SA72 6SG, SA72 6SL, SA72 6SQ, SA72 6ST, SA72 6SZ",301,284,17
W00003246,SA72,"SA72 6NL, SA72 6NW, SA72 6NY, SA72 6PA, SA72 6QP, SA72 6QR, SA72 6QS",298,272,26
W00003245,SA72,"SA72 6BE, SA72 6BJ, SA72 6BQ, SA72 6PB, SA72 6PE, SA72 6PF",228,204,24
W00003244,SA72,"SA72 6NU, SA72 6NX, SA72 6PP, SA72 6SJ, SA72 6SN, SA72 6SP, SA72 6SR, SA72 6SS, SA72 6SW, SA72 6TA",280,257,23
W00003243,SA72,"SA72 6RB, SA72 6RD, SA72 6RN, SA72 6RP, SA72 6RQ, SA72 6RR, SA72 6RS, SA72 6RT, SA72 6RU, SA72 6RW, SA72 6SH",330,301,29
W00003242,SA72,"SA72 6AA, SA72 6AB, SA72 6AD, SA72 6AQ, SA72 6GL, SA72 6RA, SA72 6RF, SA72 6RX, SA72 6RY, SA72 6RZ, SA72 6SA, SA72 6SB, SA72 6SD, SA72 6SE, SA72 6SF",514,484,30
W00003090,SA72,"SA72 4SE, SA72 4ST, SA72 4TT, SA72 4TY, SA72 4TZ, SA72 4UE, SA72 4UF, SA72 4UG, SA72 4UJ, SA72 4UL, SA72 4UQ, SA72 4UR, SA72 4US, SA72 4UT, SA72 4UW, SA72 4WE",406,373,33
W00003239,SA72,"SA72 6NZ, SA72 6QH, SA72 6QJ, SA72 6QL, SA72 6QN, SA72 6QU, SA72 6QW, SA72 6QY",350,331,19
W00003240,SA72,"SA72 6PJ, SA72 6PL, SA72 6PN, SA72 6PR, SA72 6PS, SA72 6PT, SA72 6PU, SA72 6PW, SA72 6PX, SA72 6PZ, SA72 6QB, SA72 6QF, SA72 6QG, SA72 6QZ",508,468,40
W00003238,SA72,"SA72 6BG, SA72 6PD, SA72 6PH, SA72 6PQ, SA72 6PY, SA72 6QA, SA72 6QD, SA72 6QE, SA72 6QQ, SA72 6QT, SA72 6QX",234,216,18
W00003237,SA72,"SA72 6AT, SA72 6AU, SA72 6BA, SA72 6BB, SA72 6BD, SA72 6BL, SA72 6BN, SA72 6UU",358,324,34
W00003241,SA72,"SA72 6RE, SA72 6RG, SA72 6RH, SA72 6RJ, SA72 6RL",352,334,18
W00003220,SA72,"SA72 6BT, SA72 6BX, SA72 6DA, SA72 6DE, SA72 6DH, SA72 6DJ, SA72 6DL, SA72 6DN, SA72 6EP, SA72 6HG",285,258,27
W00003235,SA72,"SA72 6AX, SA72 6AY, SA72 6NN, SA72 6NP, SA72 6NR, SA72 6NS, SA72 6NT, SA72 6XF, SA72 6XH, SA72 6XJ, SA72 6XL, SA72 6XN, SA72 6XZ",279,257,22
W00003175,SA73,"SA73 1HA, SA73 1HD, SA73 1HE, SA73 1HF, SA73 1HG, SA73 1HH, SA73 1HQ, SA73 1HY, SA73 1HZ, SA73 1JA, SA73 1JB, SA73 1JN",495,447,48
W00003172,SA73,"SA73 1BA, SA73 1BH, SA73 1BL, SA73 2DA, SA73 2DE, SA73 2PP, SA73 2RB, SA73 2RD, SA73 2RE, SA73 2RF, SA73 2RG, SA73 2RH, SA73 2RR, SA73 2RW, SA73 2RX, SA73 2RY, SA73 2RZ",432,398,34
W00003211,SA73,"SA73 1EA, SA73 1EB, SA73 1EL, SA73 1EN, SA73 1EW",222,195,27
W00003209,SA73,"SA73 1PN, SA73 1PW, SA73 1PZ, SA73 1QQ, SA73 1SF, SA73 1SG, SA73 1SU, SA73 1SX, SA73 1SY, SA73 1SZ, SA73 1TA, SA73 1TZ",308,285,23
W00003208,SA73,"SA73 1LS, SA73 1PS, SA73 1PX, SA73 1QA, SA73 1QB, SA73 1QR, SA73 1SH, SA73 1SS, SA73 1TY, SA73 1UA",311,294,17
W00003207,SA73,"SA73 1QE, SA73 1QG, SA73 1QH, SA73 1TT, SA73 1TU, SA73 1TX, SA73 1UB",291,273,18
W00003206,SA73,"SA73 1PP, SA73 1PR, SA73 1PY, SA73 1SL, SA73 1SN, SA73 1SP, SA73 1SR, SA73 1ST, SA73 1TB, SA73 1TD",247,230,17
W00003205,SA73,"SA73 1GA, SA73 1TE, SA73 1TF, SA73 1TG, SA73 1TH, SA73 1TJ, SA73 1TP, SA73 1TR",329,313,16
W00003204,SA73,"SA73 1RA, SA73 1RZ, SA73 1SD, SA73 1SQ, SA73 1TW, SA73 1UF, SA73 1UH",305,270,35
W00003203,SA73,"SA73 1PH, SA73 1PJ, SA73 1PL, SA73 1RB, SA73 1RD, SA73 1RW, SA73 1SB, SA73 1SE, SA73 1SJ, SA73 1SW, SA73 1TQ",317,295,22
W00003077,SA73,"SA73 3LY, SA73 3NQ, SA73 3UD, SA73 3UE, SA73 3UF, SA73 3UG, SA73 3UP",124,107,17
W00003186,SA73,"SA73 2AG, SA73 2AH, SA73 2AJ, SA73 2AL, SA73 2AN, SA73 2AQ, SA73 2BT, SA73 2BU, SA73 2BX, SA73 2BY, SA73 2DB, SA73 3AB, SA73 3AU",189,165,24
W00003185,SA73,"SA73 2AP, SA73 2AR, SA73 2AS, SA73 2AW, SA73 2DS, SA73 2DT, SA73 2DU, SA73 2DX, SA73 2DY",250,225,25
W00003184,SA73,"SA73 2AT, SA73 2AU, SA73 2AY, SA73 2BA, SA73 2BB, SA73 2BE, SA73 2BH, SA73 2BS, SA73 2BZ",331,304,27
W00003183,SA73,"SA73 2BD, SA73 2BG, SA73 2BJ, SA73 2BL, SA73 2BN, SA73 2BP, SA73 2BQ, SA73 2BW, SA73 2DD",295,277,18
W00003182,SA73,"SA73 2AX, SA73 2AZ, SA73 2BR, SA73 2DZ, SA73 2EA, SA73 2ED, SA73 2EP, SA73 2JP, SA73 2JR, SA73 2JS, SA73 2YE, SA73 2YG, SA73 2YL",297,273,24
W00003181,SA73,"SA73 2EE, SA73 2EF, SA73 2PD, SA73 2PE, SA73 2PN, SA73 2PR, SA73 2PW",220,208,12
W00003180,SA73,"SA73 2EB, SA73 2EG, SA73 2EN, SA73 2EQ, SA73 2ER, SA73 2ES, SA73 3UA, SA73 3UB",293,275,18
W00003170,SA73,"SA73 3HH, SA73 3HL, SA73 3HS, SA73 3HU, SA73 3HX, SA73 3RB, SA73 3RH",313,290,23
W00003169,SA73,"SA73 3HF, SA73 3HG, SA73 3HJ, SA73 3HQ",318,306,12
W00003159,SA73,"SA73 3AQ, SA73 3AX, SA73 3DJ, SA73 3LB, SA73 3LJ, SA73 3LL, SA73 3LP, SA73 3LR, SA73 3LT, SA73 3LU, SA73 3LW, SA73 3LX, SA73 3PA, SA73 3PB, SA73 3PD",280,265,15
W00003168,SA73,"SA73 3AD, SA73 3LD, SA73 3LF, SA73 3LS, SA73 3NH, SA73 3NJ, SA73 3NL, SA73 3QH",206,188,18
W00003167,SA73,"SA73 3BR, SA73 3NN, SA73 3NP, SA73 3NR, SA73 3NW, SA73 3PH, SA73 3PJ, SA73 3PL, SA73 3PQ, SA73 3PR, SA73 3PS, SA73 3PT, SA73 3PU, SA73 3PW, SA73 3PX, SA73 3RD, SA73 3RE, SA73 3RG",373,352,21
W00003158,SA73,"SA73 3NA, SA73 3NE, SA73 3PE, SA73 3PF, SA73 3PG, SA73 3QB",269,249,20
W00003160,SA73,"SA73 3AT, SA73 3BE, SA73 3BG, SA73 3BH, SA73 3BJ, SA73 3BL, SA73 3BN, SA73 3BP, SA73 3BQ, SA73 3BT, SA73 3BU, SA73 3BW, SA73 3BX, SA73 3BY, SA73 3BZ, SA73 3DA, SA73 3DB, SA73 3DE, SA73 3DG, SA73 3DH, SA73 3DQ, SA73 3DT, SA73 3DU",300,283,17
W00003166,SA73,"SA73 3HB, SA73 3HN, SA73 3HR, SA73 3HT, SA73 3PP, SA73 3RJ, SA73 3RL, SA73 3RS",284,257,27
W00003174,SA73,"SA73 1AJ, SA73 1AL, SA73 1AN, SA73 1AP, SA73 1AR, SA73 1AS, SA73 1AU, SA73 1AW, SA73 1AX, SA73 1AY, SA73 1AZ, SA73 1DW, SA73 1DZ, SA73 1GB, SA73 1HB, SA73 2RA, SA73 2RS, SA73 2RT, SA73 2RU, SA73 2SE",433,390,43
W00002961,SA73,"SA73 1LG, SA73 1NX, SA73 1NY, SA73 1PA, SA73 1PB, SA73 1PF",193,171,22
W00003177,SA73,"SA73 2PF, SA73 2PG, SA73 2PH, SA73 2PJ, SA73 2PL, SA73 2PQ, SA73 2PS",445,401,44
W00003157,SA73,"SA73 3DY, SA73 3EL, SA73 3EN, SA73 3ES, SA73 3EX, SA73 3EY",310,290,20
W00003178,SA73,"SA73 1AT, SA73 2LQ, SA73 2LW, SA73 2NA, SA73 2NB, SA73 2ND, SA73 2NE, SA73 2PX, SA73 2YD, SA73 2YF, SA73 2YW",299,273,26
W00003179,SA73,"SA73 2EH, SA73 2EJ, SA73 2EL",228,210,18
W00003165,SA73,"SA73 3HA, SA73 3HD, SA73 3HE, SA73 3HP, SA73 3HW, SA73 3PN, SA73 3RQ",365,330,35
W00003161,SA73,"SA73 3AE, SA73 3DD, SA73 3DL, SA73 3DN, SA73 3DP, SA73 3DR, SA73 3DS, SA73 3DW, SA73 3LZ",239,226,13
W00003173,SA73,"SA73 2LN, SA73 2LR, SA73 2LS, SA73 2LT, SA73 2LU",218,208,10
W00003215,SA73,"SA73 1PT, SA73 1RN, SA73 1RP, SA73 1SA, SA73 1TL, SA73 1TN",262,243,19
W00003144,SA73,"SA73 1WA, SA73 1WS, SA73 1WT, SA73 1WU, SA73 1WW, SA73 1WX, SA73 1WY, SA73 1WZ, SA73 1YA, SA73 1YB, SA73 1YE, SA73 1YL, SA73 1YN, SA73 1YP, SA73 2DH, SA73 2DN, SA73 2DP, SA73 2DR, SA73 2HH, SA73 2HJ, SA73 2HL, SA73 2HT, SA73 2HX, SA73 2HY, SA73 2JW, SA73 2XB, SA73 2YA, SA73 2YB, SA73 2YH, SA73 2YN, SA73 2YP, SA73 2YR, SA73 2ZU, SA73 2ZW, SA73 3AG, SA73 3AR, SA73 3DF, SA73 3JG, SA73 3JJ, SA73 3JL, SA73 3JQ, SA73 3WX, SA73 3WY, SA73 3WZ, SA73 3YA, SA73 3YB, SA73 3YD, SA73 3YF, SA73 3YH, SA73 3YL, SA73 3YP, SA73 3YQ, SA73 3YR, SA73 3YS, SA73 9AB, SA73 9AD, SA73 9AE, SA73 9AF, SA73 9AG",221,205,16
W00003146,SA73,"SA73 2NJ, SA73 2NL, SA73 2NN, SA73 2QL, SA73 2QN, SA73 2QP, SA73 2QR, SA73 2QS, SA73 2QT",278,262,16
W00003147,SA73,"SA73 2QA, SA73 2QB, SA73 2QD, SA73 2QE, SA73 2QG, SA73 2QH, SA73 2QJ",253,229,24
W00003298,SA73,"SA73 3RY, SA73 3RZ, SA73 3SH, SA73 3SJ, SA73 3SL, SA73 3SP, SA73 3SR, SA73 3SS, SA73 3ST, SA73 3SU, SA73 3SX, SA73 3SY, SA73 3SZ, SA73 3TB, SA73 3TD, SA73 3TE, SA73 3TF, SA73 3TG, SA73 3TP, SA73 3TR, SA73 3TS",410,359,51
W00003149,SA73,"SA73 1AA, SA73 1AB, SA73 1BJ, SA73 1DA, SA73 1DF",227,199,28
W00003150,SA73,"SA73 1DD, SA73 1DH, SA73 2NT, SA73 2NU, SA73 2NX, SA73 2NY, SA73 2PA",376,333,43
W00003151,SA73,"SA73 1DG, SA73 1DJ, SA73 1DL, SA73 1DQ, SA73 1ES, SA73 1ET, SA73 1EU",179,162,17
W00010359,SA73,"SA73 1BP, SA73 1BW, SA73 1BX, SA73 1BZ, SA73 1DB, SA73 1DE, SA73 1EY",198,180,18
W00003152,SA73,"SA73 1AG, SA73 1AQ",145,138,7
W00010676,SA73,"SA73 1AD, SA73 1AE, SA73 1AF, SA73 1AH, SA73 2SA, SA73 2SB",316,286,30
W00010684,SA73,"SA73 2RJ, SA73 2RL, SA73 2RN, SA73 2RP, SA73 2RQ, SA73 2SD, SA73 2SH",283,272,11
W00003212,SA73,"SA73 1BR, SA73 1DR, SA73 1DS, SA73 1DT, SA73 1DU, SA73 1DX, SA73 1DY, SA73 1EE, SA73 1EF, SA73 1EG, SA73 1EH, SA73 1EJ, SA73 1EQ",269,242,27
W00003216,SA73,"SA73 1QD, SA73 1QF, SA73 1QJ, SA73 1QL, SA73 1RY, SA73 1TS, SA73 1UD, SA73 1UE, SA73 1UG, SA73 1YD, SA73 1YF, SA73 1YG",339,309,30
W00003142,SA73,"SA73 2HS, SA73 2HU, SA73 2JF, SA73 2JH, SA73 2JL, SA73 2LH, SA73 2LP",241,220,21
W00003143,SA73,"SA73 2LA, SA73 2LB, SA73 2LD, SA73 2LE, SA73 2LF, SA73 2LG, SA73 2LJ, SA73 2LL, SA73 2LZ, SA73 2NP, SA73 3JP, SA73 3JR, SA73 3JS, SA73 3JU, SA73 3JW",268,238,30
W00010677,SA73,"SA73 2AA, SA73 2AB, SA73 2AD, SA73 2AE, SA73 2AF, SA73 2DJ, SA73 2DL, SA73 2HA, SA73 2HB, SA73 2HD, SA73 2HE, SA73 2HF, SA73 2HG, SA73 2HQ, SA73 2HZ, SA73 3AA, SA73 3AF, SA73 3AH, SA73 3AJ, SA73 3AL, SA73 3AN, SA73 3AP, SA73 3AS, SA73 3AW, SA73 3AY, SA73 3JA, SA73 3JB, SA73 3JE, SA73 3JF, SA73 3JH, SA73 3NF",193,180,13
W00003213,SA73,"SA73 1ED, SA73 1QP, SA73 1QX, SA73 1QY, SA73 1RE, SA73 1RF, SA73 1RG, SA73 1RH, SA73 1RJ",254,247,7
W00003141,SA73,"SA73 2JA, SA73 2JB, SA73 2JD, SA73 2JG, SA73 2JJ, SA73 2JN, SA73 2JT",272,256,16
W00010687,SA73,"SA73 1BS, SA73 1DN, SA73 1DP, SA73 1EX, SA73 1EZ, SA73 1GH, SA73 1GL",350,315,35
W00010667,SA73,"SA73 3SA, SA73 3SB, SA73 3SD, SA73 3SE",330,294,36
W00010662,SA73,"SA73 1JL, SA73 1JP, SA73 1JR, SA73 1JS, SA73 1JT, SA73 1JU, SA73 1JW, SA73 1LA, SA73 1LB, SA73 1LH, SA73 1LJ",301,266,35
W00010658,SA73,"SA73 3PY, SA73 3PZ, SA73 3QA, SA73 3QD, SA73 3RT, SA73 3RU, SA73 3RX, SA73 3SF, SA73 3SG",331,302,29
W00003153,SA73,"SA73 1BQ, SA73 1BT, SA73 1BU, SA73 1BY",269,252,17
W00003164,SA73,"SA73 3EZ, SA73 3JZ, SA73 3QU, SA73 3QX, SA73 3QY, SA73 3QZ, SA73 3RA, SA73 3YE, SA73 3YG, SA73 3YN",347,334,13
W00003163,SA73,"SA73 3LA, SA73 3LE, SA73 3LG, SA73 3LH, SA73 3LN, SA73 3LQ, SA73 3NB, SA73 3ND, SA73 3NG",265,246,19
W00003162,SA73,"SA73 3BS, SA73 3DX, SA73 3DZ, SA73 3EA, SA73 3EB, SA73 3ED, SA73 3EE, SA73 3EF, SA73 3EG, SA73 3EH, SA73 3EJ, SA73 3EP, SA73 3EQ, SA73 3EW",259,246,13
W00003154,SA73,"SA73 1BB, SA73 1BD, SA73 1BE, SA73 1BG, SA73 1BN",203,188,15
W00003155,SA73,"SA73 2LX, SA73 2LY, SA73 2NR, SA73 2NS, SA73 2NZ, SA73 2PB",316,289,27
W00003156,SA73,"SA73 3ET, SA73 3EU, SA73 3QP, SA73 3QR, SA73 3QS, SA73 3QT",292,274,18
W00010690,SA73,"SA73 2DF, SA73 2HN, SA73 2HP, SA73 2HR, SA73 2HW, SA73 2JE, SA73 2JQ, SA73 3AZ, SA73 3BA, SA73 3BB, SA73 3BD, SA73 3JN, SA73 3JT",207,182,25
W00003214,SA73,"SA73 1PU, SA73 1RL, SA73 1RQ, SA73 1RR, SA73 1RS, SA73 1RT, SA73 1RU, SA73 1RX",282,266,16
W00004731,SA8,"SA8 3BJ, SA8 3BL, SA8 3BN, SA8 3DJ, SA8 3DN",292,210,82
W00004934,SA8,"SA8 4QL, SA8 4QN, SA8 4QR, SA8 4QU, SA8 4QZ, SA9 2PD",314,236,78
W00004931,SA8,"SA8 4TX, SA9 2DP, SA9 2NX, SA9 2NY, SA9 2NZ, SA9 2PA, SA9 2PB",351,247,104
W00004737,SA8,"SA8 3AA, SA8 3AG, SA8 3AP, SA8 3AR, SA8 3AS, SA8 3AT, SA8 3AZ",285,245,40
W00004736,SA8,"SA8 3AB, SA8 3AE, SA8 3AH, SA8 3AJ, SA8 3AQ, SA8 3BD, SA8 3BP, SA8 3BR, SA8 3BS, SA8 3BT, SA8 3BU, SA8 3BW",345,271,74
W00004733,SA8,"SA8 3AL, SA8 3AN, SA8 3AW, SA8 3AX, SA8 3AY, SA8 3DL",296,231,65
W00004935,SA8,"SA8 4QP, SA8 4QS, SA8 4QT, SA8 4QX, SA8 4QY, SA8 4RA",296,237,59
W00004735,SA8,"SA8 3AD, SA8 3AF, SA8 3BX, SA8 3BY, SA8 3DA, SA8 3DH, SA8 3DQ, SA8 3YF",333,278,55
W00005034,SA8,"SA8 4PL, SA8 4RJ, SA8 4RL, SA8 4RP, SA8 4RR, SA8 4RU, SA8 4RW, SA8 4RX, SA8 4SH, SA8 4SS, SA8 4ST, SA8 4SX, SA8 4SY, SA8 4TA, SA8 4TE, SA8 4TH, SA8 4TJ, SA8 4TL, SA8 4TN, SA8 4TP, SA8 4TQ, SA8 4TR, SA8 4TS, SA8 4TU, SA8 4TY, SA9 2SB, SA9 2SD",233,172,61
W00005030,SA8,"SA8 4AZ, SA8 4HD, SA8 4JL, SA8 4JN, SA8 4JP, SA8 4JQ, SA8 4JX, SA8 4JY, SA8 4YT",391,272,119
W00010416,SA8,"SA8 3DB, SA8 3DD, SA8 3DE, SA8 3DG",389,261,128
W00010386,SA8,"SA8 3BE, SA8 3DF, SA8 3DP",322,243,79
W00005159,SA8,"SA8 4BN, SA8 4BP, SA8 4BR, SA8 4BT, SA8 4BU, SA8 4BX",276,197,79
W00005158,SA8,"SA8 4DH, SA8 4DJ, SA8 4DL, SA8 4DT",272,200,72
W00005025,SA8,"SA8 4AE, SA8 4AH, SA8 4AJ, SA8 4AN, SA8 4AQ, SA8 4AW, SA8 4JW, SA8 4LR, SA8 4LS",304,214,90
W00005031,SA8,"SA8 4AA, SA8 4AB, SA8 4AD, SA8 4AF, SA8 4EA, SA8 4EB, SA8 4ER, SA8 4HU, SA8 4HX, SA8 4HY, SA8 4JA",207,156,51
W00005032,SA8,"SA8 4ED, SA8 4EF, SA8 4EG, SA8 4EH, SA8 4EN, SA8 4EP, SA8 4ES, SA8 4ET, SA8 4EU, SA8 4EW, SA8 4EX, SA8 4EY, SA8 4EZ, SA8 4HA, SA8 4HB, SA8 4HE, SA8 4HQ, SA8 4HR, SA8 4JH, SA8 4JJ, SA8 4JU, SA8 4UH, SA8 4UL, SA8 4UW",327,237,90
W00005157,SA8,"SA8 4BB, SA8 4BL, SA8 4BS, SA8 4DN, SA8 4DR, SA8 4DS, SA8 4DW",332,228,104
W00005156,SA8,"SA8 4AP, SA8 4AR, SA8 4AS, SA8 4AT, SA8 4AU, SA8 4AX, SA8 4AY, SA8 4BA, SA8 4DP, SA8 4RN",223,152,71
W00005078,SA8,"SA8 3EH, SA8 3ES, SA8 3HB, SA8 3HR",321,249,72
W00005077,SA8,"SA8 3EN, SA8 3EP, SA8 3EW",235,198,37
W00005076,SA8,"SA8 3EB, SA8 3ED, SA8 3EQ, SA8 3FA, SA8 3FB, SA8 3FD, SA8 3HG, SA8 3HH",475,367,108
W00005072,SA8,"SA8 3DS, SA8 3DT, SA8 3DU, SA8 3DX, SA8 3DZ, SA8 3EX, SA8 3EY, SA8 3HA, SA8 3HJ, SA8 3HL, SA8 3HN, SA8 3HP, SA8 3HW, SA8 3JB, SA8 3JD, SA8 3JH, SA8 3JJ, SA8 3JL, SA8 3JN, SA8 3JP, SA8 3JQ, SA8 3JR, SA8 3JS, SA8 3JT, SA8 3JU, SA8 3XZ, SA8 3YA, SA8 3YB, SA8 3YD, SA8 3YE, SA9 2PE",468,350,118
W00005033,SA8,"SA8 4AG, SA8 4AL, SA8 4EJ, SA8 4EQ, SA8 4HN, SA8 4HP, SA8 4HW",206,150,56
W00005075,SA8,"SA8 3DR, SA8 3DY, SA8 3EA, SA8 3ER, SA8 3EZ, SA8 3JE",350,271,79
W00005074,SA8,"SA8 3HD, SA8 3HQ, SA8 3HT, SA8 3HX",235,184,51
W00005041,SA8,"SA8 4HJ, SA8 4JS, SA8 4JT, SA8 4JZ, SA8 4LA, SA8 4LB, SA8 4LD, SA8 4LE, SA8 4LJ, SA8 4LL, SA8 4LQ, SA8 4PA, SA8 4PB, SA8 4PF, SA8 4PW",502,351,151
W00005073,SA8,"SA8 3HE, SA8 3HF, SA8 3HU",161,128,33
W00005029,SA8,"SA8 4ND, SA8 4NE, SA8 4NJ, SA8 4NQ",430,322,108
W00005040,SA8,"SA8 4NB, SA8 4NH, SA8 4NL, SA8 4NN, SA8 4NT",256,202,54
W00005039,SA8,"SA8 4LX, SA8 4LY, SA8 4NS, SA8 4NU",286,244,42
W00005038,SA8,"SA8 4PJ, SA8 4PN, SA8 4PP, SA8 4PR, SA8 4PS",306,218,88
W00005028,SA8,"SA8 4LT, SA8 4LU, SA8 4LW, SA8 4LZ, SA8 4NA, SA8 4NR, SA8 4PT, SA8 4PU",449,325,124
W00005027,SA8,"SA8 4BW, SA8 4QD, SA8 4QE, SA8 4QH, SA8 4QJ, SA8 4QQ",407,324,83
W00005035,SA8,"SA8 3BB, SA8 4NW, SA8 4NZ, SA8 4SJ, SA8 4SL",337,251,86
W00005026,SA8,"SA8 4JB, SA8 4JD, SA8 4JE, SA8 4JF, SA8 4JG, SA8 4JR, SA8 4LF, SA8 4LG, SA8 4LH, SA8 4YP, SA8 4YR",344,256,88
W00005071,SA8,"SA8 3EE, SA8 3EG, SA8 3EJ, SA8 3EL, SA8 3HS",266,223,43
W00005160,SA8,"SA8 4BY, SA8 4DA, SA8 4DB, SA8 4DD, SA8 4DE",257,165,92
W00005171,SA9,"SA9 2AS, SA9 2AT, SA9 2AU, SA9 2AX, SA9 2AY, SA9 2AZ, SA9 2BA",309,213,96
W00010370,SA9,"SA9 2DG, SA9 2DR, SA9 2DS, SA9 2DT, SA9 2DW",297,232,65
W00009773,SA9,"SA9 2AD, SA9 2AE, SA9 2BB, SA9 2BD, SA9 2BE, SA9 2NL, SA9 2NN, SA9 2QT, SA9 2QU, SA9 2QX, SA9 2QY, SA9 2QZ, SA9 2TJ, SA9 2TN, SA9 2WZ, SA9 2XA, SA9 2YB, SA9 2ZA, SA9 2ZD, SA9 2ZE",157,103,54
W00009772,SA9,"SA9 2HW, SA9 2PS, SA9 2PT, SA9 2PU, SA9 2PX, SA9 2PY, SA9 2QE, SA9 2SU, SA9 2SX, SA9 2SY, SA9 2TD, SA9 2TE",389,228,161
W00002268,SA9,"SA9 1EW, SA9 1TB, SA9 1TF, SA9 1TQ, SA9 1UR, SA9 1UU, SA9 1UW, SA9 1XA, SA9 1XE, SA9 1XF, SA9 1XG, SA9 1XH, SA9 1XJ, SA9 1XQ, SA9 1XU",349,255,94
W00002269,SA9,"SA9 1QZ, SA9 1RH, SA9 1RJ, SA9 1RL, SA9 1RN, SA9 1RP, SA9 1RR, SA9 1RS, SA9 1RT, SA9 1RU, SA9 1RW, SA9 1RX, SA9 1RY, SA9 1RZ, SA9 1SA, SA9 1SB, SA9 1SF, SA9 1SH, SA9 1SL, SA9 1SN, SA9 1SP, SA9 1SQ, SA9 1SR, SA9 1SS, SA9 1ST, SA9 1SU, SA9 1SW, SA9 1SX, SA9 1SY, SA9 1SZ, SA9 1TA, SA9 1TD, SA9 1TE, SA9 1TG, SA9 1UH, SA9 1XL, SA9 1YF",284,202,82
W00002272,SA9,"SA9 1US, SA9 1UT, SA9 1UX, SA9 1UY, SA9 1UZ, SA9 1WF, SA9 1WP, SA9 1WZ, SA9 1XB, SA9 1XD, SA9 1XN, SA9 1XP, SA9 1XR, SA9 1XS, SA9 1XT, SA9 1XW, SA9 1XX",352,212,140
W00002699,SA9,"SA9 1HY, SA9 1QS, SA9 1RA",233,176,57
W00002698,SA9,"SA9 1LF, SA9 1LP, SA9 1LR, SA9 1LS, SA9 1LT, SA9 1LU, SA9 1LX, SA9 1LY, SA9 1LZ, SA9 1NA, SA9 1NB, SA9 1ND, SA9 1NE, SA9 1NH, SA9 1NQ, SA9 1SD, SA9 2QH",262,172,90
W00002697,SA9,"SA9 1AA, SA9 1HF, SA9 1HG, SA9 1HQ, SA9 1NX, SA9 1NY, SA9 1NZ, SA9 1PH, SA9 1PL, SA9 1PN, SA9 1PP, SA9 1PQ, SA9 1PR, SA9 1PS, SA9 1PT, SA9 1PU, SA9 1PW, SA9 1PX, SA9 1PY, SA9 1QP",306,189,117
W00002696,SA9,"SA9 1HD, SA9 1HE, SA9 1HN, SA9 1JH, SA9 1JJ, SA9 1JP, SA9 1JR, SA9 1JS, SA9 1JU, SA9 1LA, SA9 1LD, SA9 1NU",233,149,84
W00002270,SA9,"SA9 1QR, SA9 1QU",159,112,47
W00003864,SA9,"SA9 2FA, SA9 2XR, SA9 2YL, SA9 2YN, SA9 2YP, SA9 2YR, SA9 2YU, SA9 2YX, SA9 2YY",239,97,142
W00003865,SA9,"SA9 2XJ, SA9 2XT, SA9 2YD, SA9 2YF, SA9 2YG, SA9 2YH, SA9 2YJ, SA9 2YQ, SA9 2YS, SA9 2YT, SA9 2YW",266,100,166
W00010383,SA9,"SA9 2BG, SA9 2BH, SA9 2BL, SA9 2BQ, SA9 2DN, SA9 2EQ, SA9 2EY",371,257,114
W00002695,SA9,"SA9 1HL, SA9 1JT, SA9 1JX, SA9 1JY, SA9 1JZ, SA9 1LE, SA9 1LG, SA9 1LH, SA9 1LN, SA9 1LQ, SA9 1LW",346,226,120
W00002690,SA9,"SA9 1AU, SA9 1BG, SA9 1BP",131,98,33
W00002701,SA9,"SA9 1QJ, SA9 1QN, SA9 1SE, SA9 1SG",252,168,84
W00005169,SA9,"SA9 2EJ, SA9 2EL, SA9 2EW, SA9 2EX",275,177,98
W00005168,SA9,"SA9 2BS, SA9 2BT, SA9 2BU, SA9 2BX, SA9 2BY, SA9 2DA, SA9 2DB, SA9 2DE, SA9 2EB, SA9 2EE, SA9 2EG, SA9 2EH, SA9 2LS, SA9 2NW",182,138,44
W00005167,SA9,"SA9 2ED, SA9 2EN, SA9 2EP, SA9 2ES, SA9 2HA, SA9 2HD, SA9 2JL",253,158,95
W00002684,SA9,"SA9 1BR, SA9 1NT, SA9 1PA, SA9 1PB, SA9 1PD, SA9 1PE",238,162,76
W00002685,SA9,"SA9 1AH, SA9 1AJ, SA9 1AN, SA9 1AS, SA9 1AW, SA9 1AX, SA9 1AY, SA9 1BA, SA9 1BB, SA9 1BD, SA9 1BQ, SA9 1BU, SA9 1QA, SA9 1QB, SA9 2HB",273,199,74
W00002686,SA9,"SA9 1BJ, SA9 1BL, SA9 1BN, SA9 1EU, SA9 1EY, SA9 1HA, SA9 1LB, SA9 1NS",265,171,94
W00002687,SA9,"SA9 1ES, SA9 1ET, SA9 1EX, SA9 1GW, SA9 1PJ",247,151,96
W00005166,SA9,"SA9 1WA, SA9 1WB, SA9 1WT, SA9 1WU, SA9 1WW, SA9 1WY, SA9 1YB, SA9 2AF, SA9 2BP, SA9 2HS, SA9 2HT, SA9 2HU, SA9 2HZ, SA9 2LD, SA9 2LL, SA9 2LN, SA9 2LP, SA9 2LR, SA9 2LW, SA9 2LZ, SA9 2NA, SA9 2UZ, SA9 2XS, SA9 2XZ, SA9 2YA, SA9 2YE, SA9 2YZ, SA9 2ZF, SA9 2ZJ, SA9 2ZL, SA9 2ZN",225,163,62
W00002688,SA9,"SA9 1AF, SA9 1AG, SA9 1AL, SA9 1AP, SA9 1AQ, SA9 1AR, SA9 1AT, SA9 1AZ, SA9 1BT, SA9 1EL, SA9 1EN, SA9 1ER, SA9 1HB, SA9 1JW, SA9 2LB",302,186,116
W00005165,SA9,"SA9 2BN, SA9 2BR, SA9 2HN, SA9 2HP, SA9 2LT, SA9 2LU, SA9 2LX, SA9 2LY, SA9 2NB, SA9 2ND, SA9 2NF",228,137,91
W00002327,SA9,"SA9 1DJ, SA9 1DL, SA9 1DN, SA9 1EB, SA9 1ED, SA9 1EE, SA9 1EZ, SA9 1FN",303,221,82
W00002328,SA9,"SA9 1BW, SA9 1DA, SA9 1DR, SA9 1DS, SA9 1DU, SA9 1DX, SA9 1DY, SA9 1DZ, SA9 1EA, SA9 1EJ",362,223,139
W00002329,SA9,"SA9 1BX, SA9 1BY, SA9 1BZ, SA9 1DB, SA9 1DD, SA9 1DE, SA9 1DF, SA9 1DG, SA9 1DH, SA9 1DQ, SA9 1EF, SA9 1EG, SA9 1EH, SA9 1EP, SA9 1EQ, SA9 1FF, SA9 1FL, SA9 2LA, SA9 2LE, SA9 2QA, SA9 2QB, SA9 2QD",372,235,137
W00002330,SA9,"SA9 1DP, SA9 1DW, SA9 2QF, SA9 2QJ, SA9 2QL, SA9 2QQ, SA9 2UT, SA9 2XE, SA9 2XW",148,97,51
W00002331,SA9,"SA9 2UR, SA9 2UU, SA9 2XB, SA9 2XD, SA9 2XF, SA9 2XG, SA9 2XL, SA9 2XN, SA9 2XP, SA9 2XQ",176,102,74
W00002332,SA9,"SA9 2PN, SA9 2PP, SA9 2TT, SA9 2TU, SA9 2TW",232,140,92
W00002333,SA9,"SA9 2TZ, SA9 2UF, SA9 2UJ, SA9 2UL, SA9 2UN, SA9 2UP, SA9 2US, SA9 2UW",156,97,59
W00002702,SA9,"SA9 1HP, SA9 1HR, SA9 1HS, SA9 1HT, SA9 1HU, SA9 1HZ",259,185,74
W00002703,SA9,"SA9 1HH, SA9 1HJ, SA9 1HW, SA9 1HX, SA9 1QL, SA9 1QQ",327,226,101
W00002691,SA9,"SA9 1AB, SA9 1AD, SA9 1AE, SA9 1FT, SA9 1FU, SA9 1FX, SA9 1FY, SA9 2JG, SA9 2JP, SA9 2JR, SA9 2JS, SA9 2JT, SA9 2JU, SA9 2JX, SA9 2JY, SA9 2JZ",241,138,103
W00002650,SA9,"SA9 1YS, SA9 1YT, SA9 1YU, SA9 1YX",303,266,37
W00004889,SA9,"SA9 2FB, SA9 2FD, SA9 2FE, SA9 2FG, SA9 2FH, SA9 2FJ, SA9 2FZ, SA9 2GH, SA9 2GN, SA9 2GT, SA9 2GX, SA9 2XH",293,115,178
W00005161,SA9,"SA9 2DY, SA9 2EA, SA9 2ER, SA9 2ET, SA9 2EU",235,129,106
W00002700,SA9,"SA9 1JA, SA9 1JB, SA9 1QW",278,242,36
W00005162,SA9,"SA9 2AH, SA9 2AJ, SA9 2AL, SA9 2AN, SA9 2AP, SA9 2AR, SA9 2NE, SA9 2NH, SA9 2NJ, SA9 2NQ",275,162,113
W00004890,SA9,"SA9 2FL, SA9 2FT, SA9 2FU, SA9 2FX, SA9 2FY, SA9 2GJ, SA9 2GL",250,118,132
W00004891,SA9,"SA9 2FN, SA9 2FP, SA9 2FR, SA9 2FS, SA9 2NP, SA9 2NR, SA9 2RA, SA9 2RB, SA9 2RD, SA9 2RE, SA9 2RF, SA9 2RH, SA9 2RJ, SA9 2RL, SA9 2RN, SA9 2RP, SA9 2RQ, SA9 2RR, SA9 2RS, SA9 2RT, SA9 2RU, SA9 2RX, SA9 2RY, SA9 2SA, SA9 2SE",308,180,128
W00004892,SA9,"SA9 2FQ, SA9 2GA, SA9 2GB, SA9 2GP, SA9 2GQ, SA9 2GR, SA9 2GS, SA9 2GU, SA9 2GW, SA9 2GY",271,107,164
W00005164,SA9,"SA9 2JB, SA9 2JD, SA9 2JE, SA9 2JH, SA9 2JJ, SA9 2JN, SA9 2JQ, SA9 2JW",252,153,99
W00004932,SA9,"SA9 2BJ, SA9 2DD, SA9 2DF, SA9 2DH, SA9 2DJ, SA9 2DL, SA9 2DQ, SA9 2DU",363,246,117
W00002689,SA9,"SA9 1BE, SA9 1BH, SA9 1BS, SA9 1DT, SA9 1GU",327,212,115
W00005163,SA9,"SA9 2AA, SA9 2AB, SA9 2AQ, SA9 2AW, SA9 2HR, SA9 2HX, SA9 2HY, SA9 2JA",277,181,96
W00002271,SA9,"SA9 1QD, SA9 1QT, SA9 1QX, SA9 1QY, SA9 1RB, SA9 1RE, SA9 1RF, SA9 1RG, SA9 1RQ",241,152,89
W00002457,SY10,"SY10 0NN, SY10 0NQ, SY21 0LG, SY21 0LH, SY21 0LJ, SY21 0LL, SY21 0LQ, SY21 0LS, SY21 0NA, SY21 0NB, SY21 0ND, SY21 0NE, SY21 0NF, SY21 0NG, SY21 0QF, SY21 0QG, SY21 0QQ, SY22 5EP, SY22 5JA, SY22 5JB, SY22 5JD, SY22 5JE, SY22 5JF, SY22 5JG, SY22 5JH, SY22 5ND, SY22 6JJ, SY22 6JL",459,242,217
W00002494,SY10,"SY10 0AF, SY10 9HZ, SY10 9JG, SY10 9JL, SY10 9JN, SY10 9JP, SY10 9JR, SY10 9JS, SY10 9JT, SY10 9JU, SY10 9JW, SY10 9JX, SY10 9JY, SY10 9JZ, SY10 9LB, SY10 9LD, SY10 9LG, SY10 9LH, SY10 9LJ, SY10 9LP, SY10 9LQ, SY10 9LT, SY10 9PA, SY22 5EY, SY22 5EZ",399,308,91
W00002495,SY10,"SY10 0AA, SY10 0BA, SY10 0DJ, SY10 0JG, SY10 0JH, SY10 0JJ, SY10 0JL, SY10 0JN, SY10 0JQ, SY10 0JW, SY10 0JX, SY10 0JY, SY10 0JZ, SY10 0LA, SY10 0LB, SY10 0LD, SY10 0LE, SY10 0LF, SY10 0LG, SY10 0LH, SY10 0LL, SY10 0LN, SY10 0LQ, SY10 0LW, SY10 0NR",430,258,172
W00002496,SY10,"SY10 0AD, SY10 0AE, SY10 0BX, SY10 0BY, SY10 0DA, SY10 0DB, SY10 0DD, SY10 0DE, SY10 0DL, SY10 0DN, SY10 0DP, SY10 0DR, SY10 0DS, SY10 0DT, SY10 0DU, SY10 0DW, SY10 0DX, SY10 0DY, SY10 0DZ, SY10 0EA, SY10 0EB, SY10 0ED, SY10 0EE, SY10 0EF, SY10 9LE, SY10 9LF",281,168,113
W00002497,SY10,"SY10 7JL, SY10 7PG, SY10 7PU, SY10 7PX, SY10 7PZ, SY10 7QA, SY10 7QB, SY10 7QD, SY10 7QE, SY10 7QG, SY10 7QQ, SY10 7QZ, SY10 9BP, SY10 9BW, SY10 9FN, SY10 9FP",306,242,64
W00002498,SY10,"SY10 7JE, SY10 7JF, SY10 7JG, SY10 7JH, SY10 7JJ, SY10 7JN, SY10 7JQ, SY10 7JW, SY10 7PS, SY10 7PT, SY10 7PY, SY10 7QF, SY10 7QH, SY10 7QJ, SY10 7QL, SY10 7QN, SY10 7QP, SY10 7QR, SY10 7QS, SY10 7QT, SY10 7QU, SY10 7QW, SY10 7QX, SY10 7QY, SY10 9LA",364,256,108
W00002499,SY10,"SY10 9LL, SY10 9LN, SY10 9LW, SY22 6UG, SY22 6UJ, SY22 6UL, SY22 6UN, SY22 6UP, SY22 6UR, SY22 6UW, SY22 6XE, SY22 6XG, SY22 6XH, SY22 6XL, SY22 6XN, SY22 6XQ, SY22 6YR, SY22 6YS, SY22 6YT",220,177,43
W00002501,SY10,"SY10 9JH, SY10 9JJ, SY10 9LR, SY22 6AL, SY22 6AX, SY22 6AY, SY22 6BA, SY22 6BB, SY22 6BD, SY22 6BQ, SY22 6SU, SY22 6TL, SY22 6TP, SY22 6TR, SY22 6TS, SY22 6TW, SY22 6TZ, SY22 6UA",305,255,50
W00002490,SY10,"SY10 0AG, SY10 0AH, SY10 0AJ, SY10 0AL, SY10 0AN, SY10 0AQ, SY10 0AT, SY10 0AU, SY10 0AX, SY10 0AY, SY10 0BE, SY10 0PE, SY22 5HA, SY22 5HB, SY22 5HD, SY22 5HE",252,156,96
W00002491,SY10,"SY10 0BG, SY10 0BJ, SY10 0BN, SY10 0BP, SY10 0BQ, SY10 0BS, SY10 0BT, SY10 0BU, SY10 0BW, SY10 0BZ, SY10 0JP, SY10 0JR, SY10 0JS, SY10 0JT, SY10 0JU, SY10 0LJ",204,127,77
W00002489,SY10,"SY10 0AB, SY10 0EP, SY10 0ER, SY10 0ES, SY10 0ET, SY10 0EU, SY10 0EW, SY10 0EX, SY10 0EY, SY10 0EZ, SY10 0HA, SY10 0HB, SY10 0HD, SY10 0HE, SY10 0HF, SY10 0HG, SY10 0HH, SY10 0HJ, SY10 0HL, SY10 0HQ",294,204,90
W00002493,SY10,"SY10 0AZ, SY10 0BH, SY10 0BL, SY10 0EL, SY10 0EN, SY10 0GH, SY10 0HN, SY10 0HP, SY10 0HR, SY10 0HS, SY10 0HU, SY10 0HW, SY10 0HX, SY10 0HY, SY10 0HZ, SY10 0NP, SY10 0NS, SY10 0NT, SY10 0NU, SY10 0NX, SY10 0NY, SY10 0NZ, SY10 0PA, SY10 0PB, SY10 0PD, SY10 0PF, SY10 0PG, SY10 0PQ, SY10 0WB, SY10 0WD, SY10 0WE, SY10 0WF, SY10 0WG",484,240,244
W00002492,SY10,"SY10 0HT, SY10 0LP, SY10 0LR, SY10 0LS, SY10 0LT, SY10 0LU, SY10 0LX, SY10 0LY, SY10 0LZ, SY10 0NA, SY10 0NB, SY10 0ND, SY10 0NE, SY10 0NF, SY10 0NG, SY10 0NH, SY10 0NJ, SY10 0NL",242,151,91
W00002461,SY10,"SY10 0AP, SY10 0AR, SY10 0AS, SY10 0AW, SY22 5EN, SY22 5ET, SY22 5EU, SY22 5EW, SY22 5EX, SY22 5HF, SY22 5HG, SY22 5HH, SY22 5HJ, SY22 5HL, SY22 5HQ, SY22 5HS, SY22 5HT, SY22 5HU, SY22 5HX, SY22 5HY, SY22 5HZ, SY22 5JQ, SY22 5LD, SY22 5LE, SY22 5LF, SY22 5LX, SY22 5NF",461,298,163
W00001857,SY13,"SY13 2JH, SY13 2JQ, SY13 3AD, SY13 3AE, SY13 3AF, SY13 3AG, SY13 3AH, SY13 3AJ, SY13 3AN, SY13 3AP, SY13 3AQ, SY13 3AR, SY13 3AS, SY13 3AT, SY13 3AW, SY13 3AY, SY13 3BH, SY13 3ET, SY13 3EU, SY13 3EX, SY13 3EY, SY13 3NZ, SY13 3PA, SY13 3PB, SY13 3PE",284,265,19
W00001856,SY13,"SY13 2JJ, SY13 2JN, SY13 3GZ, SY13 3HJ, SY13 3HN, SY13 3HQ, SY13 3HW, SY13 3JB",280,267,13
W00002143,SY13,"SY13 2JX, SY13 2JZ, SY13 3BJ, SY13 3BS, SY13 3DB, SY13 3DE, SY13 3DF, SY13 3DG, SY13 3DL, SY13 3DN, SY13 3DQ, SY13 3EG, SY13 3EH, SY13 3EJ, SY13 3EL, SY13 3EN, SY13 3EQ, SY13 3EW",255,228,27
W00001859,SY13,"SY13 2JP, SY13 2JR, SY13 2JS, SY13 2JT, SY13 2JW, SY13 3AL, SY13 3AU, SY13 3AX, SY13 3AZ, SY13 3BA, SY13 3BB, SY13 3BD, SY13 3BE, SY13 3BG, SY13 3BQ, SY13 3BT, SY13 4RE, SY14 7JT, SY14 7JU, SY14 7JZ, SY14 7LA, SY14 7LB, SY14 7LE",279,265,14
W00001858,SY13,"SY13 2JU, SY13 2PB, SY13 3EP, SY13 3ER, SY13 3EZ, SY13 3HA, SY13 3HB, SY13 3HD, SY13 3HE, SY13 3HF, SY13 3HG, SY13 3HH, SY13 3HL, SY13 3HP, SY13 3HR, SY13 3HS, SY13 3HT, SY13 3HU, SY13 3HX, SY13 3HY, SY13 3HZ, SY13 3JA, SY13 3PD, SY13 3WB, SY13 3WE",277,258,19
W00002536,SY15,"SY15 6EX, SY15 6EY, SY15 6EZ, SY15 6HA, SY15 6HB, SY15 6HD, SY15 6HE, SY15 6HF, SY15 6HG, SY15 6HH, SY15 6HJ, SY15 6HL, SY15 6HQ, SY15 6HW, SY15 6JA, SY15 6JB, SY15 6JE, SY15 6JF, SY15 6WL",306,276,30
W00002537,SY15,"SY15 6ET, SY15 6EU, SY15 6QP, SY15 6QU, SY15 6QX, SY15 6RD, SY15 6RE, SY15 6SH, SY15 6UJ, SY15 6UL, SY15 6UP, SY15 6UR",321,283,38
W00002343,SY15,"SY15 6BB, SY15 6FA, SY15 6FB, SY15 6JS, SY15 6JT, SY15 6NH, SY15 6NJ, SY15 6NT, SY15 6NU",431,376,55
W00002342,SY15,"SY15 6HR, SY15 6HS, SY15 6JU, SY15 6JZ, SY15 6LF, SY15 6LG, SY15 6LH, SY15 6LN, SY15 6LQ, SY15 6LR, SY15 6LU, SY15 6LX, SY15 6LY",330,306,24
W00002341,SY15,"SY15 6JW, SY15 6JY, SY15 6LA, SY15 6LB, SY15 6LD, SY15 6LE, SY15 6LJ, SY15 6LL, SY15 6LP, SY15 6LW, SY15 6NN, SY15 6NP, SY15 6NR, SY15 6NS",307,268,39
W00002340,SY15,"SY15 6JG, SY15 6JH, SY15 6JJ, SY15 6JL, SY15 6JP, SY15 6JQ, SY15 6JX, SY15 6NA, SY15 6ND, SY15 6NE, SY15 6NF, SY15 6NG, SY15 6NL, SY15 6NQ, SY16 3AP, SY16 3AS, SY16 3AT, SY16 3BJ",462,408,54
W00002316,SY15,"SY15 6HP, SY15 6HX, SY15 6HZ, SY15 6JD, SY15 6TD, SY15 6TE, SY15 6TF, SY15 6TG, SY15 6TH, SY15 6TJ, SY15 6TN, SY15 6TP, SY15 6TQ, SY15 6TW, SY15 6TY, SY9 5JP",297,287,10
W00002384,SY15,"SY15 6LS, SY16 4DQ, SY16 4EH, SY16 4EJ, SY16 4EL, SY16 4EN, SY16 4EP, SY16 4EQ, SY16 4ER, SY16 4ES, SY16 4ET, SY16 4EU, SY16 4EW, SY16 4EX, SY16 4EY, SY16 4EZ, SY16 4FE, SY16 4HG, SY16 4HH, SY16 4HJ, SY16 4HL, SY16 4HN, SY16 4HP, SY16 4HQ, SY16 4HR, SY16 4HS, SY16 4HW, SY16 4LP, SY16 4LR, SY16 4LZ",387,354,33
W00002315,SY15,"SY15 6AB, SY15 6AD, SY15 6AE, SY15 6AF, SY15 6AP, SY15 6AS, SY15 6DS, SY15 6SR, SY15 6SS, SY15 6ST, SY15 6SU, SY15 6SX, SY15 6TA, SY15 6TB, SY15 6TL, SY15 6UA, SY9 5JW",351,322,29
W00002314,SY15,"SY15 6AJ, SY15 6AN, SY15 6AR, SY15 6AT, SY15 6DH, SY15 6DJ, SY15 6DT, SY15 6DU, SY15 6DX, SY15 6DY, SY15 6DZ, SY15 6EA, SY15 6EB, SY15 6EF, SY15 6EG, SY15 6EH, SY15 6EJ, SY15 6EL, SY15 6EQ, SY15 6EW",356,346,10
W00002674,SY15,"SY15 6WA, SY15 6WB, SY15 6WD, SY15 6WE, SY15 6WF, SY15 6WG, SY15 6WH, SY15 6WJ, SY15 6WN, SY15 6WP, SY15 6WQ, SY15 6WR, SY15 6WS, SY15 6WT, SY15 6WX, SY15 6WY, SY15 6WZ, SY15 6YN, SY21 0WA, SY21 0WB, SY21 0WD, SY21 0WE, SY21 0WF, SY21 0WG, SY21 0WJ, SY21 0WL, SY21 0WN, SY21 0WP, SY21 0WQ, SY21 0WZ, SY21 0XA, SY21 0YR, SY21 0ZW, SY21 1AA, SY21 1AP, SY21 1AY, SY21 1AZ, SY21 1BA, SY21 1BB, SY21 1BD, SY21 1BE, SY21 1BF, SY21 1BG, SY21 1BH, SY21 1BJ, SY21 7AB, SY21 7AE, SY21 7AF, SY21 7AG, SY21 7AL, SY21 7AW, SY21 7BP, SY21 7BQ, SY21 7BU, SY21 7BX, SY21 7DD, SY21 7DE, SY21 7DG, SY21 7DQ, SY21 7FD, SY21 7JA, SY21 7LH, SY21 7TR, SY21 7TT, SY21 7UQ, SY21 7WA, SY21 7WB, SY21 7WF, SY21 7WH, SY21 7WN, SY21 7WQ, SY21 7WR, SY21 7WS, SY21 7WT, SY21 7WU, SY21 7WW, SY21 7WX, SY21 7WY, SY21 7WZ, SY21 7XA, SY21 7XE, SY21 7XF, SY21 7XY, SY21 7XZ, SY21 7ZR, SY21 7ZW, SY21 8WA, SY21 8WB, SY21 8WD, SY21 8WE, SY21 8WF, SY21 8WG, SY21 8WH, SY21 8WJ, SY21 8WL, SY21 8WN, SY21 8WP, SY21 8WQ, SY21 8WR, SY21 8WS, SY21 8WT, SY21 8WU, SY21 8WW, SY21 8WX, SY21 8WY, SY21 8WZ, SY21 8XA, SY21 8XB, SY21 8XD, SY21 8XE, SY21 8XF, SY21 8XG, SY21 8XQ, SY21 8XY, SY21 8XZ, SY21 8ZZ, SY21 9WA, SY21 9WB, SY21 9WE, SY21 9WF, SY21 9WJ, SY21 9WL, SY21 9WX, SY21 9WY, SY21 9WZ, SY21 9ZQ",257,236,21
W00002283,SY15,"SY15 6RR, SY15 6SQ, SY21 8AB, SY21 8AD, SY21 8AE, SY21 8AG, SY21 8AH, SY21 8AJ, SY21 8AL, SY21 8AQ, SY21 8BF, SY21 8BT, SY21 8BU, SY21 8PF, SY21 8PG, SY21 8PH, SY21 8PL, SY21 8PQ, SY21 8PW, SY21 8QA, SY21 8QB, SY21 8QD, SY21 8QE, SY21 8QF",337,292,45
W00002281,SY15,"SY15 6JN, SY15 6NB, SY15 6RN, SY15 6RP, SY15 6RS, SY15 6RT, SY15 6RU, SY15 6RW, SY15 6RX, SY15 6RY, SY15 6RZ, SY15 6SA, SY15 6SB, SY15 6SD, SY15 6SE, SY15 6SF, SY15 6SG, SY21 8QJ, SY21 8QQ",326,291,35
W00002317,SY15,"SY15 6AU, SY15 6DN, SY15 6DQ, SY15 6DW, SY15 6EN, SY5 0JJ, SY5 0JL, SY5 0JN",315,303,12
W00002386,SY15,"SY15 6NW, SY16 4DY, SY16 4EG, SY16 4LH, SY16 4LJ, SY16 4LL, SY16 4LN, SY16 4LS, SY16 4LT, SY16 4LU, SY16 4LW, SY16 4LX, SY16 4LY, SY16 4NA, SY16 4NB, SY16 4ND, SY16 4NE, SY16 4NF, SY16 4NG, SY16 4NH, SY16 4NQ, SY16 4PD, SY16 4PE, SY16 4PF, SY16 4PG, SY16 4PQ",391,353,38
W00002313,SY15,"SY15 6AA, SY15 6AG, SY15 6AH, SY15 6AL, SY15 6AQ, SY15 6AW, SY15 6AZ, SY15 6BA, SY15 6BF, SY15 6DL, SY15 6JR",385,367,18
W00009792,SY15,"SY15 6PA, SY15 6PB, SY15 6PH, SY15 6PJ, SY15 6PL, SY15 6PN, SY15 6PQ, SY15 6PU, SY15 6PX, SY15 6PY, SY15 6PZ, SY15 6QA, SY15 6QB, SY15 6QD, SY15 6QH, SY15 6QJ, SY15 6QL, SY15 6QN, SY15 6QW, SY15 6QZ, SY15 6RA, SY15 6RF, SY15 6RG, SY15 6RL",267,251,16
W00009794,SY15,"SY15 6ER, SY15 6HN, SY15 6PD, SY15 6PE, SY15 6PF, SY15 6PG, SY15 6PP, SY15 6PR, SY15 6PS, SY15 6PT, SY15 6PW, SY15 6RB, SY15 6RH, SY15 6RJ",257,240,17
W00009793,SY15,"SY15 6ES, SY15 6QE, SY15 6QF, SY15 6QG, SY15 6QQ, SY15 6QR, SY15 6QS, SY15 6QT, SY15 6QY, SY15 6UN",99,89,10
W00002570,SY16,"SY16 2AF, SY16 2AP, SY16 2AS, SY16 2AT, SY16 2HG, SY16 2HU, SY16 2JD, SY16 2JE, SY16 2QF",188,164,24
W00002569,SY16,"SY16 2FD, SY16 2HZ, SY16 2JA, SY16 2JB, SY16 2JF, SY16 2JG, SY16 2JH, SY16 2JJ, SY16 2JL, SY16 2JN, SY16 2JQ, SY16 2JS, SY16 2JU, SY16 2JX",367,324,43
W00002568,SY16,"SY16 2LA, SY16 2LE, SY16 2LF, SY16 2LH, SY16 2LQ, SY16 2ND, SY16 2QG, SY16 2QH, SY16 2QW",272,238,34
W00002567,SY16,"SY16 2AR, SY16 2AW, SY16 2HT, SY16 2HX, SY16 2HY, SY16 2JT, SY16 2JY, SY16 2JZ, SY16 2LB, SY16 2LD, SY16 2LG, SY16 2LJ, SY16 2PS, SY16 2PU",297,266,31
W00002388,SY16,"SY16 4EB, SY16 4NR, SY16 4NT, SY16 4NX, SY16 4PP",166,149,17
W00002566,SY16,"SY16 2PR, SY16 2PT, SY16 2QA, SY16 2QB, SY16 2QD, SY16 2QL, SY16 2QP, SY16 2WB, SY16 2WF, SY16 2WH, SY16 2WJ",265,224,41
W00002565,SY16,"SY16 2JP, SY16 2JR, SY16 2JW, SY16 2LL, SY16 2QE, SY16 2QJ, SY16 2QN, SY16 2QQ, SY16 2QR, SY16 3BB, SY16 3JX",378,340,38
W00002387,SY16,"SY16 4AA, SY16 4AD, SY16 4AE, SY16 4AG, SY16 4AH, SY16 4AJ, SY16 4AL, SY16 4AQ, SY16 4AS, SY16 4AT, SY16 4AU, SY16 4AX, SY16 4AY, SY16 4AZ, SY16 4BH, SY16 4BJ, SY16 4BL, SY16 4BN, SY16 4BS, SY16 4BW, SY16 4DG, SY16 4DN, SY16 4DP, SY16 4DS, SY16 4DT, SY16 4DU, SY16 4DW, SY16 4DX, SY16 4FA, SY16 4FB, SY16 4NZ, SY16 4PA, SY16 4PH, SY16 4PJ, SY16 4PL, SY16 4PN, SY16 4PW, SY16 4WD, SY16 4WE, SY7 8PS",399,365,34
W00002564,SY16,"SY16 2TA, SY16 2TB, SY16 2TD, SY16 2TE, SY16 2TF, SY16 2TG, SY16 2TH, SY16 2WD, SY16 2WQ, SY16 3AQ, SY16 3AU, SY16 3AW, SY16 3AX, SY16 3AY, SY16 3AZ, SY16 3BA, SY16 3BH, SY16 3FB, SY16 3JY, SY16 3LA, SY16 3LB",377,320,57
W00002563,SY16,"SY16 1AD, SY16 1BH, SY16 1BJ, SY16 1BN, SY16 1BP, SY16 1BS, SY16 1BW, SY16 1BZ, SY16 1DA, SY16 1DB, SY16 1DD, SY16 1DG, SY16 1DH, SY16 1DJ, SY16 1DL, SY16 1DN, SY16 1DP, SY16 1DR, SY16 1DS, SY16 1DT, SY16 1DU, SY16 1DW, SY16 1DX, SY16 1DY, SY16 1DZ, SY16 1NA, SY16 1YY, SY16 1YZ, SY16 3AF, SY16 3AG, SY16 3AH, SY16 3AJ, SY16 3AL, SY16 3BD, SY16 3BE, SY16 3BG, SY16 3DN, SY16 3RA, SY16 3RD, SY16 4EE",274,251,23
W00002562,SY16,"SY16 1BF, SY16 1NL, SY16 1NN",250,217,33
W00002571,SY16,"SY16 2BJ, SY16 2BL, SY16 2BP, SY16 2BS, SY16 2BT, SY16 2BU, SY16 2BW, SY16 2BX, SY16 2BY, SY16 2BZ, SY16 2DE, SY16 2DH, SY16 2DX, SY16 2FA, SY16 2HN, SY16 2HP, SY16 2HW",241,217,24
W00002573,SY16,"SY16 2DB, SY16 2DF, SY16 2DJ, SY16 2DL, SY16 2DQ, SY16 2DR, SY16 2DT, SY16 2NJ, SY16 2RA",228,201,27
W00002575,SY16,"SY16 2EA, SY16 2EB, SY16 2ED, SY16 2EE, SY16 2EF, SY16 2EG, SY16 2EL, SY16 2EN, SY16 2ER, SY16 2HS",180,154,26
W00002560,SY16,"SY16 1BY, SY16 1NB, SY16 1ND, SY16 1NE, SY16 1NF, SY16 1NG, SY16 1NH, SY16 1NJ, SY16 1NQ",241,216,25
W00002609,SY16,"SY16 3BW, SY16 3EE, SY16 3EF, SY16 3EG, SY16 3EJ, SY16 3EN, SY16 3EQ, SY16 3EU, SY16 3EX, SY16 3EY, SY16 3HA, SY16 3NZ, SY16 3PH, SY16 3PJ, SY16 3PL, SY16 3PN, SY16 3PP, SY16 3PR, SY16 3PS, SY16 3PW",476,371,105
W00002608,SY16,"SY16 3EH, SY16 3EL, SY16 3EP, SY16 3ER, SY16 3ES, SY16 3ET, SY16 3EW, SY16 3EZ, SY16 3JB, SY16 3NT, SY16 3PA, SY16 3PB, SY16 3PD, SY16 3PE, SY16 3PF, SY16 3PG, SY16 3PQ, SY16 3PT, SY16 3PU, SY16 3PY, SY16 3PZ, SY16 3QA, SY16 3QB",367,298,69
W00002607,SY16,"SY16 3BP, SY16 3BS, SY16 3NG, SY16 3NH, SY16 3NJ, SY16 3NL, SY16 3NQ, SY16 3NW, SY21 8BJ, SY21 8BL, SY21 8BN, SY21 8BP, SY21 8BS, SY21 8BW, SY21 8BX, SY21 8QU, SY21 9AY",313,248,65
W00002606,SY16,"SY16 3BF, SY16 3BQ, SY16 3BT, SY16 3BU, SY16 3BX, SY16 3BY, SY16 3BZ, SY16 3DA, SY16 3DB, SY16 3DD, SY16 3DE, SY16 3DF, SY16 3DG, SY16 3DH, SY16 3DJ, SY16 3DL, SY16 3DQ, SY16 3DW, SY16 3NN, SY16 3NP, SY16 3NR, SY16 3NS, SY16 3PX, SY21 0AB, SY21 0AE, SY21 0AF, SY21 0AG, SY21 0AH, SY21 0AJ, SY21 0AL, SY21 0AN, SY21 0AP, SY21 0AQ, SY21 0AR, SY21 0AW, SY21 0AX, SY21 0AY, SY21 0AZ, SY21 0EW",547,428,119
W00002605,SY16,"SY16 3HB, SY16 3HH, SY16 3HJ, SY16 3HL, SY16 3HN, SY16 3HT, SY16 3HU, SY16 3HW, SY16 3HX, SY16 3HY, SY16 3HZ, SY16 3JA, SY16 3JD, SY16 3JE, SY16 3JF, SY16 3JG, SY16 3JH, SY16 3JJ, SY16 3JL, SY16 3JN, SY16 3JQ, SY16 3JR, SY16 3JS, SY16 3JW, SY16 3LR, SY16 3LS, SY16 3LT, SY16 3LU, SY16 3LW",422,353,69
W00002582,SY16,"SY16 1HW, SY16 1LA, SY16 1LE, SY16 1LF, SY16 1LG, SY16 1LQ",269,233,36
W00002574,SY16,"SY16 2EJ, SY16 2EP, SY16 2EW, SY16 2EZ, SY16 2GB, SY16 2HF, SY16 2HQ, SY16 2HR",148,125,23
W00002581,SY16,"SY16 1AZ, SY16 1JE, SY16 1JR, SY16 1JS, SY16 1JT, SY16 1JU, SY16 1JX, SY16 1JY, SY16 1JZ, SY16 1LH, SY16 1LJ, SY16 1LN, SY16 4LF",295,265,30
W00002580,SY16,"SY16 1HN, SY16 1HP, SY16 1HR, SY16 1HS, SY16 1HT, SY16 1HX, SY16 1LB, SY16 1LD",275,245,30
W00002579,SY16,"SY16 1JD, SY16 1JF, SY16 1JG, SY16 1JH, SY16 1JJ, SY16 1JL, SY16 1JN, SY16 1JP, SY16 1JQ, SY16 1JW",318,267,51
W00002578,SY16,"SY16 1HU, SY16 1QH, SY16 1QQ",291,261,30
W00002577,SY16,"SY16 1EX, SY16 1HL, SY16 1QJ, SY16 4BQ, SY16 4BT, SY16 4HT, SY16 4HU, SY16 4HX, SY16 4JA, SY16 4JB, SY16 4JD, SY16 4LE, SY16 4LG",323,289,34
W00009782,SY16,"SY16 1AL, SY16 1AR, SY16 1AS, SY16 1AT, SY16 1AU, SY16 1AX, SY16 1AY, SY16 1BA, SY16 1NS, SY16 1NT, SY16 1NU, SY16 1RB, SY16 3AA",419,362,57
W00002576,SY16,"SY16 2BF, SY16 2DG, SY16 2ES, SY16 2ET, SY16 2EU, SY16 2EX, SY16 2EY, SY16 2HA, SY16 2HB, SY16 2HD, SY16 2HE, SY16 2HH, SY16 2HJ, SY16 2HL",224,198,26
W00002415,SY16,"SY16 4AF, SY16 4BP, SY16 4JL, SY16 4JN, SY16 4JP, SY16 4JR, SY16 4JS, SY16 4JT, SY16 4JU, SY16 4JW, SY16 4JX, SY16 4JY",278,241,37
W00002558,SY16,"SY16 1BE, SY16 1BL, SY16 1DF, SY16 1DQ, SY16 1LR, SY16 2AA, SY16 2AB, SY16 2AD, SY16 2AE, SY16 2AG, SY16 2BG, SY16 2LP, SY16 2LT, SY16 2PF, SY16 2PJ",148,128,20
W00002339,SY16,"SY16 3BL, SY16 3BN, SY16 3DP, SY16 3DR, SY16 3DS, SY16 3DT, SY16 3DU, SY16 3DX, SY16 3DY, SY16 3DZ, SY16 3EA, SY16 3EB, SY16 3ED, SY16 3LF, SY16 3LG, SY16 3LH, SY16 3LJ, SY16 3LL, SY16 3LN, SY16 3LQ, SY16 3WF, SY21 8QL, SY21 8QP, SY21 8QW",453,375,78
W00002553,SY16,"SY16 1EZ, SY16 1HA, SY16 1HB, SY16 1HD, SY16 1HE, SY16 1HY, SY16 1WF, SY16 1WP, SY16 1WR, SY16 1WS, SY16 1WT",277,223,54
W00002546,SY16,"SY16 1LS, SY16 1QX, SY16 1RA",258,238,20
W00002547,SY16,"SY16 1RE, SY16 1RF, SY16 1RJ, SY16 1RQ, SY16 1UZ",318,273,45
W00002548,SY16,"SY16 1HG, SY16 1HH, SY16 1HJ, SY16 1HQ, SY16 1PW, SY16 1PX, SY16 1PY, SY16 1PZ, SY16 1QA",339,284,55
W00002549,SY16,"SY16 1HF, SY16 1HZ, SY16 1LL, SY16 1PR, SY16 1PS, SY16 1PT",244,216,28
W00002550,SY16,"SY16 1AH, SY16 1LP, SY16 1QZ",335,304,31
W00002551,SY16,"SY16 1PU, SY16 1QB, SY16 1QF, SY16 1QG, SY16 1QN",275,249,26
W00002552,SY16,"SY16 1DE, SY16 1EA, SY16 1EB, SY16 1ED, SY16 1EL, SY16 1EN, SY16 1EP, SY16 1ER, SY16 1ES, SY16 1ET, SY16 1EU, SY16 1EW, SY16 1EY, SY16 1LW",233,206,27
W00002554,SY16,"SY16 1QU, SY16 1QY",254,228,26
W00002545,SY16,"SY16 1QD, SY16 1QE, SY16 1QL",372,331,41
W00002555,SY16,"SY16 1QT, SY16 1RG, SY16 1RH, SY16 1RL, SY16 1RR",293,266,27
W00002557,SY16,"SY16 1NR, SY16 3AB, SY16 3AD, SY16 3AE, SY16 3AN, SY16 4AB, SY16 4BG, SY16 4DR, SY16 4EF",115,102,13
W00010112,SY16,"SY16 2AH, SY16 2AL, SY16 3FA, SY16 3GA, SY16 3GD, SY16 3HF, SY16 3HG, SY16 3HQ, SY16 3NA, SY16 4LD",344,297,47
W00009783,SY16,"SY16 1AE, SY16 1AJ, SY16 1BB, SY16 1BX, SY16 1JA, SY16 1NP, SY16 1NW",286,240,46
W00010114,SY16,"SY16 2DN, SY16 2DP, SY16 2DS, SY16 2DU, SY16 2DW, SY16 3GB, SY16 3JU, SY16 3JZ, SY16 3LD, SY16 3LE, SY16 3LP, SY16 3LX, SY16 3LY, SY16 3LZ",259,212,47
W00002416,SY16,"SY16 4HY, SY16 4HZ, SY16 4JE, SY16 4JF, SY16 4JG, SY16 4JH, SY16 4JJ, SY16 4JQ, SY16 4JZ, SY16 4LA, SY16 4LB, SY16 4LQ, SY17 5SG",205,164,41
W00002389,SY16,"SY16 4DZ, SY16 4EA, SY16 4ED, SY16 4FD, SY16 4NY, SY16 4PB, SY16 4PR, SY16 4PS",281,261,20
W00002385,SY16,"SY16 4AP, SY16 4DA, SY16 4DB, SY16 4DD, SY16 4DE, SY16 4DF, SY16 4DH, SY16 4DL, SY16 4NJ, SY16 4NP, SY16 4NS, SY16 4NU",330,275,55
W00002308,SY16,"SY16 3HP, SY16 3HR, SY16 3HS, SY17 5HP, SY17 5HR, SY17 5HS, SY17 5HT, SY17 5HW, SY17 5JA, SY17 5JB, SY17 5JF, SY17 5JG, SY17 5JH, SY17 5JL, SY17 5JQ, SY17 5LA, SY17 5NY, SY17 5NZ, SY17 5PA, SY17 5PB, SY17 5PD, SY17 5RE, SY17 5SB, SY17 5SD, SY17 5SF",404,317,87
W00002556,SY16,"SY16 1AA, SY16 1AB, SY16 1AF, SY16 1AG, SY16 1AN, SY16 1AP, SY16 1AQ, SY16 1AW, SY16 1BD, SY16 1BG, SY16 1BQ, SY16 1BT, SY16 1BU, SY16 1EE, SY16 1EF, SY16 1EG, SY16 1EH, SY16 1EJ, SY16 1EQ, SY16 1JB, SY16 1QP, SY16 1QR, SY16 1QS, SY16 1QW, SY16 1RD, SY16 1WA, SY16 1WB, SY16 1WD, SY16 1WE, SY16 1WG, SY16 1WH, SY16 1WJ, SY16 1WL, SY16 1WN, SY16 1WQ, SY16 1WU, SY16 1WW, SY16 1WX, SY16 1WY, SY16 1WZ, SY16 1XA, SY16 1XZ, SY16 2AJ, SY16 2AN, SY16 2AQ, SY16 2AU, SY16 2AX, SY16 2AY, SY16 2AZ, SY16 2BB, SY16 2BE, SY16 2BH, SY16 2BQ, SY16 2LN, SY16 2LR, SY16 2LS, SY16 2LU, SY16 2LW, SY16 2LX, SY16 2LY, SY16 2LZ, SY16 2NA, SY16 2NB, SY16 2NE, SY16 2NF, SY16 2NG, SY16 2NH, SY16 2NL, SY16 2NN, SY16 2NP, SY16 2NQ, SY16 2NR, SY16 2NS, SY16 2NT, SY16 2NU, SY16 2NW, SY16 2NX, SY16 2NY, SY16 2NZ, SY16 2PD, SY16 2PE, SY16 2PG, SY16 2PH, SY16 2PL, SY16 2PN, SY16 2PP, SY16 2PQ, SY16 2PW, SY16 2PZ, SY16 2QZ, SY16 2UZ, SY16 2WA, SY16 2WE, SY16 2WG, SY16 2WL, SY16 2WN, SY16 2WP, SY16 2WR, SY16 2WS, SY16 2WT, SY16 2WU, SY16 2WW, SY16 2WX, SY16 2WY, SY16 2WZ, SY16 2ZZ, SY16 3WA, SY16 3WB, SY16 3WD, SY16 3WE, SY16 3WG, SY16 3WH, SY16 3WJ, SY16 3WQ, SY16 4AN, SY16 4WA, SY16 4WB, SY16 4WF, SY16 4WL, SY16 4WZ, SY16 9AF, SY16 9AJ, SY16 9AL, SY16 9AN, SY16 9AQ, SY16 9AR, SY16 9AS, SY16 9AT, SY16 9AU, SY16 9AW, SY16 9AX, SY16 9AY, SY16 9AZ, SY16 9BA, SY17 5WA, SY17 5WE, SY17 5WJ, SY17 5WL, SY17 5WN, SY17 5WP, SY17 5WX, SY17 5WY, SY17 5WZ, SY17 5ZR, SY19 7WA, SY19 7WB, SY19 7WD, SY19 7WE, SY19 7WT, SY19 7WY, SY19 7WZ, SY19 7XA",306,287,19
W00010113,SY16,"SY16 2BA, SY16 2BD, SY16 2BN, SY16 2DA, SY16 2DD, SY16 2DY, SY16 2DZ, SY16 2EH, SY16 2EQ, SY16 3AR, SY16 3HD, SY16 3HE, SY16 3JP",229,194,35
W00002412,SY17,"SY17 5AA, SY17 5AB, SY17 5AD, SY17 5AE, SY17 5AF, SY17 5AG, SY17 5AH, SY17 5AQ, SY17 5AS, SY17 5AX, SY17 5BA, SY17 5BS, SY17 5BY, SY17 5BZ, SY17 5DA, SY17 5DG, SY17 5DQ, SY17 5DW",262,223,39
W00002307,SY17,"SY17 5DT, SY17 5DY, SY17 5EF, SY17 5EJ, SY17 5EQ, SY17 5HH, SY17 5HJ, SY17 5HL, SY17 5HN, SY17 5HY, SY17 5NA",216,186,30
W00002413,SY17,"SY17 5AZ, SY17 5BB, SY17 5BD, SY17 5BE, SY17 5BG, SY18 6JP, SY18 6JR, SY18 6JS, SY18 6JT, SY18 6JU, SY18 6JX, SY18 6JY, SY18 6LJ, SY18 6LL, SY18 6LN, SY18 6LP, SY18 6LW, SY18 6LX, SY18 6QT",341,281,60
W00002414,SY17,"SY17 5AP, SY17 5AR, SY17 5AT, SY17 5AU, SY17 5BH, SY17 5BJ, SY17 5BL, SY17 5BQ, SY17 5BT, SY17 5BU, SY17 5BX, SY17 5DB, SY17 5DD, SY17 5DE, SY17 5DF, SY17 5DH, SY17 5DJ, SY17 5DL, SY17 5DN, SY17 5DR, SY17 5SE",266,229,37
W00002288,SY17,"SY17 5PJ, SY17 5PL, SY17 5PR, SY17 5PW, SY17 5QE, SY17 5QF, SY17 5QG, SY17 5QH, SY17 5QQ, SY17 5QY, SY17 5QZ, SY17 5RG, SY17 5RH, SY17 5RW",296,226,70
W00002290,SY17,"SY17 5RJ, SY17 5RL, SY17 5RN, SY17 5RP, SY17 5RQ, SY17 5RR, SY17 5RS, SY18 6NS, SY18 6NT, SY19 7BS, SY19 7BT, SY19 7BU, SY19 7BX, SY19 7BY, SY19 7BZ, SY19 7DB, SY19 7DE, SY19 7DF, SY19 7DG",238,161,77
W00002309,SY17,"SY17 5JD, SY17 5JE, SY17 5JR, SY17 5ND, SY17 5NE, SY17 5NJ, SY17 5NL, SY17 5NN, SY17 5NP, SY17 5NQ, SY17 5NR, SY17 5NS, SY17 5NW, SY17 5PQ, SY17 5QP, SY17 5QS, SY17 5WB, SY17 5WD, SY17 5WF, SY17 5WG, SY17 5WH",323,242,81
W00002310,SY17,"SY17 5AJ, SY17 5HA, SY17 5HB, SY17 5HD, SY17 5HE, SY17 5HF, SY17 5HG, SY17 5HQ, SY17 5HU, SY17 5HX, SY17 5HZ",316,275,41
W00002306,SY17,"SY17 5DS, SY17 5DU, SY17 5DX, SY17 5DZ, SY17 5EA, SY17 5EB, SY17 5ED, SY17 5EE, SY17 5EG, SY17 5EH, SY17 5EL, SY17 5EN, SY17 5EP, SY17 5ER, SY17 5ES, SY17 5ET, SY17 5EU, SY17 5EW, SY17 5EX, SY17 5EY, SY17 5EZ, SY17 5PP, SY17 5SA",238,189,49
W00002311,SY17,"SY17 5JY, SY17 5LB, SY17 5LD, SY17 5LH, SY17 5LJ, SY17 5LL, SY17 5LN, SY17 5LP, SY17 5LR, SY17 5LT, SY17 5LU, SY17 5LW, SY17 5LY, SY17 5LZ, SY17 5NB, SY17 5NG",361,228,133
W00002289,SY17,"SY17 5AY, SY17 5PE, SY17 5PH, SY17 5PN, SY17 5PS, SY17 5PT, SY17 5PU, SY17 5PX, SY17 5PY, SY17 5QR, SY17 5QT, SY17 5QU, SY17 5QX, SY17 5RF",377,294,83
W00002312,SY17,"SY17 5JP, SY17 5JS, SY17 5JT, SY17 5JU, SY17 5JX, SY17 5JZ, SY17 5LE, SY17 5LF, SY17 5LG, SY17 5LQ, SY17 5LS, SY17 5LX, SY19 7AN",356,224,132
W00002480,SY18,"SY18 6DE, SY18 6DH, SY18 6DQ, SY18 6EA, SY18 6ED, SY18 6FE, SY18 6FF, SY18 6JF, SY18 6LB, SY18 6LD",264,224,40
W00002481,SY18,"SY18 6AJ, SY18 6DU, SY18 6DX, SY18 6EJ, SY18 6EL, SY18 6EN, SY18 6ET, SY18 6EW, SY18 6EX, SY18 6PG, SY18 6RA, SY18 6RE",261,209,52
W00002479,SY18,"SY18 6DD, SY18 6DP, SY18 6DY, SY18 6ER, SY18 6ES",209,176,33
W00002478,SY18,"SY18 6HE, SY18 6HH, SY18 6HR, SY18 6HS, SY18 6HT, SY18 6HU, SY18 6HW, SY18 6HX, SY18 6HY, SY18 6HZ, SY18 6JG",239,205,34
W00002285,SY18,"SY18 6JL, SY18 6PL, SY18 6QA, SY18 6QB, SY18 6QD, SY18 6QE, SY18 6QF, SY18 6QG, SY18 6QH, SY18 6QJ, SY18 6QL, SY18 6QN, SY18 6QQ, SY18 6QX, SY18 6QY, SY18 6RB, SY18 6RF, SY18 6RG, SY18 6RH, SY18 6RJ, SY18 6RL, SY18 6RN, SY18 6RP, SY18 6RQ, SY18 6RR, SY18 6RW, SY18 6RX, SY18 6SH, SY18 6SJ, SY18 6SL, SY18 6SQ",387,335,52
W00002487,SY18,"SY18 6BJ, SY18 6BU, SY18 6BX, SY18 6BY, SY18 6BZ, SY18 6DA, SY18 6DB, SY18 6DF, SY18 6DZ, SY18 6EB, SY18 6EH, SY18 6EP, SY18 6EY, SY18 6EZ, SY18 6YS, SY18 6YU",224,198,26
W00002486,SY18,"SY18 6AF, SY18 6AG, SY18 6AH, SY18 6AL, SY18 6AN, SY18 6AP, SY18 6AQ, SY18 6AW, SY18 6BE, SY18 6BF, SY18 6BQ, SY18 6HA, SY18 6HB, SY18 6HD, SY18 6HF, SY18 6HG, SY18 6HJ, SY18 6HL, SY18 6HN, SY18 6HQ, SY18 6NB, SY18 6ND",212,180,32
W00002485,SY18,"SY18 6AX, SY18 6AY, SY18 6BB, SY18 6BD, SY18 6BS, SY18 6BT",173,144,29
W00002484,SY18,"SY18 6AR, SY18 6AS, SY18 6AT, SY18 6AU, SY18 6AZ, SY18 6BA, SY18 6FD, SY18 6HP, SY18 6JA, SY18 6JB, SY18 6JD, SY18 6JE, SY18 6JQ, SY18 6LE",311,255,56
W00002287,SY18,"SY18 6JH, SY18 6JJ, SY18 6JZ, SY18 6LA, SY18 6LG, SY18 6LH, SY18 6LQ, SY18 6LR, SY18 6LS, SY18 6LT, SY18 6LU, SY18 6NA, SY18 6NE, SY18 6NF, SY18 6NG, SY18 6NN, SY18 6NQ, SY18 6NZ, SY18 6PQ",326,273,53
W00002482,SY18,"SY18 6BG, SY18 6BP, SY18 6DJ, SY18 6DL, SY18 6DN, SY18 6DW, SY18 6FA, SY18 6FB, SY18 6YR",295,260,35
W00002284,SY18,"SY18 6PH, SY18 6PJ, SY18 6PN, SY18 6PP, SY18 6PS, SY18 6RS, SY18 6RT, SY18 6RU, SY18 6RZ, SY18 6SA, SY18 6SB, SY18 6SG, SY18 6SN, SY18 6SU, SY18 6SW, SY18 6SX, SY18 6SY, SY18 6SZ, SY18 6TA, SY18 6TB, SY18 6WF",359,300,59
W00002286,SY18,"SY18 6NH, SY18 6NJ, SY18 6NL, SY18 6NP, SY18 6NR, SY18 6NU, SY18 6NW, SY18 6NX, SY18 6NY, SY18 6PB, SY18 6PR, SY18 6PT, SY18 6PW",290,218,72
W00002483,SY18,"SY18 6DR, SY18 6DS, SY18 6DT, SY18 6EU, SY18 6YT, SY18 6ZB",260,222,38
W00002488,SY18,"SY18 6AA, SY18 6AB, SY18 6AD, SY18 6AE, SY18 6BH, SY18 6BL, SY18 6BN, SY18 6BW, SY18 6DG, SY18 6EE, SY18 6EF, SY18 6EG, SY18 6EQ, SY18 6QP, SY18 6WA, SY18 6WB, SY18 6WD, SY18 6WE, SY18 6WG, SY18 6WH, SY18 6WJ, SY18 6WU, SY18 6WW, SY18 6WX, SY18 6WY, SY18 6WZ, SY18 6XR",266,234,32
W00002411,SY19,"SY19 7AE, SY19 7AG, SY19 7AR, SY19 7AS, SY19 7AT, SY19 7AU, SY19 7BB, SY19 7BD, SY19 7BE, SY19 7BG, SY19 7BH, SY19 7BJ, SY19 7BP, SY19 7BQ, SY19 7BW, SY19 7DN, SY19 7DP, SY19 7DR, SY19 7DS, SY19 7DU, SY19 7DW, SY19 7DX, SY19 7EB",295,176,119
W00002410,SY19,"SY19 7AA, SY19 7DA, SY19 7DH, SY19 7DJ, SY19 7DQ, SY19 7DT, SY19 7DY, SY19 7DZ, SY19 7EA, SY20 9HS",280,161,119
W00002409,SY19,"SY19 7AB, SY19 7AD, SY19 7AF, SY19 7AH, SY19 7AJ, SY19 7AL, SY19 7AP, SY19 7AQ, SY19 7AW, SY19 7BA, SY19 7BL, SY19 7BN, SY19 7DD, SY19 7DL",330,189,141
W00002517,SY20,"SY20 8DE, SY20 8EP, SY20 8FB, SY20 8HE, SY20 8HG, SY20 8HQ, SY20 8HZ, SY20 8JA, SY20 8JB",297,153,144
W00002518,SY20,"SY20 8HL, SY20 8HN, SY20 8HR",318,150,168
W00002519,SY20,"SY20 0AD, SY20 0AE, SY20 0AF, SY20 0AG, SY20 0AH, SY20 0AJ, SY20 0AL, SY20 0AN, SY20 8AH, SY20 8AU, SY20 8DY, SY20 8DZ, SY20 8EA, SY20 8ED, SY20 8EE, SY20 8EG, SY20 8EN, SY20 8EQ, SY20 8ES, SY20 8ET, SY20 8EU, SY20 8EX, SY20 8FA, SY20 8HP, SY20 8JD, SY20 8JU, SY20 8PA, SY20 8PE, SY20 8TL, SY20 8UH, SY20 8UZ, SY20 8WD, SY20 8WF, SY20 8WG, SY20 8WH, SY20 8WJ, SY20 8WL, SY20 8WQ, SY20 8WR, SY20 8WS, SY20 8WT, SY20 8WW, SY20 8WX, SY20 8WY, SY20 8WZ, SY20 8XD, SY20 8XZ, SY20 8ZQ, SY20 8ZU, SY20 8ZZ, SY20 9WA, SY20 9WX, SY20 9WY, SY20 9WZ, SY20 9ZP",252,137,115
W00002523,SY20,"SY20 8AA, SY20 8AB, SY20 8AE, SY20 8AG, SY20 8AJ, SY20 8AL, SY20 8AN, SY20 8AW, SY20 8DA, SY20 8DG, SY20 8DJ, SY20 8DL, SY20 8DN, SY20 8DP, SY20 8DQ, SY20 8DT, SY20 8DU, SY20 8DW, SY20 8DX, SY20 8EL, SY20 8ER, SY20 8WA, SY20 8WB, SY20 8WE, SY20 8WN, SY20 8WP, SY20 8WU, SY20 9WF, SY20 9WH, SY20 9WJ, SY20 9WN, SY20 9WP, SY20 9ZR",235,153,82
W00002794,SY20,"SY20 8JG, SY20 8JH, SY20 8JJ, SY20 8JL, SY20 8JN, SY20 8JQ, SY20 8PN, SY20 8PP, SY20 8PR, SY20 8PT",263,151,112
W00002795,SY20,"SY20 8JP, SY20 8JR, SY20 8JS, SY20 8JW, SY20 8PU, SY20 8PW, SY20 8QB, SY20 8QD, SY20 8QE, SY24 5LB",309,158,151
W00002355,SY20,"SY20 8NA, SY20 8NB, SY20 8QG, SY20 8QH, SY20 8QQ, SY20 8QT, SY20 9AR, SY20 9AX, SY20 9AZ, SY20 9EX, SY20 9EY, SY20 9EZ, SY20 9HA, SY20 9HB, SY20 9HD, SY20 9HE, SY20 9RB, SY20 9TF, SY20 9TG, SY20 9WB, SY20 9WE, SY20 9WG",295,140,155
W00002356,SY20,"SY20 8JX, SY20 8LB, SY20 8LD, SY20 8LE, SY20 8LL, SY20 8LR, SY20 8LS, SY20 8LT, SY20 8QP, SY20 8QR, SY20 8QW, SY20 9AA, SY20 9AB, SY20 9AD, SY20 9EW, SY20 9NJ, SY20 9NL, SY20 9NN, SY20 9NT, SY20 9NU, SY20 9NX, SY20 9NY, SY20 9NZ, SY20 9PA, SY20 9PB, SY20 9PD, SY20 9PE, SY20 9PF, SY20 9PT, SY20 9PX, SY20 9PY, SY20 9PZ, SY20 9QP, SY20 9QQ",297,137,160
W00002521,SY20,"SY20 8BA, SY20 8BE, SY20 8BG, SY20 8BH, SY20 8BJ, SY20 8BN, SY20 8BP, SY20 8BQ, SY20 8BS, SY20 8BT, SY20 8BU, SY20 8BW, SY20 8BX, SY20 8BY, SY20 8BZ, SY20 8DR, SY20 8DS",213,131,82
W00002353,SY20,"SY20 8PS, SY20 8PY, SY20 8PZ, SY20 8RP, SY20 8RR, SY20 8SD, SY20 8SR, SY20 8TN, SY20 8TP, SY20 8TQ, SY20 8TR, SY20 8TS, SY20 8TT, SY20 8TU, SY20 8TW, SY20 8TX, SY20 8TY, SY20 8TZ, SY20 8UA, SY20 8UB, SY20 8UR",246,98,148
W00002354,SY20,"SY20 8DF, SY20 8NE, SY20 8NF, SY20 8NG, SY20 8NH, SY20 8NJ, SY20 8NN, SY20 8NQ, SY20 8RN, SY20 8RW, SY20 8RY, SY20 8RZ, SY20 8SA, SY20 8SB, SY20 8UJ, SY20 8UL",284,130,154
W00002520,SY20,"SY20 8AD, SY20 8EF, SY20 8HA, SY20 8HU, SY20 8HW, SY20 8HX, SY20 8HY, SY20 8XA, SY20 8XB",230,129,101
W00002516,SY20,"SY20 8AF, SY20 8AP, SY20 8AQ, SY20 8AR, SY20 8AS, SY20 8AT, SY20 8AX, SY20 8AY, SY20 8AZ, SY20 8BB, SY20 8BD, SY20 8BL, SY20 8DD, SY20 8EB, SY20 8EW, SY20 8HH, SY20 8HS, SY20 8HT, SY20 8TG",246,115,131
W00002358,SY20,"SY20 8JY, SY20 8LF, SY20 8LG, SY20 8LH, SY20 8LJ, SY20 8LN, SY20 8LP, SY20 8LQ, SY20 8LU, SY20 8LW, SY20 8LZ, SY20 8NP, SY20 8NR, SY20 8NS, SY20 8NT, SY20 8NU, SY20 8NX, SY20 8NY, SY20 8QS",313,163,150
W00002357,SY20,"SY20 8JZ, SY20 8LA, SY20 8LX, SY20 8LY, SY20 8QJ, SY20 8QL, SY20 8QN, SY20 9PL, SY20 9PN, SY20 9PP, SY20 9PR, SY20 9PS, SY20 9PU, SY20 9PW",274,148,126
W00002796,SY20,"SY20 8ND, SY20 8PD, SY20 8PG, SY20 8PH, SY20 8PJ, SY20 8PL, SY20 8PQ, SY20 8PX, SY20 8SS, SY20 8SU, SY20 8SX, SY20 8SY, SY20 8SZ, SY20 8TA, SY20 8TB, SY20 8TD, SY20 8TE, SY20 8TF",285,167,118
W00002522,SY20,"SY20 8DB, SY20 8DH, SY20 8EH, SY20 8EJ, SY20 8EY, SY20 8EZ, SY20 8HB, SY20 8HD, SY20 8HF, SY20 8HJ",301,133,168
W00000235,SY20,"SY20 8QA, SY20 9DH, SY20 9DJ, SY20 9DL, SY20 9DN, SY20 9DP, SY20 9DR, SY20 9DS, SY20 9DT, SY20 9DU, SY20 9DW, SY20 9DX, SY20 9DY, SY20 9DZ, SY20 9JJ, SY20 9JR, SY20 9JS, SY20 9JT, SY20 9JU, SY20 9JX, SY20 9JY, SY20 9JZ, SY20 9LA, SY20 9LB, SY20 9LD, SY20 9LE, SY20 9LF, SY20 9LG",328,164,164
W00000307,SY20,"SY20 9AE, SY20 9AF, SY20 9AG, SY20 9AH, SY20 9AJ, SY20 9AQ, SY20 9EE, SY20 9EF, SY20 9EL, SY20 9HN, SY20 9HP, SY20 9HR, SY20 9JD, SY20 9JF, SY20 9JG, SY20 9JH, SY20 9JQ, SY20 9LP, SY20 9LX, SY20 9NH, SY20 9QA, SY20 9QG, SY20 9QN, SY20 9QR, SY20 9ST",348,159,189
W00002352,SY20,"SY20 8NL, SY20 8NW, SY20 8NZ, SY20 8PB, SY20 8PF, SY20 8RA, SY20 8RB, SY20 8RD, SY20 8RE, SY20 8RF, SY20 8RG, SY20 8SE, SY20 8SF, SY20 8SG, SY20 8SH, SY20 8SJ, SY20 8SQ, SY20 8UN, SY20 8UP, SY20 8UW",291,95,196
W00000306,SY20,"SY20 9EJ, SY20 9EN, SY20 9EP, SY20 9HJ, SY20 9HL, SY20 9HW, SY20 9JA, SY20 9JB, SY20 9JE, SY20 9LL, SY20 9LN, SY20 9LR, SY20 9LS, SY20 9LT, SY20 9LU, SY20 9LW, SY20 9ND, SY20 9NE, SY20 9NF, SY20 9NG, SY20 9NQ, SY20 9QH, SY20 9QJ, SY20 9QL, SY20 9QW",288,136,152
W00000304,SY20,"SY20 9AS, SY20 9AT, SY20 9AU, SY20 9AY, SY20 9BE, SY20 9BG, SY20 9BH, SY20 9BJ, SY20 9BL, SY20 9BN, SY20 9BP, SY20 9BQ, SY20 9BS, SY20 9BT, SY20 9BU, SY20 9BW, SY20 9BX, SY20 9BY, SY20 9BZ, SY20 9DA, SY20 9DB, SY20 9JP, SY20 9QY, SY20 9QZ, SY20 9RA, SY20 9RD, SY20 9RE, SY20 9RF, SY20 9RG, SY20 9RH, SY20 9RQ, SY20 9RT, SY20 9RU, SY20 9RX, SY20 9RY, SY20 9RZ, SY20 9SA, SY20 9SB, SY20 9SL, SY20 9SN, SY20 9TH, SY20 9TN, SY20 9TS, SY20 9TT, SY20 9WL",337,194,143
W00000305,SY20,"SY20 9RJ, SY20 9RL, SY20 9RN, SY20 9RP, SY20 9RR, SY20 9RS, SY20 9RW, SY20 9SD, SY20 9SH, SY20 9SJ, SY20 9SP, SY20 9SR, SY20 9SS, SY20 9SU, SY20 9SW, SY20 9SX, SY20 9SY, SY20 9SZ, SY20 9TA, SY20 9TB, SY20 9TD, SY20 9TE, SY20 9TJ, SY20 9TL, SY20 9TP, SY20 9TQ, SY20 9TR, SY20 9TW, SY20 9WD",254,137,117
W00002664,SY21,"SY21 8AR, SY21 8RE, SY21 8RF, SY21 8RG, SY21 8RH, SY21 8RJ, SY21 8RN, SY21 8RP, SY21 8RQ, SY21 8RR, SY21 8RS, SY21 8RW, SY21 8SA, SY21 8SB, SY21 8SD, SY21 8SE, SY21 8SF, SY21 8SG, SY21 8SJ, SY21 8SQ, SY21 8ZA, SY21 9AB, SY21 9AD, SY21 9AE, SY21 9AF",229,211,18
W00002372,SY21,"SY21 9BT, SY21 9BU, SY21 9BX, SY21 9BY, SY21 9DA, SY21 9DB, SY21 9DD, SY21 9DE, SY21 9DF, SY21 9DG, SY21 9DQ, SY21 9ER, SY21 9JA, SY21 9JF, SY21 9JG, SY21 9NT, SY21 9NU, SY21 9NZ, SY21 9WD, SY21 9WG, SY21 9WH",227,196,31
W00002348,SY21,"SY21 8FA, SY21 8FD, SY21 8FG, SY21 8NA, SY21 8NB, SY21 8ND, SY21 8NE, SY21 8NF, SY21 8NH, SY21 8NL, SY21 8NN, SY21 8NP, SY21 8NQ, SY21 8NR, SY21 8NS, SY21 8NT, SY21 8NW, SY21 8NY, SY21 8NZ",384,351,33
W00002669,SY21,"SY21 7DH, SY21 7FA, SY21 7FB, SY21 7NT, SY21 7NU, SY21 7QU, SY21 7RA, SY21 7RB, SY21 7RD, SY21 7TP, SY21 7UL, SY21 7UN, SY21 7XG, SY21 9HW",466,412,54
W00002534,SY21,"SY21 9DN, SY21 9DP, SY21 9DR, SY21 9DW, SY22 5LL, SY22 5LN, SY22 5LP, SY22 5LR, SY22 5LT, SY22 5LU, SY22 6BN, SY22 6BP, SY22 6BW, SY22 6QN, SY22 6QW, SY22 6XT, SY22 6XU, SY22 6XY",355,294,61
W00002659,SY21,"SY21 8BY, SY21 8DA, SY21 8DB, SY21 8DE, SY21 8DF, SY21 8DH, SY21 8DQ, SY21 8EJ, SY21 8EL, SY21 8EX, SY21 8EY, SY21 8EZ",321,296,25
W00002660,SY21,"SY21 7BF, SY21 7TU, SY21 7TY, SY21 7TZ, SY21 7UB, SY21 7UD, SY21 7UF, SY21 7UG, SY21 7UH, SY21 7US, SY21 7UU, SY21 7UY, SY21 7UZ",282,251,31
W00002661,SY21,"SY21 7BZ, SY21 7SF, SY21 7SN, SY21 7SX, SY21 7TB, SY21 7TD, SY21 7TE, SY21 7TF, SY21 7XW",171,158,13
W00002439,SY21,"SY21 9LD, SY22 6NT, SY22 6NU, SY22 6PU, SY22 6QT, SY22 6RL, SY22 6RN, SY22 6RP, SY22 6RS, SY22 6RW, SY22 6RZ, SY22 6SE",305,261,44
W00002680,SY21,"SY21 7DT, SY21 7DU, SY21 7EU, SY21 7HU, SY21 7HX, SY21 7HZ, SY21 7QE, SY21 7QH, SY21 7QP, SY21 7QQ, SY21 7QR, SY21 7QS, SY21 7QW, SY21 7RG, SY21 7WE, SY21 7WG, SY21 7WJ, SY21 7WL, SY21 7WP, SY21 7YA",254,221,33
W00002662,SY21,"SY21 7AH, SY21 7AP, SY21 7AR, SY21 7AT, SY21 7AU, SY21 7BB, SY21 7BD, SY21 7DA, SY21 7DF, SY21 7SR, SY21 7SS, SY21 7ST, SY21 7SU, SY21 7SY, SY21 7SZ, SY21 7TA, SY21 7UT, SY21 7YZ",237,208,29
W00002663,SY21,"SY21 7JG, SY21 7NS, SY21 7UA, SY21 7UE, SY21 7UJ, SY21 7UR, SY21 7XD",305,265,40
W00002670,SY21,"SY21 7TS, SY21 7TW, SY21 7UP, SY21 7UW, SY21 9HL",333,281,52
W00002665,SY21,"SY21 7AA, SY21 7AD, SY21 7AJ, SY21 7AQ, SY21 7JF, SY21 7JN, SY21 7JP, SY21 7JS, SY21 7JT, SY21 7JX, SY21 7JZ, SY21 7LN, SY21 7LS, SY21 7LT, SY21 7LW, SY21 7PD, SY21 7RN, SY21 7RP, SY21 7RR, SY21 7RS, SY21 7RT, SY21 7RU, SY21 7RW, SY21 7SG, SY21 7SJ, SY21 7SL, SY21 7SP, SY21 7SQ, SY21 7UX, SY21 7WD, SY21 7XB, SY21 7YX, SY21 7YY",214,198,16
W00002671,SY21,"SY21 7TH, SY21 7TJ, SY21 7TL, SY21 7TN, SY21 7TQ, SY21 7TX",257,225,32
W00002681,SY21,"SY21 9AA, SY21 9BP, SY21 9BS, SY21 9BW, SY21 9JB, SY21 9JD, SY21 9JE, SY21 9JQ, SY21 9PG, SY21 9PQ, SY21 9QE",169,147,22
W00002349,SY21,"SY21 8HU, SY21 8HX, SY21 8JJ, SY21 8JZ, SY21 8LB, SY21 8LD, SY21 8LE, SY21 8LP, SY21 8LS, SY21 8LX, SY21 8LY, SY21 8LZ, SY21 8NG, SY21 8NU, SY21 8NX, SY21 8PA, SY21 8RU, SY21 8RX, SY21 8RY, SY21 8RZ, SY21 8TP, SY21 8TR, SY21 8TS, SY21 8TT, SY21 8TU",380,356,24
W00002532,SY21,"SY21 9DJ, SY21 9DL, SY22 6BS, SY22 6BT, SY22 6BU, SY22 6DJ, SY22 6DN, SY22 6DW, SY22 6HF, SY22 6XZ, SY22 6YA, SY22 6YB, SY22 6YD, SY22 6YE",309,258,51
W00002438,SY21,"SY21 9LA, SY21 9LB, SY21 9LE, SY21 9LF, SY21 9LG, SY21 9LH, SY22 6PZ, SY22 6QS, SY22 6QX, SY22 6RT, SY22 6RU, SY22 6RX, SY22 6RY, SY22 6TT, SY22 6TY, SY22 6WA",421,369,52
W00002672,SY21,"SY21 7EJ, SY21 7HP, SY21 7HR, SY21 7HS, SY21 7HT, SY21 7HW, SY21 7JB, SY21 7QT, SY21 7QX, SY21 7QY, SY21 7QZ, SY21 7RE, SY21 7RF, SY21 7SW",259,238,21
W00002679,SY21,"SY21 7JD, SY21 7JJ, SY21 7JW, SY21 7JY, SY21 7LB, SY21 7NB, SY21 7ND, SY21 7PA, SY21 7PB",134,123,11
W00002675,SY21,"SY21 7LA, SY21 7LD, SY21 7LF, SY21 7LG, SY21 7LU, SY21 7LX, SY21 7LY, SY21 7NA, SY21 7NE, SY21 7NN, SY21 7NP, SY21 7NR, SY21 7NW",217,190,27
W00002677,SY21,"SY21 7DL, SY21 7DN, SY21 7DP, SY21 7DS, SY21 7JE, SY21 7JH, SY21 7JL, SY21 7JQ, SY21 7JR, SY21 7JU, SY21 7LE, SY21 7LJ, SY21 7LL, SY21 7LP, SY21 7LQ, SY21 7LR, SY21 7NJ, SY21 7PE, SY21 7PF, SY21 7PG, SY21 7PQ, SY21 7RX, SY21 7RY, SY21 7RZ, SY21 7SA, SY21 7SB, SY21 7SD, SY21 7SE, SY21 7SH, SY21 7YB, SY21 7YD",243,223,20
W00002459,SY21,"SY21 0JY, SY21 0JZ, SY21 0LA, SY21 0LB, SY21 0LE, SY21 0LF, SY21 0LT, SY22 6HX, SY22 6JA, SY22 6JB, SY22 6JD, SY22 6JE, SY22 6JF, SY22 6JH, SY22 6JP, SY22 6JQ, SY22 6JR, SY22 6JT",235,163,72
W00002456,SY21,"SY21 0BB, SY21 0BD, SY21 0BE, SY21 0BF, SY21 0BS, SY21 0BT, SY21 0BU, SY21 0BY, SY21 0DX, SY21 0DY, SY21 0SQ",386,264,122
W00002371,SY21,"SY21 9LX, SY21 9LY, SY21 9LZ, SY21 9NA, SY21 9NB, SY21 9PA, SY21 9PB",268,238,30
W00002370,SY21,"SY21 9PJ, SY21 9PL, SY21 9PN, SY21 9PP, SY21 9QD, SY21 9ZZ",215,184,31
W00002682,SY21,"SY21 7GY, SY21 7QF, SY21 7QG, SY21 7QJ, SY21 7QL, SY21 7RL, SY21 7TG",354,309,45
W00002273,SY21,"SY21 0NP, SY21 0NR, SY21 0NU, SY21 0NX, SY21 0NY, SY21 0NZ, SY21 0PB, SY21 0PJ, SY21 0PL, SY21 0PN, SY21 0PP, SY21 0PR, SY21 0PS, SY21 0PT, SY21 0PW, SY21 0PY, SY21 0PZ, SY21 0QA, SY21 0QJ",248,139,109
W00002656,SY21,"SY21 8DD, SY21 8DG, SY21 8DJ, SY21 8DR, SY21 8DS, SY21 8DU, SY21 8DW, SY21 8EA, SY21 8EB, SY21 8EF, SY21 8EG, SY21 8EH, SY21 8EN, SY21 8EQ, SY21 8ES, SY21 8ET, SY21 8EU, SY21 8SY, SY21 8TB, SY21 8TD",476,431,45
W00002657,SY21,"SY21 8DP, SY21 8DT, SY21 8DX, SY21 8DY, SY21 8DZ, SY21 8ED, SY21 8EE, SY21 8SZ, SY21 8TA",266,241,25
W00002658,SY21,"SY21 8HA, SY21 8HB, SY21 8HD, SY21 8HE, SY21 8HF, SY21 8HG, SY21 8JB, SY21 8JD, SY21 8JE, SY21 8JF, SY21 8SS, SY21 8ST, SY21 8SU, SY21 8SX, SY21 8TE, SY21 8TF, SY5 9SB",276,255,21
W00002366,SY21,"SY21 8RL, SY21 9AG, SY21 9AL, SY21 9AN, SY21 9AP, SY21 9AQ, SY21 9AR, SY21 9AT, SY21 9AW, SY21 9BF, SY21 9BH, SY21 9BQ, SY21 9DX",222,192,30
W00002367,SY21,"SY21 9ND, SY21 9NE, SY21 9NF, SY21 9NG, SY21 9NH, SY21 9NJ, SY21 9NL, SY21 9NN, SY21 9NP, SY21 9NR, SY21 9NS, SY21 9NW, SY21 9PD, SY21 9PF",316,286,30
W00002368,SY21,"SY21 9BL, SY21 9NQ, SY21 9PE, SY21 9PR, SY21 9PT, SY21 9PU, SY21 9PW, SY21 9PX, SY21 9QA, SY21 9QB",330,298,32
W00002676,SY21,"SY21 7NF, SY21 7NG, SY21 7NH, SY21 7NL, SY21 7NQ, SY21 7NX, SY21 7NZ, SY21 7PN, SY21 9BN, SY21 9HJ, SY21 9HZ",273,251,22
W00002455,SY21,"SY21 0BJ, SY21 0BL, SY21 0BP, SY21 0BW, SY21 0BZ, SY21 0DA, SY21 0DB, SY21 0DD, SY21 0DE, SY21 0DF, SY21 0ED, SY21 0EE, SY21 0HF, SY21 0HN, SY21 0HP, SY21 0HS, SY21 0HT, SY21 0HU, SY21 0HX, SY21 0HY, SY21 0JR, SY21 0JU, SY21 0JX, SY21 0LN, SY21 0LP, SY21 0LR, SY21 0LW, SY21 0SG, SY21 9ED, SY21 9EZ, SY21 9HA, SY21 9HB, SY21 9HD, SY21 9HE",353,216,137
W00002369,SY21,"SY21 9BZ, SY21 9DH, SY21 9DS, SY21 9DT, SY21 9DU, SY21 9FB, SY21 9LJ, SY21 9LL, SY21 9LN, SY21 9LP, SY21 9LQ, SY21 9LW, SY21 9NX, SY21 9NY, SY21 9PS, SY21 9PY, SY21 9PZ, SY22 6QP",247,212,35
W00002274,SY21,"SY21 0AU, SY21 0GA, SY21 0NH, SY21 0NJ, SY21 0NL, SY21 0NN, SY21 0NQ, SY21 0NS, SY21 0NT, SY21 0NW, SY21 0PA, SY21 0PD, SY21 0PE, SY21 0PU, SY21 0PX, SY21 0QB, SY21 0QD, SY21 0QE, SY21 0QH, SY21 0QL",387,209,178
W00002282,SY21,"SY21 8AS, SY21 8AT, SY21 8AU, SY21 8AX, SY21 8AY, SY21 8BD, SY21 8BE, SY21 8BG, SY21 8BH, SY21 8BQ, SY21 8PP, SY21 8PR, SY21 8PS, SY21 8QG, SY21 8QH, SY21 8QN, SY21 8QR, SY21 8QS, SY21 8QT, SY21 8QX, SY21 8QY, SY21 9AU",353,296,57
W00002365,SY21,"SY21 9AH, SY21 9AJ, SY21 9AS, SY21 9AX, SY21 9AZ, SY21 9BA, SY21 9BB, SY21 9BD, SY21 9BE, SY21 9BG, SY21 9BJ, SY21 9DY, SY21 9DZ, SY21 9EE, SY21 9EF, SY21 9EG, SY21 9EP, SY21 9EQ, SY21 9ES, SY21 9ET, SY21 9EU, SY21 9EW, SY21 9EX, SY21 9EY",375,304,71
W00002280,SY21,"SY21 8AA, SY21 8AF, SY21 8AN, SY21 8AP, SY21 8AW, SY21 8AZ, SY21 8BA, SY21 8BB, SY21 8FB, SY21 8PD, SY21 8PE, SY21 8PJ, SY21 8PN, SY21 8SH",283,247,36
W00002666,SY21,"SY21 7DR, SY21 7DX, SY21 7DY, SY21 7DZ, SY21 7EA, SY21 7EB, SY21 7ED, SY21 7EE, SY21 7EF, SY21 7EG, SY21 7EH, SY21 7EL, SY21 7EN, SY21 7EP, SY21 7ER, SY21 7EW, SY21 7EY, SY21 7HA, SY21 7HY",302,268,34
W00002454,SY21,"SY21 0BN, SY21 0HR, SY21 0QP, SY21 0QR, SY21 0QS, SY21 0QT, SY21 0QU, SY21 0QX, SY21 0QY, SY21 0QZ, SY21 0RA, SY21 0RB, SY21 0RD, SY21 0RE, SY21 0RF, SY21 0RG, SY21 0RH, SY21 0RL, SY21 0RN, SY21 0RP, SY21 0RQ, SY21 0RW, SY21 0RY, SY21 0SB, SY21 0SD, SY21 0SE",293,211,82
W00002453,SY21,"SY21 0AT, SY21 0BG, SY21 0BH, SY21 0HL, SY21 0HW, SY21 0RJ, SY21 0RR, SY21 0RS, SY21 0RT, SY21 0RU, SY21 0RX, SY21 0RZ, SY21 0SA, SY21 0SF, SY21 9EA, SY21 9EB",261,171,90
W00002452,SY21,"SY21 0AA, SY21 0AD, SY21 0BA, SY21 0BX, SY21 0DG, SY21 0DH, SY21 0DJ, SY21 0DL, SY21 0DN, SY21 0DP, SY21 0DQ, SY21 0DR, SY21 0DS, SY21 0DT, SY21 0DU, SY21 0DW, SY21 0EB, SY21 0EF, SY21 0EY, SY21 0EZ, SY21 0HA, SY21 0HB, SY21 0HD, SY21 0HE, SY21 0WH",373,234,139
W00002667,SY21,"SY21 7AN, SY21 7AS, SY21 7AX, SY21 7AY, SY21 7AZ, SY21 7BA, SY21 7BE, SY21 7BG, SY21 7BH, SY21 7BJ, SY21 7BL, SY21 7BN, SY21 7BW, SY21 7BY, SY21 7DJ, SY21 7HE, SY21 7HF, SY21 7YE, SY21 8FJ, SY21 9HN",391,347,44
W00002668,SY21,"SY21 8SL, SY21 8SR, SY21 9HP, SY21 9HR, SY21 9HS, SY21 9HT, SY21 9HU, SY21 9HX, SY21 9HY, SY21 9JH, SY21 9JP, SY21 9JR, SY21 9JS, SY21 9JT, SY21 9JU, SY21 9JX, SY21 9JY, SY21 9JZ, SY21 9PH",281,253,28
W00002351,SY21,"SY21 8LF, SY21 8LG, SY21 8LH, SY21 8LQ, SY21 8LR, SY21 8LT, SY21 8LU, SY21 8NJ, SY21 8PT",376,320,56
W00002350,SY21,"SY21 8GA, SY21 8HH, SY21 8HJ, SY21 8HL, SY21 8HN, SY21 8HP, SY21 8HQ, SY21 8HR, SY21 8HS, SY21 8HT, SY21 8HW, SY21 8HY, SY21 8HZ, SY21 8JA, SY21 8JG, SY21 8JH, SY21 8LA, SY21 8LJ, SY21 8LL, SY21 8LN, SY21 8LW, SY21 8RT",355,330,25
W00002683,SY21,"SY21 7LZ, SY21 7NY, SY21 7PZ, SY21 7QA, SY21 7QB, SY21 7QD, SY21 7QN",214,184,30
W00002458,SY21,"SY21 0JS, SY21 0JT, SY21 0LD, SY21 9EH, SY21 9EJ, SY21 9EL, SY21 9EN, SY21 9HF, SY22 6HR, SY22 6HS, SY22 6HT, SY22 6HY, SY22 6HZ, SY22 6JN, SY22 6JS, SY22 6JW",330,239,91
W00002275,SY21,"SY21 0AS, SY21 0EA, SY21 0EG, SY21 0EH, SY21 0EJ, SY21 0EL, SY21 0EN, SY21 0EP, SY21 0EQ, SY21 0ER, SY21 0ES, SY21 0ET, SY21 0EU, SY21 0EX, SY21 0HG, SY21 0HZ, SY21 0JA, SY21 0JB, SY21 0JD, SY21 0JE, SY21 0JF, SY21 0JG, SY21 0JH, SY21 0JJ, SY21 0JQ",426,213,213
W00002678,SY21,"SY21 7GZ, SY21 7PH, SY21 7PJ, SY21 7PL, SY21 7PP, SY21 7PR, SY21 7PS, SY21 7PT, SY21 7PU, SY21 7PW, SY21 7PX, SY21 7PY, SY21 7RH, SY21 7RJ, SY21 7RQ",297,250,47
W00002673,SY21,"SY21 7BS, SY21 7BT, SY21 7DB, SY21 7DW, SY21 7EQ, SY21 7ES, SY21 7ET, SY21 7EX, SY21 7EZ, SY21 7HB, SY21 7HD, SY21 7HG, SY21 7HH, SY21 7HJ, SY21 7HL, SY21 7HN, SY21 7HQ",307,268,39
W00002445,SY22,"SY22 6PG, SY22 6PH, SY22 6PL, SY22 6PN, SY22 6PP, SY22 6PQ, SY22 6PR, SY22 6PS, SY22 6PW, SY22 6QU, SY22 6QZ, SY22 6RA, SY22 6RE, SY22 6TX",378,338,40
W00002531,SY22,"SY22 5LH, SY22 5LJ, SY22 5LS, SY22 5LY, SY22 5LZ, SY22 5NA, SY22 5NB, SY22 5NE, SY22 6DB, SY22 6DH, SY22 6DL, SY22 6DP, SY22 6DR, SY22 6DS, SY22 6DT, SY22 6HL, SY22 6HN, SY22 6HP, SY22 6HU, SY22 6HW, SY22 6JG, SY22 6YG",328,241,87
W00002500,SY22,"SY22 5LG, SY22 5LQ, SY22 6UB, SY22 6UD, SY22 6UE, SY22 6UF, SY22 6UH, SY22 6UQ, SY22 6UT, SY22 6UU, SY22 6UX, SY22 6UY, SY22 6UZ, SY22 6WD, SY22 6XA, SY22 6XB, SY22 6XD, SY22 6XF, SY22 6XJ",254,209,45
W00009786,SY22,"SY22 5BG, SY22 5BH, SY22 5BJ, SY22 5BL, SY22 5BZ, SY22 5DA, SY22 5DE, SY22 5DF, SY22 5DH, SY22 5JZ, SY22 5LA",322,228,94
W00002444,SY22,"SY22 6LP, SY22 6LT, SY22 6ND, SY22 6NG, SY22 6NX, SY22 6NY, SY22 6NZ, SY22 6RB, SY22 6RD, SY22 6RF, SY22 6RG, SY22 6RH, SY22 6RJ, SY22 6RQ, SY22 6SH, SY22 6SJ, SY22 6SL, SY22 6SN, SY22 6SR, SY22 6ST, SY22 6SW",482,431,51
W00002446,SY22,"SY22 6NA, SY22 6NB, SY22 6NE, SY22 6NF, SY22 6NH, SY22 6NJ, SY22 6NL, SY22 6NN, SY22 6NP, SY22 6NQ, SY22 6NR, SY22 6NS",276,237,39
W00002504,SY22,"SY22 5LW, SY22 6AZ, SY22 6DG, SY22 6LR, SY22 6LS, SY22 6QQ, SY22 6SY, SY22 6SZ, SY22 6TA, SY22 6TB, SY22 6TD, SY22 6TE, SY22 6TF, SY22 6TG, SY22 6TH, SY22 6TJ, SY22 6TQ, SY22 6WF, SY22 6WG, SY22 6XP, SY22 6XS, SY22 6XX",373,311,62
W00009785,SY22,"SY22 5AS, SY22 5AU, SY22 5AX, SY22 5AY, SY22 5BF, SY22 5BQ, SY22 5DD, SY22 5DJ, SY22 5DN, SY22 5DP, SY22 5DQ, SY22 5ER, SY22 5ES, SY22 5LB",417,269,148
W00002441,SY22,"SY22 6GA, SY22 6PT, SY22 6PX, SY22 6PY, SY22 6QA, SY22 6QB, SY22 6QD, SY22 6QE, SY22 6QF, SY22 6QG, SY22 6QH, SY22 6QJ, SY22 6QL, SY22 6QR, SY22 6SP",332,289,43
W00009784,SY22,"SY22 5AA, SY22 5AB, SY22 5AD, SY22 5AE, SY22 5AF, SY22 5BN, SY22 5BP, SY22 5BS, SY22 5BW, SY22 5BY, SY22 5DL",152,110,42
W00002440,SY22,"SY22 6RR, SY22 6SA, SY22 6SB, SY22 6SD, SY22 6SF, SY22 6SG, SY22 6SQ, SY22 6SS, SY22 6TU, SY22 6US",363,327,36
W00002443,SY22,"SY22 6EN, SY22 6EP, SY22 6ER, SY22 6ES, SY22 6ET, SY22 6EU, SY22 6EW, SY22 6EX, SY22 6EY, SY22 6FA, SY22 6FD, SY22 6HE",360,317,43
W00002502,SY22,"SY22 6AA, SY22 6AB, SY22 6AD, SY22 6AE, SY22 6AR, SY22 6AS, SY22 6AT, SY22 6AU, SY22 6BF, SY22 6BJ, SY22 6DZ, SY22 6FB, SY22 6FF, SY22 6FH, SY22 6SX, SY22 6XR",490,416,74
W00002503,SY22,"SY22 6AF, SY22 6AG, SY22 6AH, SY22 6AJ, SY22 6AN, SY22 6AP, SY22 6AQ, SY22 6AW, SY22 6BE, SY22 6BG, SY22 6BH, SY22 6BL",305,239,66
W00002533,SY22,"SY22 6BX, SY22 6BY, SY22 6BZ, SY22 6DA, SY22 6DD, SY22 6DE, SY22 6DF, SY22 6DQ, SY22 6DU, SY22 6DX, SY22 6DY, SY22 6YF",336,254,82
W00002463,SY22,"SY22 5AG, SY22 5AH, SY22 5AJ, SY22 5AL, SY22 5AN, SY22 5AP, SY22 5AQ, SY22 5AR, SY22 5AT, SY22 5AW, SY22 5AZ, SY22 5BA, SY22 5BB, SY22 5BD, SY22 5BE, SY22 5BT, SY22 5BU, SY22 5BX, SY22 5DB, SY22 5DG, SY22 5DR, SY22 5DS, SY22 5WA, SY22 5WB, SY22 5WP, SY22 5WZ",197,157,40
W00002442,SY22,"SY22 6EZ, SY22 6HA, SY22 6JY, SY22 6JZ, SY22 6LA, SY22 6LB, SY22 6LD, SY22 6LE, SY22 6LF, SY22 6LH, SY22 6LJ, SY22 6PA, SY22 6PB, SY22 6PD, SY22 6PE, SY22 6PF, SY22 6PJ",318,292,26
W00002939,SY23,"SY23 3EF, SY23 3EG, SY23 3ER, SY23 3ES, SY23 3FA, SY23 3HD, SY23 3HQ, SY23 3TY",422,215,207
W00002940,SY23,"SY23 3EL, SY23 3EP, SY23 3EQ, SY23 3EW, SY23 3HE, SY23 3NJ, SY23 3TB, SY23 3TW, SY23 3XH, SY23 3XL, SY23 3XP",392,158,234
W00002743,SY23,"SY23 1EB, SY23 1JA, SY23 1JE, SY23 1PX, SY23 1QB, SY23 1QE, SY23 1QF, SY23 1QG, SY23 1QQ",292,220,72
W00002938,SY23,"SY23 3EH, SY23 3EJ, SY23 3EN, SY23 3GZ, SY23 3HF, SY23 3HG, SY23 3SW, SY23 3TR",523,227,296
W00002955,SY23,"SY23 4EH, SY23 4EQ, SY23 4JT, SY23 4JU, SY23 4JX, SY23 4JY, SY23 4JZ, SY23 4LA, SY23 4LB, SY23 4LD, SY23 4LF, SY23 4LY, SY23 4LZ, SY23 4NA, SY23 4NB, SY23 4ND",288,103,185
W00002950,SY23,"SY23 4AL, SY23 4LP, SY23 4NR, SY23 4NS, SY23 4PA, SY23 4PD, SY23 4PF, SY23 4PG, SY23 4QT, SY23 4SB, SY23 4SD, SY23 4SE, SY23 4SF, SY23 4SG, SY23 4SJ, SY23 4SQ, SY23 4ST, SY23 4WG, SY23 4WJ",357,139,218
W00010681,SY23,"SY23 3FH, SY23 3FJ, SY23 3FN, SY23 3FP, SY23 3FQ, SY23 3FR, SY23 3FW, SY23 3PP, SY23 3PW, SY23 3PY, SY23 3PZ, SY23 3QA, SY23 3QB, SY23 3QD, SY23 3QH, SY23 3TE, SY23 3TG",1806,1591,215
W00002736,SY23,"SY23 1ED, SY23 1EE, SY23 1EF, SY23 1ES, SY23 1ET, SY23 1EU, SY23 1EW, SY23 1EX, SY23 1EY, SY23 1HA, SY23 1HB, SY23 1HJ, SY23 2JZ, SY23 3BU, SY23 3DJ, SY23 3HH",376,194,182
W00002737,SY23,"SY23 1EJ, SY23 1LU, SY23 1LZ, SY23 1NA, SY23 1NB, SY23 1NJ",269,159,110
W00002738,SY23,"SY23 1EH, SY23 1EZ, SY23 1LB, SY23 1LR, SY23 1LT, SY23 1LW, SY23 1LX, SY23 1LY, SY23 1ND, SY23 1NE, SY23 1NF, SY23 1NG, SY23 1NH, SY23 1NN, SY23 1NQ, SY23 2JP, SY23 2JS, SY23 2JT, SY23 2JU, SY23 2JW, SY23 2JX, SY23 2NP, SY23 3FS, SY23 3FT",256,180,76
W00002951,SY23,"SY23 4AH, SY23 4AN, SY23 4NJ, SY23 4NU, SY23 4NX, SY23 4NZ, SY23 4PB, SY23 4PE, SY23 4PS, SY23 4PW, SY23 4QR, SY23 4SA",329,133,196
W00002952,SY23,"SY23 4ES, SY23 4ET, SY23 4EU, SY23 4NL, SY23 4NP, SY23 4NT, SY23 4NW, SY23 4NY, SY23 4PH, SY23 4PJ, SY23 4PL, SY23 4PN, SY23 4PQ, SY23 5AP",383,155,228
W00002953,SY23,"SY23 4AP, SY23 4AR, SY23 4AS, SY23 4AZ, SY23 4BB, SY23 4BN, SY23 4LE, SY23 4LG, SY23 4LH, SY23 4LJ, SY23 4LL, SY23 4LN, SY23 4LQ, SY23 4RR, SY23 4RS",257,119,138
W00002739,SY23,"SY23 1AA, SY23 1AD, SY23 1DE, SY23 1DG, SY23 1DH, SY23 1DJ, SY23 1DQ, SY23 1HP, SY23 1HS, SY23 1HX, SY23 1NT, SY23 1PS, SY23 1PU, SY23 1QH, SY23 1WA, SY23 1WB, SY23 1WE, SY23 1WF, SY23 1WL, SY23 1WN, SY23 1WP, SY23 1WQ, SY23 1WR, SY23 1WS, SY23 1WU, SY23 1XB, SY23 1XF, SY23 1XH, SY23 1XT, SY23 1XZ, SY23 1YQ, SY23 1YS, SY23 1ZE, SY23 1ZQ, SY23 2AA, SY23 2JH, SY23 2LE, SY23 2NE, SY23 2UZ, SY23 2WD, SY23 2WE, SY23 2WF, SY23 2WG, SY23 2WH, SY23 2WJ, SY23 2WL, SY23 2WN, SY23 2WP, SY23 2WQ, SY23 2WT, SY23 2XE, SY23 2XF, SY23 2XT, SY23 2XY, SY23 2ZZ, SY23 3WA, SY23 3WE, SY23 3WF, SY23 3WJ, SY23 3WL, SY23 3WN, SY23 3WP, SY23 3WQ, SY23 3WR, SY23 3WS, SY23 3WT, SY23 3WU, SY23 3WW, SY23 3WX, SY23 3XA, SY23 3XB, SY23 3XD, SY23 3XF, SY23 3XG, SY23 3XJ, SY23 3XN, SY23 3XQ, SY23 3XR, SY23 3XS, SY23 3XU, SY23 3XX, SY23 3XZ, SY23 3YL, SY23 3ZF, SY23 3ZP, SY23 3ZQ, SY23 3ZR, SY23 3ZS, SY23 3ZT, SY23 3ZU, SY23 3ZW, SY23 4WA, SY23 4WD, SY23 4WE, SY23 4WF, SY23 4WH, SY23 4WL, SY23 4WN, SY23 4WP, SY23 4WQ, SY23 4WR, SY23 4WS, SY23 4WT, SY23 4WZ, SY23 4ZZ, SY23 5WB, SY23 5WE, SY23 5WF, SY23 5WG, SY23 5WZ, SY23 5ZZ, SY24 5WA, SY24 5WB, SY24 5WG, SY24 5WN, SY24 5WP, SY24 5WS, SY24 5WW, SY24 5WX, SY24 5WY, SY24 5WZ",271,207,64
W00002740,SY23,"SY23 1NP, SY23 2AB, SY23 2AE, SY23 2AJ, SY23 2AQ, SY23 2BJ, SY23 2BT, SY23 2BU, SY23 2DT, SY23 2DU, SY23 2DZ, SY23 2HL, SY23 2JJ, SY23 2JL, SY23 2ND, SY23 2NL, SY23 2NR",267,205,62
W00002741,SY23,"SY23 1LA, SY23 1LG, SY23 1NY, SY23 1NZ, SY23 2BZ, SY23 2JN, SY23 2NH",241,179,62
W00002954,SY23,"SY23 4AT, SY23 4AU, SY23 4AX, SY23 4AY, SY23 4BA, SY23 4BD, SY23 4BE, SY23 4BG, SY23 4BH, SY23 4BJ, SY23 4BQ, SY23 4HS, SY23 4HT, SY23 4RW",343,189,154
W00002937,SY23,"SY23 3ET, SY23 3EU, SY23 3EX, SY23 3EZ, SY23 3HA, SY23 3HB, SY23 3JD",190,111,79
W00002742,SY23,"SY23 1DL, SY23 1EA, SY23 2AN, SY23 2AR, SY23 2AS, SY23 2AW, SY23 2AZ, SY23 2BA, SY23 2BB, SY23 2BD, SY23 2BE, SY23 2BG, SY23 2BL, SY23 2BS, SY23 2BW, SY23 2DF, SY23 2DR, SY23 2LR, SY23 2LS, SY23 2LU",313,273,40
W00002931,SY23,"SY23 3DN, SY23 3DP, SY23 3DR, SY23 3DW, SY23 3PH, SY24 5NT",174,81,93
W00002765,SY23,"SY23 1HZ, SY23 1PE, SY23 1PF, SY23 1PJ, SY23 1PL, SY23 1PN, SY23 1PR, SY23 1PW",229,162,67
W00002766,SY23,"SY23 1JN, SY23 1JR, SY23 1JT, SY23 1JU, SY23 1JW, SY23 1JX",276,208,68
W00002767,SY23,"SY23 1BA, SY23 1BB, SY23 1BE, SY23 1BG, SY23 1BQ, SY23 1BX, SY23 1BY, SY23 1BZ",210,140,70
W00002768,SY23,"SY23 1DB, SY23 1DD, SY23 1DF",125,80,45
W00002769,SY23,"SY23 1AS, SY23 1BJ, SY23 1BL, SY23 1JY",144,101,43
W00002770,SY23,"SY23 1AT, SY23 1BH, SY23 1BN, SY23 1BP, SY23 1BS, SY23 1BT, SY23 1BU, SY23 1BW, SY23 1DA, SY23 1DR, SY23 1PG, SY23 1PH, SY23 1TH, SY23 1UY, SY23 1UZ, SY23 1WG, SY23 1WJ, SY23 1XD, SY23 1XE, SY23 1XG",283,176,107
W00002771,SY23,"SY23 1DN, SY23 1DP, SY23 1DT, SY23 1DU, SY23 1DW, SY23 1DY, SY23 1DZ, SY23 1JS, SY23 1PY, SY23 2AT, SY23 2AU, SY23 2AY, SY23 2BH, SY23 2BQ, SY23 2LJ, SY23 2LL, SY23 2LN, SY23 2LT",370,289,81
W00010659,SY23,"SY23 3PR, SY23 3PS",149,77,72
W00002805,SY23,"SY23 3PT, SY23 3PU, SY23 3PX, SY23 3QE",254,134,120
W00002806,SY23,"SY23 3AY, SY23 3NH, SY23 3QJ, SY23 3QQ, SY23 3TP, SY23 3TS",331,169,162
W00002807,SY23,"SY23 3AW, SY23 3AZ, SY23 3BA, SY23 3BB, SY23 3PN, SY23 3QF",259,143,116
W00002808,SY23,"SY23 3AX, SY23 3BD, SY23 3BE, SY23 3BG, SY23 3HN, SY23 3HP, SY23 3HR, SY23 3HS, SY23 3HT, SY23 3TA, SY23 3UB",365,199,166
W00002809,SY23,"SY23 3BH, SY23 3BJ, SY23 3BL, SY23 3BN, SY23 3BQ, SY23 3BW",266,166,100
W00010052,SY23,"SY23 2BN, SY23 2DG, SY23 2DJ, SY23 2DP, SY23 2DQ, SY23 2EG, SY23 2HQ, SY23 2HT",361,313,48
W00010054,SY23,"SY23 1EP, SY23 1ER, SY23 2LA, SY23 2LB, SY23 3AJ, SY23 3BF, SY23 3BX, SY23 3BY, SY23 3BZ, SY23 3DA, SY23 3DB, SY23 3DD, SY23 3DE, SY23 3DY, SY23 3DZ, SY23 3FB, SY23 3FG, SY23 3FL, SY23 3GH, SY23 3LG, SY23 3UF, SY23 3UG, SY23 3UU, SY23 3UW, SY23 3UX",298,124,174
W00002764,SY23,"SY23 1DX, SY23 1JG, SY23 1JQ, SY23 1PZ, SY23 1QA",233,179,54
W00010057,SY23,"SY23 2DD, SY23 2DE, SY23 2DS, SY23 2DY, SY23 2EB, SY23 2ED, SY23 2HF, SY23 2HJ, SY23 2HP, SY23 2HS, SY23 2HW, SY23 2LP, SY23 2NG, SY23 2WU, SY23 2XA, SY23 2XB",242,196,46
W00002763,SY23,"SY23 1AB, SY23 1BD, SY23 1JB, SY23 1JF, SY23 1JH, SY23 1JJ, SY23 1JL, SY23 1JP, SY23 1PP, SY23 1QD",277,220,57
W00002761,SY23,"SY23 1SP, SY23 1SW, SY23 3RS, SY23 3RT, SY23 3RU, SY23 3RX, SY23 3SB",278,208,70
W00002744,SY23,"SY23 2AF, SY23 2AG, SY23 2DW, SY23 2DX, SY23 2EA, SY23 2NN, SY23 2NQ",256,152,104
W00002745,SY23,"SY23 2NF, SY23 2NJ",192,157,35
W00002746,SY23,"SY23 1DS, SY23 1LD, SY23 1LE, SY23 1LF, SY23 1LH, SY23 1LJ, SY23 1LL, SY23 1LN, SY23 1LP, SY23 1LQ, SY23 1LS, SY23 1NL, SY23 1NX, SY23 1PA, SY23 1PB, SY23 1PD, SY23 1PQ, SY23 1PT, SY23 1YA, SY23 1YY",252,174,78
W00002747,SY23,"SY23 2ES, SY23 2EU, SY23 2HA, SY23 2HB, SY23 2HD, SY23 3DF, SY23 3DU, SY23 3TH",217,115,102
W00002748,SY23,"SY23 2AD, SY23 2AL, SY23 2DL, SY23 2EE, SY23 2EF, SY23 2EP, SY23 2ER, SY23 2FA, SY23 2HE, SY23 2HH, SY23 2JR, SY23 2WW",325,224,101
W00002751,SY23,"SY23 2AP, SY23 2BX, SY23 2BY, SY23 2DA, SY23 2DB, SY23 2HG, SY23 2HN, SY23 2HR",222,174,48
W00002752,SY23,"SY23 2AH, SY23 2BF, SY23 2EH, SY23 2EJ, SY23 2EL, SY23 2EN, SY23 2EQ, SY23 2ET, SY23 2EW, SY23 2EZ, SY23 2HZ",329,239,90
W00002753,SY23,"SY23 1RD, SY23 1RE, SY23 1RG, SY23 1RH, SY23 1RQ, SY23 3RP, SY23 3RR, SY23 3YB",346,237,109
W00002754,SY23,"SY23 1RF, SY23 1RN, SY23 1RP, SY23 1RS, SY23 1RT, SY23 1RW, SY23 1SG, SY23 1SH, SY23 1SJ, SY23 1SQ",250,141,109
W00002755,SY23,"SY23 1RJ, SY23 1RL, SY23 1TA, SY23 1TE, SY23 1UA",319,238,81
W00002756,SY23,"SY23 1RR, SY23 1RU, SY23 1RX, SY23 1RY, SY23 1RZ, SY23 1SA, SY23 1SB, SY23 1SD, SY23 1SE, SY23 1SF, SY23 4DX, SY23 4PP, SY23 4RN",386,225,161
W00002757,SY23,"SY23 1QP, SY23 1QR, SY23 1QS, SY23 1QT, SY23 1QU, SY23 1QW, SY23 1QX, SY23 1SY",206,137,69
W00002758,SY23,"SY23 1QY, SY23 1QZ, SY23 1RA, SY23 1RB, SY23 1SZ",236,151,85
W00002759,SY23,"SY23 1SL, SY23 1SN, SY23 1SR, SY23 1SS",265,191,74
W00002760,SY23,"SY23 1TB, SY23 1TD, SY23 1TF, SY23 1TG, SY23 1TQ",256,192,64
W00002762,SY23,"SY23 3PL, SY23 3RZ, SY23 3SD, SY23 3YA, SY23 3YD",315,214,101
W00010058,SY23,"SY23 2DH, SY23 2DN, SY23 2HU",253,219,34
W00010060,SY23,"SY23 3GA, SY23 3GJ, SY23 3GN, SY23 3RB, SY23 3RG, SY23 3RL, SY23 3RN, SY23 3RW, SY23 3TJ, SY23 3TQ, SY23 3TX, SY23 3TZ, SY23 3UE",281,168,113
W00010063,SY23,"SY23 2HX, SY23 2HY, SY23 2JA, SY23 2JB, SY23 2JD",131,78,53
W00002885,SY23,"SY23 5AQ, SY23 5AU, SY23 5BH, SY23 5BQ, SY23 5HP, SY23 5HR, SY23 5HS, SY23 5HW, SY23 5LP, SY23 5LT, SY23 5LU, SY23 5LX, SY23 5LY, SY23 5LZ",321,160,161
W00002886,SY23,"SY23 5BX, SY23 5BY, SY23 5BZ, SY23 5DA, SY23 5JZ, SY23 5LB, SY23 5LD, SY23 5LE, SY23 5LF, SY23 5LG, SY23 5LH, SY23 5LJ, SY23 5LL, SY23 5LN, SY23 5LQ, SY23 5LR, SY23 5LW, SY23 5WA, SY23 5WD",275,152,123
W00002887,SY23,"SY23 5HJ, SY23 5HL, SY23 5HN, SY23 5HU, SY23 5HX, SY23 5JA, SY23 5JB, SY23 5JD, SY23 5JY, SY23 5LA",242,115,127
W00002895,SY23,"SY23 4AJ, SY23 4HL, SY23 4HU, SY23 4HX, SY23 4HZ, SY23 4JE, SY23 4JW, SY23 4SH, SY23 4TA, SY23 4TB, SY23 4TD, SY23 4TE, SY23 4TF, SY23 4TG, SY23 4TH, SY23 4TQ",337,152,185
W00002896,SY23,"SY23 4JA, SY23 4JB, SY23 4JD, SY23 4JF, SY23 4JG, SY23 4JH, SY23 4JQ, SY23 4TJ, SY23 4TL, SY23 4TP, SY23 4TR, SY23 4TS, SY23 4TT, SY23 4TW, SY25 6LS",338,157,181
W00002901,SY23,"SY23 4HY, SY25 6AA, SY25 6AB, SY25 6AD, SY25 6AE, SY25 6AF, SY25 6AG, SY25 6AH, SY25 6AJ, SY25 6AL, SY25 6AN, SY25 6AP, SY25 6AQ, SY25 6AW, SY25 6AX",358,176,182
W00002902,SY23,"SY23 3AD, SY23 3AG, SY23 3JT, SY23 3JU, SY23 3JY, SY23 3JZ, SY23 3LA, SY23 3LB, SY23 3LD, SY23 3LE",204,115,89
W00002903,SY23,"SY23 3AB, SY23 3AE, SY23 3AF, SY23 3JP, SY23 3JR, SY23 3JS, SY23 3JW, SY23 3JX, SY23 3LF, SY23 3LJ, SY23 3NQ, SY23 3PJ, SY23 3PQ, SY23 4AA",253,153,100
W00002904,SY23,"SY23 3LR, SY23 3LS, SY23 3LT, SY23 3LU, SY23 3LW, SY23 3LX, SY23 3LY, SY23 3LZ, SY23 3NN",250,115,135
W00002905,SY23,"SY23 3LN, SY23 3LP, SY23 3NA, SY23 3ND, SY23 4AW, SY23 4EF, SY23 4EG, SY23 4EJ, SY23 4EL",324,138,186
W00002906,SY23,"SY23 3NB, SY23 3NE, SY23 3NF, SY23 3NT, SY23 3NU, SY23 3NX, SY23 3NY, SY23 3NZ, SY23 3PA, SY23 3PE, SY23 3PG, SY23 4NE, SY23 4NF, SY23 4NG, SY23 4NH",243,118,125
W00002907,SY23,"SY23 3HZ, SY23 3LL, SY23 3NL, SY23 3NP, SY23 3NR, SY23 3NS, SY23 3NW, SY23 3PB, SY23 3PD, SY23 3PF",269,117,152
W00002908,SY23,"SY23 3GW, SY23 3JL, SY23 3JN, SY23 4AB, SY23 4AD, SY23 4AE, SY23 4AF, SY23 4AG, SY23 4RB, SY25 6DX",184,121,63
W00002909,SY23,"SY23 4QU, SY23 4QX, SY23 4QY, SY23 4QZ, SY23 4RA, SY23 4RD, SY23 4RE, SY23 4RF, SY23 4RG, SY23 4RH, SY23 4RJ, SY23 4RL, SY23 4RP, SY23 4RQ",232,118,114
W00002929,SY23,"SY23 3DG, SY23 3DH, SY23 3DL, SY23 3DQ, SY23 3DS, SY23 3DT",136,87,49
W00002884,SY23,"SY23 5BL, SY23 5HA, SY23 5HB, SY23 5HD, SY23 5HE, SY23 5HF, SY23 5HG, SY23 5HH, SY23 5HQ, SY23 5HT, SY23 5HY, SY23 5HZ",320,170,150
W00002880,SY23,"SY23 5LS, SY23 5NA, SY23 5NB, SY23 5ND, SY23 5NF, SY23 5NH, SY23 5NJ, SY23 5NL, SY23 5NN, SY23 5NT, SY23 5PD",327,177,150
W00002879,SY23,"SY23 5AA, SY23 5AB, SY23 5BF, SY23 5BN, SY23 5BP, SY23 5BT, SY23 5BU, SY23 5BW, SY23 5DG, SY23 5DH, SY23 5DJ, SY23 5DL, SY23 5DQ",334,143,191
W00002877,SY23,"SY23 5AD, SY23 5AL, SY23 5AN, SY23 5AS, SY23 5AW, SY23 5AX, SY23 5BA, SY23 5BB, SY23 5BD, SY23 5DN, SY23 5DP, SY23 5DR, SY23 5DS, SY23 5DT, SY23 5DU, SY23 5DW, SY23 5EA, SY23 5EF, SY23 5EG",300,148,152
W00010064,SY23,"SY23 1EL, SY23 1EN, SY23 1EQ, SY23 2EX, SY23 2EY, SY23 2JY",140,99,41
W00010066,SY23,"SY23 1HD, SY23 1HE, SY23 1HF, SY23 1HL, SY23 1HN, SY23 1HQ, SY23 1HY, SY23 1JD, SY23 1NR, SY23 1NU, SY23 3GB, SY23 3GD, SY23 3GE, SY23 3GF, SY23 3GG, SY23 3QP, SY23 3QS, SY23 3QT, SY23 3TL, SY23 3UR",319,191,128
W00002825,SY23,"SY23 3SE, SY23 3SG, SY23 3SP, SY23 3US",238,158,80
W00002826,SY23,"SY23 3AA, SY23 3AU, SY23 3HL, SY23 3HW, SY23 3SS, SY23 3SU, SY23 3SX, SY23 3SY, SY23 3SZ, SY23 3UA",164,105,59
W00002827,SY23,"SY23 3RE, SY23 3RJ, SY23 3RQ, SY23 3SH, SY23 3SJ, SY23 3SL, SY23 3SN, SY23 3SQ, SY23 3SR, SY23 3ST, SY23 3TD, SY23 3TN, SY23 3UH, SY23 3UJ",225,122,103
W00002828,SY23,"SY23 3AL, SY23 3AP, SY23 3AS, SY23 3AT, SY23 3BP, SY23 3GY, SY23 3JG, SY23 3QG, SY23 3TF, SY23 3TU, SY23 3UL, SY23 3UN, SY23 3UP, SY23 3UQ",312,193,119
W00002829,SY23,"SY23 3QU, SY23 3QY, SY23 3QZ, SY23 3RA, SY23 3RD, SY23 3RF, SY23 3RH, SY23 3SA, SY23 3SF",179,100,79
W00002936,SY23,"SY23 3BT, SY23 3EA, SY23 3EB, SY23 3ED, SY23 3EE, SY23 3EY, SY23 3HU, SY23 3HX, SY23 3HY, SY23 3JA, SY23 3JE",189,99,90
W00002831,SY23,"SY23 1HG, SY23 1HH, SY23 3AH, SY23 3AN, SY23 3AR, SY23 3BS, SY23 3DX, SY23 3FD, SY23 3FE, SY23 3GL, SY23 3JJ, SY23 3LH, SY23 3QL, SY23 3QN, SY23 3QR, SY23 3QW, SY23 3QX, SY23 3TT, SY23 3UY, SY23 3UZ",720,577,143
W00002852,SY23,"SY23 1NS, SY23 1WD, SY23 1WH, SY23 1WT, SY23 1WW, SY23 1WX, SY23 1WY, SY23 1WZ, SY23 1XA, SY23 1XU, SY23 1ZU, SY23 2AX, SY23 2BP, SY23 2NB, SY23 2WA, SY23 2WB, SY23 2WR, SY23 2WS, SY23 2WX, SY23 2WY, SY23 2WZ, SY23 2XD, SY23 2XZ, SY23 2YA, SY23 3AQ, SY23 3FF, SY23 3GX, SY23 3HJ, SY23 3JB, SY23 3JF, SY23 3JH, SY23 3JQ, SY23 3LQ, SY23 3NG, SY23 3RY, SY23 3UD, SY23 3WB, SY23 3WD, SY23 3WG, SY23 3WH, SY23 3WY, SY23 3WZ, SY23 3XE, SY23 3XT, SY23 3XW, SY23 3XY, SY23 3YH, SY23 3ZE, SY23 3ZZ, SY23 4DY, SY23 4DZ, SY23 4EA, SY23 4EB, SY23 4ED, SY23 4EE, SY23 4LU, SY23 4WB, SY23 4WY, SY23 4YE, SY23 5WY, SY23 9AB, SY23 9AE, SY23 9AF, SY23 9AG, SY23 9AJ, SY23 9AN, SY23 9AP, SY23 9AR, SY23 9AT, SY23 9AW, SY23 9AX, SY23 9AY, SY23 9AZ, SY23 9BA, SY23 9BB, SY23 9BD, SY23 9BE, SY23 9BF, SY23 9BG, SY23 9BH, SY23 9BJ, SY23 9BL, SY23 9BN, SY23 9BP, SY23 9BQ, SY23 9BR, SY23 9BS, SY23 9BT, SY23 9BW, SY23 9BX, SY23 9FA, SY23 9FE, SY23 9FF, SY23 9FG, SY23 9FH, SY23 9FJ, SY23 9FL, SY23 9FN, SY23 9FP, SY23 9FQ, SY23 9FR, SY23 9FS, SY23 9FT, SY23 9FU, SY23 9FW, SY23 9FX, SY23 9FY, SY23 9FZ, SY24 5WR",289,148,141
W00002853,SY23,"SY23 4BP, SY23 4BX, SY23 4LX, SY23 4PZ, SY23 4QA, SY23 4QE, SY23 4QF, SY23 4UA, SY23 4UH, SY23 4UJ, SY23 4UL",272,131,141
W00002854,SY23,"SY23 4BS, SY23 4BT, SY23 4BU, SY23 4BY, SY23 4BZ, SY23 4DA, SY23 4DB, SY23 4DD, SY23 4DE, SY23 4NN, SY23 4QG, SY23 4QQ, SY23 4UB, SY23 4UD, SY23 4UE, SY23 4UF, SY23 4UG, SY23 4UN, SY23 4UQ",253,125,128
W00002855,SY23,"SY23 4BL, SY23 4DF, SY23 4DG, SY23 4DH, SY23 4DJ, SY23 4DL, SY23 4DN, SY23 4DP, SY23 4DQ, SY23 4DR, SY23 4DW, SY23 4QH, SY23 4QJ, SY23 4QL, SY23 4QN, SY23 4QW",279,117,162
W00002867,SY23,"SY23 4TN, SY25 6LJ, SY25 6LU, SY25 6QJ, SY25 6QL, SY25 6QZ, SY25 6RA, SY25 6RB, SY25 6SX, SY25 6TU, SY25 6TZ",248,134,114
W00002875,SY23,"SY23 4HD, SY23 4HE, SY23 4HF, SY23 4HG, SY23 4HH, SY23 4HJ, SY23 4HQ, SY23 4JJ, SY23 4JL, SY23 4JN, SY23 4SS, SY23 5AE, SY23 5AF, SY23 5BE, SY23 5EJ, SY23 5EL, SY23 5NW",275,127,148
W00002876,SY23,"SY23 4ER, SY23 4EW, SY23 4EX, SY23 4EY, SY23 4EZ, SY23 4HA, SY23 4HB, SY23 4SL, SY23 4SN, SY23 4SP, SY23 4SR, SY23 4SW, SY23 5AG, SY23 5AR",276,122,154
W00002851,SY23,"SY23 4BF, SY23 4LR, SY23 4LT, SY23 4PR, SY23 4PT, SY23 4PU, SY23 4PX, SY23 4PY, SY23 4QB, SY23 4QD, SY23 4QP, SY23 4QS",393,174,219
W00002878,SY23,"SY23 5AH, SY23 5AT, SY23 5AY, SY23 5AZ, SY23 5BG, SY23 5BJ, SY23 5BS, SY23 5DB, SY23 5DY, SY23 5EB, SY23 5ED, SY23 5EE, SY23 5EH, SY23 5EQ",322,176,146
W00002935,SY24,"SY24 5BH, SY24 5DE, SY24 5DF, SY24 5DT, SY24 5EP",269,145,124
W00002792,SY24,"SY24 5DY, SY24 5DZ, SY24 5ED, SY24 5EH, SY24 5EN, SY24 5EQ, SY24 5ER, SY24 5ES, SY24 5ET, SY24 5EU, SY24 5EX, SY24 5EY, SY24 5EZ, SY24 5HB",283,127,156
W00002793,SY24,"SY24 5AP, SY24 5DL, SY24 5EF, SY24 5EG, SY24 5HA, SY24 5HD, SY24 5HE, SY24 5HF, SY24 5HG, SY24 5HH, SY24 5HQ",353,155,198
W00002933,SY24,"SY24 5AL, SY24 5AS, SY24 5AT, SY24 5BB, SY24 5BD, SY24 5BE, SY24 5BF, SY24 5BG, SY24 5BJ, SY24 5BW, SY24 5DB, SY24 5DG",349,125,224
W00002791,SY24,"SY24 5AH, SY24 5DH, SY24 5DJ, SY24 5DN, SY24 5DP, SY24 5DR, SY24 5DW, SY24 5EA, SY24 5EB, SY24 5EE, SY24 5HJ, SY24 5HL, SY24 5HN",344,118,226
W00002785,SY24,"SY24 5AA, SY24 5AD, SY24 5AG, SY24 5BX, SY24 5BY, SY24 5EJ, SY24 5LX, SY24 5LY, SY24 5LZ, SY24 5NS, SY24 5NU, SY24 5NX, SY24 5WD, SY24 5WE, SY24 5WF, SY24 5WH, SY24 5WJ, SY24 5WL, SY24 5WQ",345,157,188
W00002932,SY24,"SY24 5AE, SY24 5AF, SY24 5AJ, SY24 5AQ, SY24 5AW, SY24 5BP, SY24 5BQ, SY24 5DQ, SY24 5DS, SY24 5DU",353,152,201
W00002784,SY24,"SY24 5AB, SY24 5AN, SY24 5BS, SY24 5BT, SY24 5BU, SY24 5BZ, SY24 5DA, SY24 5DD, SY24 5DX",346,141,205
W00002783,SY24,"SY24 5JU, SY24 5JX, SY24 5JY, SY24 5JZ, SY24 5LA, SY24 5NA",129,84,45
W00002930,SY24,"SY24 5AX, SY24 5AY, SY24 5BA, SY24 5BL",240,124,116
W00002782,SY24,"SY24 5LN, SY24 5LP, SY24 5LT, SY24 5LU, SY24 5LW, SY24 5NB, SY24 5NG, SY24 5NP, SY24 5NQ, SY24 5NW, SY24 5NY, SY24 5NZ, SY24 5WT",247,159,88
W00002781,SY24,"SY24 5EL, SY24 5LE, SY24 5LH, SY24 5LJ, SY24 5LL, SY24 5LR, SY24 5LS, SY24 5ND, SY24 5NH, SY24 5NJ, SY24 5NL, SY24 5NN, SY24 5NR",280,175,105
W00002780,SY24,"SY24 5JA, SY24 5JB, SY24 5JD, SY24 5JE, SY24 5JF, SY24 5JG, SY24 5JQ, SY24 5LG",177,127,50
W00002779,SY24,"SY24 5HP, SY24 5HU, SY24 5HW, SY24 5HX, SY24 5HY, SY24 5HZ, SY24 5JH",170,123,47
W00002778,SY24,"SY24 5HT, SY24 5JP, SY24 5JR, SY24 5JS, SY24 5JT, SY24 5LD",224,147,77
W00002934,SY24,"SY24 5AR, SY24 5AU, SY24 5AZ, SY24 5BN",207,115,92
W00002900,SY25,"SY25 6AR, SY25 6AY, SY25 6BJ, SY25 6BL, SY25 6BN, SY25 6BP, SY25 6BS, SY25 6BT, SY25 6BU, SY25 6BW, SY25 6EF, SY25 6EG, SY25 6EH, SY25 6EJ, SY25 6EL, SY25 6EQ, SY25 6ES, SY25 6ET, SY25 6GA",389,186,203
W00002898,SY25,"SY25 6DA, SY25 6DB, SY25 6DN, SY25 6DP, SY25 6DR, SY25 6DU, SY25 6DW",156,84,72
W00002897,SY25,"SY25 6AU, SY25 6DD, SY25 6DE, SY25 6DF, SY25 6DG, SY25 6DH, SY25 6DJ, SY25 6DL, SY25 6DQ, SY25 6DS, SY25 6DT, SY25 6DY, SY25 6SS",267,167,100
W00002866,SY25,"SY25 6PX, SY25 6PY, SY25 6QF, SY25 6QG, SY25 6QH, SY25 6QQ, SY25 6QX, SY25 6QY, SY25 6SH, SY25 6SJ, SY25 6SL, SY25 6SW, SY25 6SY, SY25 6TD, SY25 6TE, SY25 6TF, SY25 6TP, SY25 6TR",239,151,88
W00002941,SY25,"SY25 6HD, SY25 6HJ, SY25 6HQ, SY25 6HU, SY25 6HX, SY25 6HY, SY25 6HZ, SY25 6JA, SY25 6JZ",242,85,157
W00002899,SY25,"SY25 6AZ, SY25 6BA, SY25 6BB, SY25 6BD, SY25 6BE, SY25 6BG, SY25 6BH, SY25 6BQ, SY25 6EB, SY25 6ED, SY25 6EE, SY25 6EN, SY25 6EP, SY25 6ER, SY25 6EU, SY25 6EW",304,148,156
W00002943,SY25,"SY25 6HN, SY25 6HR, SY25 6HW, SY25 6JR, SY25 6JS, SY25 6LG, SY25 6LH, SY25 6LL, SY25 6LN, SY25 6LP, SY25 6LR, SY25 6LT, SY25 6LW, SY25 6NG, SY25 6NH, SY25 6NJ, SY25 6NL, SY25 6NN, SY25 6NQ, SY25 6NR, SY25 6NW, SY25 6PP, SY25 6QS, SY25 6QT, SY25 6TB",270,135,135
W00002944,SY25,"SY25 6HL, SY25 6JB, SY25 6JD, SY25 6JE, SY25 6JF, SY25 6JG, SY25 6JH, SY25 6JQ, SY25 6LQ, SY25 6ND, SY25 6NF, SY25 6WD, SY25 6WF, SY25 6WL",314,114,200
W00002865,SY25,"SY25 6QU, SY25 6SU, SY25 6SZ, SY25 6TA, SY25 6TL, SY25 6TN, SY25 6TS, SY25 6TT, SY25 6TW, SY25 6TX, SY25 6TY",242,113,129
W00002942,SY25,"SY25 6AT, SY25 6HA, SY25 6HB, SY25 6HE, SY25 6HF, SY25 6HG, SY25 6HH, SY25 6HP, SY25 6HS, SY25 6JL, SY25 6JN, SY25 6JP, SY25 6JT, SY25 6JU, SY25 6JW, SY25 6JX, SY25 6JY, SY25 6LA, SY25 6NB, SY25 6NE, SY25 6WA, SY25 6WB, SY25 6WE, SY25 6WG, SY25 6WH, SY25 6WJ, SY25 6WN, SY25 6WP, SY25 6WQ, SY25 6WR, SY25 6WS, SY25 6WW, SY25 6WX, SY25 6WZ, SY25 6XA",302,131,171
W00002863,SY25,"SY25 6AS, SY25 6NY, SY25 6RL, SY25 6RN, SY25 6RR, SY25 6RS, SY25 6RT, SY25 6RU, SY25 6RW, SY25 6RX, SY25 6RY, SY25 6RZ, SY25 6SA, SY25 6SB, SY25 6UT",306,161,145
W00002437,SY5,"SY5 9AU, SY5 9AX, SY5 9AY, SY5 9AZ, SY5 9BA, SY5 9BB, SY5 9BD, SY5 9BE, SY5 9BG, SY5 9BH, SY5 9BJ, SY5 9BL, SY5 9BN, SY5 9BP, SY5 9BQ, SY5 9BT, SY5 9BW",287,261,26
W00002436,SY5,"SY5 9AR, SY5 9AS, SY5 9AT, SY5 9AW, SY5 9BF, SY5 9BS, SY5 9BU, SY5 9EU, SY5 9FB, SY5 9FF, SY5 9GN, SY5 9GR, SY5 9LD",391,377,14
